what block is to the left of either block 1 or block 2	( call SW.listValue ( call SW.filter ( call SW.getProperty ( call SW.singleton en.block ) ( string ! type ) ) ( string left ) ( string = ) ( call SW.concat en.block.block1 en.block.block2 ) ) )	overnight-blocks
block that is right of block that is special	( call SW.listValue ( call SW.filter ( call SW.getProperty ( call SW.singleton en.block ) ( string ! type ) ) ( string right ) ( string = ) ( call SW.filter ( call SW.getProperty ( call SW.singleton en.block ) ( string ! type ) ) ( string is_special ) ) ) )	overnight-blocks
find me all blocks below which block 1 is above	( call SW.listValue ( call SW.filter ( call SW.getProperty ( call SW.singleton en.block ) ( string ! type ) ) ( call SW.reverse ( string above ) ) ( string = ) ( call SW.filter ( call SW.getProperty ( call SW.singleton en.block ) ( string ! type ) ) ( string below ) ( string = ) en.block.block1 ) ) )	overnight-blocks
find me all 3 inch long blocks  that block 1 is left of	( call SW.listValue ( call SW.filter ( call SW.filter ( call SW.getProperty ( call SW.singleton en.block ) ( string ! type ) ) ( call SW.reverse ( string left ) ) ( string = ) en.block.block1 ) ( string length ) ( string = ) ( number 3 en.inch ) ) )	overnight-blocks
select the blocks that are 3 inches wide	( call SW.listValue ( call SW.filter ( call SW.getProperty ( call SW.singleton en.block ) ( string ! type ) ) ( call SW.reverse ( string below ) ) ( string = ) ( call SW.filter ( call SW.getProperty ( call SW.singleton en.block ) ( string ! type ) ) ( string width ) ( string = ) ( number 3 en.inch ) ) ) )	overnight-blocks
find the block with the most blocks to the right of	( call SW.listValue ( call SW.countSuperlative ( call SW.getProperty ( call SW.singleton en.block ) ( string ! type ) ) ( string max ) ( string right ) ( call SW.getProperty ( call SW.singleton en.block ) ( string ! type ) ) ) )	overnight-blocks
which brick is at the very top	( call SW.listValue ( call SW.countSuperlative ( call SW.getProperty ( call SW.singleton en.block ) ( string ! type ) ) ( string min ) ( string below ) ( call SW.getProperty ( call SW.singleton en.block ) ( string ! type ) ) ) )	overnight-blocks
what block is shorter than 3 inches	( call SW.listValue ( call SW.filter ( call SW.getProperty ( call SW.singleton en.block ) ( string ! type ) ) ( call SW.ensureNumericProperty ( string height ) ) ( string < ) ( call SW.ensureNumericEntity ( number 3 en.inch ) ) ) )	overnight-blocks
find me all blocks left of 2 blocks	( call SW.listValue ( call SW.countComparative ( call SW.getProperty ( call SW.singleton en.block ) ( string ! type ) ) ( string left ) ( string = ) ( number 2 ) ( call SW.getProperty ( call SW.singleton en.block ) ( string ! type ) ) ) )	overnight-blocks
find a block with the same height as block 1	( call SW.listValue ( call SW.filter ( call SW.getProperty ( call SW.singleton en.block ) ( string ! type ) ) ( string height ) ( string = ) ( call SW.getProperty en.block.block1 ( string height ) ) ) )	overnight-blocks
which block has a width of less than 3 inches	( call SW.listValue ( call SW.filter ( call SW.getProperty ( call SW.singleton en.block ) ( string ! type ) ) ( call SW.ensureNumericProperty ( string width ) ) ( string < ) ( call SW.ensureNumericEntity ( call SW.concat ( number 3 en.inch ) ( number 6 en.inch ) ) ) ) )	overnight-blocks
find me all blocks with at least 2 colors	( call SW.listValue ( call SW.countComparative ( call SW.getProperty ( call SW.singleton en.block ) ( string ! type ) ) ( string color ) ( string >= ) ( number 2 ) ) )	overnight-blocks
what block is thinner then block 1 is long	( call SW.listValue ( call SW.filter ( call SW.getProperty ( call SW.singleton en.block ) ( string ! type ) ) ( call SW.ensureNumericProperty ( string width ) ) ( string < ) ( call SW.ensureNumericEntity ( call SW.getProperty en.block.block1 ( string length ) ) ) ) )	overnight-blocks
block that has block 1 above and below	( call SW.listValue ( call SW.filter ( call SW.filter ( call SW.getProperty ( call SW.singleton en.block ) ( string ! type ) ) ( call SW.reverse ( string above ) ) ( string = ) en.block.block1 ) ( string below ) ( string = ) en.block.block1 ) )	overnight-blocks
right of special block	( call SW.listValue ( call SW.filter ( call SW.getProperty ( call SW.singleton en.block ) ( string ! type ) ) ( call SW.reverse ( string left ) ) ( string = ) ( call SW.filter ( call SW.getProperty ( call SW.singleton en.block ) ( string ! type ) ) ( string is_special ) ) ) )	overnight-blocks
select the blocks to the left of block 1	( call SW.listValue ( call SW.filter ( call SW.getProperty ( call SW.singleton en.block ) ( string ! type ) ) ( string left ) ( string = ) en.block.block1 ) )	overnight-blocks
which brick has no more than 2 bricks to its right	( call SW.listValue ( call SW.countComparative ( call SW.getProperty ( call SW.singleton en.block ) ( string ! type ) ) ( call SW.reverse ( string right ) ) ( string <= ) ( number 2 ) ( call SW.getProperty ( call SW.singleton en.block ) ( string ! type ) ) ) )	overnight-blocks
which brick is no higher than 3 or 6 inches	( call SW.listValue ( call SW.filter ( call SW.getProperty ( call SW.singleton en.block ) ( string ! type ) ) ( call SW.ensureNumericProperty ( string height ) ) ( string <= ) ( call SW.ensureNumericEntity ( call SW.concat ( number 3 en.inch ) ( number 6 en.inch ) ) ) ) )	overnight-blocks
below and left of block 1	( call SW.listValue ( call SW.filter ( call SW.filter ( call SW.getProperty ( call SW.singleton en.block ) ( string ! type ) ) ( call SW.reverse ( string above ) ) ( string = ) en.block.block1 ) ( call SW.reverse ( string right ) ) ( string = ) en.block.block1 ) )	overnight-blocks
find me all the blocks below and to the left of block 1	( call SW.listValue ( call SW.filter ( call SW.getProperty ( call SW.singleton en.block ) ( string ! type ) ) ( string below ) ( string = ) ( call SW.filter ( call SW.getProperty ( call SW.singleton en.block ) ( string ! type ) ) ( string left ) ( string = ) en.block.block1 ) ) )	overnight-blocks
locate the block with a height measurement that equals at minimum the length of block 1	( call SW.listValue ( call SW.filter ( call SW.getProperty ( call SW.singleton en.block ) ( string ! type ) ) ( call SW.ensureNumericProperty ( string height ) ) ( string >= ) ( call SW.ensureNumericEntity ( call SW.getProperty en.block.block1 ( string length ) ) ) ) )	overnight-blocks
find me all the 3 inch wide blocks	( call SW.listValue ( call SW.filter ( call SW.filter ( call SW.getProperty ( call SW.singleton en.block ) ( string ! type ) ) ( string width ) ( string = ) ( number 3 en.inch ) ) ( string width ) ( string = ) ( number 3 en.inch ) ) )	overnight-blocks
choose a block that is the same height as block 1	( call SW.listValue ( call SW.filter ( call SW.getProperty ( call SW.singleton en.block ) ( string ! type ) ) ( call SW.ensureNumericProperty ( string width ) ) ( string >= ) ( call SW.ensureNumericEntity ( call SW.getProperty en.block.block1 ( string height ) ) ) ) )	overnight-blocks
which brick is not to the left of brick 1	( call SW.listValue ( call SW.filter ( call SW.getProperty ( call SW.singleton en.block ) ( string ! type ) ) ( string left ) ( string ! = ) en.block.block1 ) )	overnight-blocks
block that more than two block is right of	( call SW.listValue ( call SW.countComparative ( call SW.getProperty ( call SW.singleton en.block ) ( string ! type ) ) ( call SW.reverse ( string right ) ) ( string > ) ( number 2 ) ( call SW.getProperty ( call SW.singleton en.block ) ( string ! type ) ) ) )	overnight-blocks
block below block 1	( call SW.listValue ( call SW.filter ( call SW.filter ( call SW.getProperty ( call SW.singleton en.block ) ( string ! type ) ) ( string below ) ( string = ) en.block.block1 ) ( call SW.reverse ( string above ) ) ( string = ) en.block.block1 ) )	overnight-blocks
what block is to the right of block 1 and has a width of 3 inches	( call SW.listValue ( call SW.filter ( call SW.filter ( call SW.getProperty ( call SW.singleton en.block ) ( string ! type ) ) ( call SW.reverse ( string left ) ) ( string = ) en.block.block1 ) ( string width ) ( string = ) ( number 3 en.inch ) ) )	overnight-blocks
block left and above block 1	( call SW.listValue ( call SW.filter ( call SW.filter ( call SW.getProperty ( call SW.singleton en.block ) ( string ! type ) ) ( string left ) ( string = ) en.block.block1 ) ( call SW.reverse ( string below ) ) ( string = ) en.block.block1 ) )	overnight-blocks
which brick has the least number of shapes	( call SW.listValue ( call SW.countSuperlative ( call SW.getProperty ( call SW.singleton en.block ) ( string ! type ) ) ( string min ) ( string shape ) ) )	overnight-blocks
find me all blocks that is right of the block which block 1 is right of	( call SW.listValue ( call SW.filter ( call SW.getProperty ( call SW.singleton en.block ) ( string ! type ) ) ( string right ) ( string = ) ( call SW.filter ( call SW.getProperty ( call SW.singleton en.block ) ( string ! type ) ) ( call SW.reverse ( string right ) ) ( string = ) en.block.block1 ) ) )	overnight-blocks
find me a block that is below at most two blocks	( call SW.listValue ( call SW.countComparative ( call SW.getProperty ( call SW.singleton en.block ) ( string ! type ) ) ( call SW.reverse ( string above ) ) ( string <= ) ( number 2 ) ( call SW.getProperty ( call SW.singleton en.block ) ( string ! type ) ) ) )	overnight-blocks
find me all the blocks with the same width as the length of block 1	( call SW.listValue ( call SW.filter ( call SW.getProperty ( call SW.singleton en.block ) ( string ! type ) ) ( string width ) ( string = ) ( call SW.getProperty en.block.block1 ( string length ) ) ) )	overnight-blocks
find the blocks that have two shapes or less	( call SW.listValue ( call SW.countComparative ( call SW.getProperty ( call SW.singleton en.block ) ( string ! type ) ) ( string shape ) ( string <= ) ( number 2 ) ) )	overnight-blocks
choose the brick to the right of the 3 inch block	( call SW.listValue ( call SW.filter ( call SW.getProperty ( call SW.singleton en.block ) ( string ! type ) ) ( string right ) ( string = ) ( call SW.filter ( call SW.getProperty ( call SW.singleton en.block ) ( string ! type ) ) ( string length ) ( string = ) ( number 3 en.inch ) ) ) )	overnight-blocks
get a block above any pyramid block	( call SW.listValue ( call SW.filter ( call SW.getProperty ( call SW.singleton en.block ) ( string ! type ) ) ( call SW.reverse ( string below ) ) ( string = ) ( call SW.filter ( call SW.getProperty ( call SW.singleton en.block ) ( string ! type ) ) ( string shape ) ( string = ) en.shape.pyramid ) ) )	overnight-blocks
what block is above block 1	( call SW.listValue ( call SW.filter ( call SW.getProperty ( call SW.singleton en.block ) ( string ! type ) ) ( string left ) ( string = ) ( call SW.filter ( call SW.getProperty ( call SW.singleton en.block ) ( string ! type ) ) ( string above ) ( string = ) en.block.block1 ) ) )	overnight-blocks
select the blocks on the right of and below block 1	( call SW.listValue ( call SW.filter ( call SW.filter ( call SW.getProperty ( call SW.singleton en.block ) ( string ! type ) ) ( string right ) ( string = ) en.block.block1 ) ( call SW.reverse ( string above ) ) ( string = ) en.block.block1 ) )	overnight-blocks
select the block that block 1 is above with a width of 3 inches	( call SW.listValue ( call SW.filter ( call SW.filter ( call SW.getProperty ( call SW.singleton en.block ) ( string ! type ) ) ( call SW.reverse ( string above ) ) ( string = ) en.block.block1 ) ( string width ) ( string = ) ( number 3 en.inch ) ) )	overnight-blocks
select the blocks less than 3 inches	( call SW.listValue ( call SW.filter ( call SW.getProperty ( call SW.singleton en.block ) ( string ! type ) ) ( call SW.ensureNumericProperty ( string length ) ) ( string <= ) ( call SW.ensureNumericEntity ( number 3 en.inch ) ) ) )	overnight-blocks
block above at most two block	( call SW.listValue ( call SW.countComparative ( call SW.getProperty ( call SW.singleton en.block ) ( string ! type ) ) ( call SW.reverse ( string above ) ) ( string <= ) ( number 2 ) ( call SW.getProperty ( call SW.singleton en.block ) ( string ! type ) ) ) )	overnight-blocks
right of block 1	( call SW.listValue ( call SW.filter ( call SW.filter ( call SW.getProperty ( call SW.singleton en.block ) ( string ! type ) ) ( call SW.reverse ( string left ) ) ( string = ) en.block.block1 ) ( call SW.reverse ( string left ) ) ( string = ) en.block.block1 ) )	overnight-blocks
what block is to the left of and below block 1	( call SW.listValue ( call SW.filter ( call SW.getProperty ( call SW.singleton en.block ) ( string ! type ) ) ( call SW.reverse ( string below ) ) ( string = ) ( call SW.filter ( call SW.getProperty ( call SW.singleton en.block ) ( string ! type ) ) ( call SW.reverse ( string left ) ) ( string = ) en.block.block1 ) ) )	overnight-blocks
block whose height is height of block 1	( call SW.listValue ( call SW.filter ( call SW.getProperty ( call SW.singleton en.block ) ( string ! type ) ) ( string height ) ( string = ) ( call SW.getProperty en.block.block1 ( string height ) ) ) )	overnight-blocks
what is the total width of the blocks	( call SW.listValue ( call SW.aggregate ( string sum ) ( call SW.getProperty ( call SW.getProperty ( call SW.singleton en.block ) ( string ! type ) ) ( string width ) ) ) )	overnight-blocks
block that is below block 1 or block 2	( call SW.listValue ( call SW.filter ( call SW.getProperty ( call SW.singleton en.block ) ( string ! type ) ) ( string below ) ( string = ) ( call SW.concat en.block.block1 en.block.block2 ) ) )	overnight-blocks
what shape is block 1	( call SW.listValue ( call SW.getProperty en.block.block1 ( string shape ) ) )	overnight-blocks
find the block to the left of two blocks or one but no more	( call SW.listValue ( call SW.countComparative ( call SW.getProperty ( call SW.singleton en.block ) ( string ! type ) ) ( call SW.reverse ( string right ) ) ( string <= ) ( number 2 ) ( call SW.getProperty ( call SW.singleton en.block ) ( string ! type ) ) ) )	overnight-blocks
find a block that is is left of block two	( call SW.listValue ( call SW.countComparative ( call SW.getProperty ( call SW.singleton en.block ) ( string ! type ) ) ( call SW.reverse ( string left ) ) ( string >= ) ( number 2 ) ( call SW.getProperty ( call SW.singleton en.block ) ( string ! type ) ) ) )	overnight-blocks
find the special block to the left of block 1	( call SW.listValue ( call SW.filter ( call SW.filter ( call SW.getProperty ( call SW.singleton en.block ) ( string ! type ) ) ( string left ) ( string = ) en.block.block1 ) ( string is_special ) ) )	overnight-blocks
below and right of block 1	( call SW.listValue ( call SW.filter ( call SW.filter ( call SW.getProperty ( call SW.singleton en.block ) ( string ! type ) ) ( string right ) ( string = ) en.block.block1 ) ( call SW.reverse ( string above ) ) ( string = ) en.block.block1 ) )	overnight-blocks
find me all blocks with the same width as block 1	( call SW.listValue ( call SW.filter ( call SW.getProperty ( call SW.singleton en.block ) ( string ! type ) ) ( string length ) ( string = ) ( call SW.getProperty en.block.block1 ( string width ) ) ) )	overnight-blocks
find the pyramidshaped block below block 1	( call SW.listValue ( call SW.filter ( call SW.filter ( call SW.getProperty ( call SW.singleton en.block ) ( string ! type ) ) ( string below ) ( string = ) en.block.block1 ) ( string shape ) ( string = ) en.shape.pyramid ) )	overnight-blocks
block that has the smallest width	( call SW.listValue ( call SW.superlative ( call SW.getProperty ( call SW.singleton en.block ) ( string ! type ) ) ( string min ) ( call SW.ensureNumericProperty ( string width ) ) ) )	overnight-blocks
select the blocks on the right and left of block 1	( call SW.listValue ( call SW.filter ( call SW.filter ( call SW.getProperty ( call SW.singleton en.block ) ( string ! type ) ) ( string left ) ( string = ) en.block.block1 ) ( string right ) ( string = ) en.block.block1 ) )	overnight-blocks
find me the block that block 1 is below and to the left of	( call SW.listValue ( call SW.filter ( call SW.getProperty ( call SW.singleton en.block ) ( string ! type ) ) ( call SW.reverse ( string left ) ) ( string = ) ( call SW.filter ( call SW.getProperty ( call SW.singleton en.block ) ( string ! type ) ) ( call SW.reverse ( string below ) ) ( string = ) en.block.block1 ) ) )	overnight-blocks
select the block below the one on the right	( call SW.listValue ( call SW.filter ( call SW.filter ( call SW.getProperty ( call SW.singleton en.block ) ( string ! type ) ) ( call SW.reverse ( string below ) ) ( string = ) en.block.block1 ) ( call SW.reverse ( string right ) ) ( string = ) en.block.block1 ) )	overnight-blocks
is there a block with the same color as block 1	( call SW.listValue ( call SW.filter ( call SW.getProperty ( call SW.singleton en.block ) ( string ! type ) ) ( string color ) ( string = ) ( call SW.getProperty en.block.block1 ( string color ) ) ) )	overnight-blocks
3 inches tall block at the right of block 1	( call SW.listValue ( call SW.filter ( call SW.filter ( call SW.getProperty ( call SW.singleton en.block ) ( string ! type ) ) ( string height ) ( string = ) ( number 3 en.inch ) ) ( string right ) ( string = ) en.block.block1 ) )	overnight-blocks
find the block with the pyramidshaped block above it	( call SW.listValue ( call SW.filter ( call SW.getProperty ( call SW.singleton en.block ) ( string ! type ) ) ( string below ) ( string = ) ( call SW.filter ( call SW.getProperty ( call SW.singleton en.block ) ( string ! type ) ) ( string shape ) ( string = ) en.shape.pyramid ) ) )	overnight-blocks
select the 3 inch long block to the right of block 1	( call SW.listValue ( call SW.filter ( call SW.filter ( call SW.getProperty ( call SW.singleton en.block ) ( string ! type ) ) ( string length ) ( string = ) ( number 3 en.inch ) ) ( string right ) ( string = ) en.block.block1 ) )	overnight-blocks
find me all blocks at least 3 inches wide	( call SW.listValue ( call SW.filter ( call SW.getProperty ( call SW.singleton en.block ) ( string ! type ) ) ( call SW.ensureNumericProperty ( string width ) ) ( string >= ) ( call SW.ensureNumericEntity ( number 3 en.inch ) ) ) )	overnight-blocks
select a block with a length larger than the length of block 1	( call SW.listValue ( call SW.filter ( call SW.getProperty ( call SW.singleton en.block ) ( string ! type ) ) ( call SW.ensureNumericProperty ( string length ) ) ( string > ) ( call SW.ensureNumericEntity ( call SW.getProperty en.block.block1 ( string length ) ) ) ) )	overnight-blocks
what block is in the shape of a pyramid and is above block 1	( call SW.listValue ( call SW.filter ( call SW.filter ( call SW.getProperty ( call SW.singleton en.block ) ( string ! type ) ) ( string shape ) ( string = ) en.shape.pyramid ) ( string above ) ( string = ) en.block.block1 ) )	overnight-blocks
block right of pyramid block	( call SW.listValue ( call SW.filter ( call SW.getProperty ( call SW.singleton en.block ) ( string ! type ) ) ( call SW.reverse ( string left ) ) ( string = ) ( call SW.filter ( call SW.getProperty ( call SW.singleton en.block ) ( string ! type ) ) ( string shape ) ( string = ) en.shape.pyramid ) ) )	overnight-blocks
select blocks that have a length of 3 icnhes and are to the right of block 1	( call SW.listValue ( call SW.filter ( call SW.filter ( call SW.getProperty ( call SW.singleton en.block ) ( string ! type ) ) ( string length ) ( string = ) ( number 3 en.inch ) ) ( call SW.reverse ( string right ) ) ( string = ) en.block.block1 ) )	overnight-blocks
select the 3 inch block below block 1	( call SW.listValue ( call SW.filter ( call SW.filter ( call SW.getProperty ( call SW.singleton en.block ) ( string ! type ) ) ( string length ) ( string = ) ( number 3 en.inch ) ) ( string below ) ( string = ) en.block.block1 ) )	overnight-blocks
block that is below block 1 and whose width is 3 inches	( call SW.listValue ( call SW.filter ( call SW.filter ( call SW.getProperty ( call SW.singleton en.block ) ( string ! type ) ) ( string below ) ( string = ) en.block.block1 ) ( string width ) ( string = ) ( number 3 en.inch ) ) )	overnight-blocks
block left of 2 blocks	( call SW.listValue ( call SW.countComparative ( call SW.getProperty ( call SW.singleton en.block ) ( string ! type ) ) ( string left ) ( string >= ) ( number 2 ) ( call SW.getProperty ( call SW.singleton en.block ) ( string ! type ) ) ) )	overnight-blocks
look right of block 1 and find 3 inch block	( call SW.listValue ( call SW.filter ( call SW.filter ( call SW.getProperty ( call SW.singleton en.block ) ( string ! type ) ) ( string length ) ( string = ) ( number 3 en.inch ) ) ( call SW.reverse ( string left ) ) ( string = ) en.block.block1 ) )	overnight-blocks
find me the block that is to the left of block 1 with a height of 3 inches	( call SW.listValue ( call SW.filter ( call SW.filter ( call SW.getProperty ( call SW.singleton en.block ) ( string ! type ) ) ( string left ) ( string = ) en.block.block1 ) ( string height ) ( string = ) ( number 3 en.inch ) ) )	overnight-blocks
block that is above block 1	( call SW.listValue ( call SW.filter ( call SW.getProperty ( call SW.singleton en.block ) ( string ! type ) ) ( string above ) ( string = ) en.block.block1 ) )	overnight-blocks
block a above block that is above block 1	( call SW.listValue ( call SW.filter ( call SW.getProperty ( call SW.singleton en.block ) ( string ! type ) ) ( string above ) ( string = ) ( call SW.filter ( call SW.getProperty ( call SW.singleton en.block ) ( string ! type ) ) ( string above ) ( string = ) en.block.block1 ) ) )	overnight-blocks
find the block that is beneath the smallest number of other blocks	( call SW.listValue ( call SW.countSuperlative ( call SW.getProperty ( call SW.singleton en.block ) ( string ! type ) ) ( string min ) ( string below ) ( call SW.getProperty ( call SW.singleton en.block ) ( string ! type ) ) ) )	overnight-blocks
block on bottom	( call SW.listValue ( call SW.countComparative ( call SW.getProperty ( call SW.singleton en.block ) ( string ! type ) ) ( string below ) ( string >= ) ( number 2 ) ( call SW.getProperty ( call SW.singleton en.block ) ( string ! type ) ) ) )	overnight-blocks
find the 3 inch wide special block	( call SW.listValue ( call SW.filter ( call SW.filter ( call SW.getProperty ( call SW.singleton en.block ) ( string ! type ) ) ( string width ) ( string = ) ( number 3 en.inch ) ) ( string is_special ) ) )	overnight-blocks
find me all the blocks left and below block 1	( call SW.listValue ( call SW.filter ( call SW.getProperty ( call SW.singleton en.block ) ( string ! type ) ) ( string left ) ( string = ) ( call SW.filter ( call SW.getProperty ( call SW.singleton en.block ) ( string ! type ) ) ( string below ) ( string = ) en.block.block1 ) ) )	overnight-blocks
below and right from block 1	( call SW.listValue ( call SW.filter ( call SW.getProperty ( call SW.singleton en.block ) ( string ! type ) ) ( call SW.reverse ( string right ) ) ( string = ) ( call SW.filter ( call SW.getProperty ( call SW.singleton en.block ) ( string ! type ) ) ( call SW.reverse ( string below ) ) ( string = ) en.block.block1 ) ) )	overnight-blocks
find me all blocks that block 1 is below	( call SW.listValue ( call SW.filter ( call SW.filter ( call SW.getProperty ( call SW.singleton en.block ) ( string ! type ) ) ( call SW.reverse ( string below ) ) ( string = ) en.block.block1 ) ( call SW.reverse ( string below ) ) ( string = ) en.block.block1 ) )	overnight-blocks
which brick is shorter than brick 1 is high	( call SW.listValue ( call SW.filter ( call SW.getProperty ( call SW.singleton en.block ) ( string ! type ) ) ( call SW.ensureNumericProperty ( string height ) ) ( string < ) ( call SW.ensureNumericEntity ( call SW.getProperty en.block.block1 ( string width ) ) ) ) )	overnight-blocks
find the block located on the left side of the special block	( call SW.listValue ( call SW.filter ( call SW.getProperty ( call SW.singleton en.block ) ( string ! type ) ) ( string left ) ( string = ) ( call SW.filter ( call SW.getProperty ( call SW.singleton en.block ) ( string ! type ) ) ( string is_special ) ) ) )	overnight-blocks
find the block up 1 and right 1 of block 1	( call SW.listValue ( call SW.filter ( call SW.getProperty ( call SW.singleton en.block ) ( string ! type ) ) ( string above ) ( string = ) ( call SW.filter ( call SW.getProperty ( call SW.singleton en.block ) ( string ! type ) ) ( string right ) ( string = ) en.block.block1 ) ) )	overnight-blocks
choose brick 1 or brick 2	( call SW.listValue ( call SW.concat en.block.block1 en.block.block2 ) )	overnight-blocks
locate a block that is shorter than 3 inches or 6 inches	( call SW.listValue ( call SW.filter ( call SW.getProperty ( call SW.singleton en.block ) ( string ! type ) ) ( call SW.ensureNumericProperty ( string length ) ) ( string < ) ( call SW.ensureNumericEntity ( call SW.concat ( number 3 en.inch ) ( number 6 en.inch ) ) ) ) )	overnight-blocks
locate a block that is no wider than the height of block 1	( call SW.listValue ( call SW.filter ( call SW.getProperty ( call SW.singleton en.block ) ( string ! type ) ) ( call SW.ensureNumericProperty ( string width ) ) ( string <= ) ( call SW.ensureNumericEntity ( call SW.getProperty en.block.block1 ( string height ) ) ) ) )	overnight-blocks
block two above block 1	( call SW.listValue ( call SW.filter ( call SW.getProperty ( call SW.singleton en.block ) ( string ! type ) ) ( string above ) ( string = ) ( call SW.filter ( call SW.getProperty ( call SW.singleton en.block ) ( string ! type ) ) ( call SW.reverse ( string below ) ) ( string = ) en.block.block1 ) ) )	overnight-blocks
what block is below the special block	( call SW.listValue ( call SW.filter ( call SW.getProperty ( call SW.singleton en.block ) ( string ! type ) ) ( string below ) ( string = ) ( call SW.filter ( call SW.getProperty ( call SW.singleton en.block ) ( string ! type ) ) ( string is_special ) ) ) )	overnight-blocks
block that is below the most number of block	( call SW.listValue ( call SW.countSuperlative ( call SW.getProperty ( call SW.singleton en.block ) ( string ! type ) ) ( string max ) ( string below ) ( call SW.getProperty ( call SW.singleton en.block ) ( string ! type ) ) ) )	overnight-blocks
are there any blocks whose height is that of either 3 inches or 6 inches at most	( call SW.listValue ( call SW.filter ( call SW.getProperty ( call SW.singleton en.block ) ( string ! type ) ) ( call SW.ensureNumericProperty ( string height ) ) ( string <= ) ( call SW.ensureNumericEntity ( call SW.concat ( number 3 en.inch ) ( number 6 en.inch ) ) ) ) )	overnight-blocks
which brick is to the left of the brick that is 3 inches tall	( call SW.listValue ( call SW.filter ( call SW.getProperty ( call SW.singleton en.block ) ( string ! type ) ) ( string left ) ( string = ) ( call SW.filter ( call SW.getProperty ( call SW.singleton en.block ) ( string ! type ) ) ( string height ) ( string = ) ( number 3 en.inch ) ) ) )	overnight-blocks
find the block that has the smallest length	( call SW.listValue ( call SW.superlative ( call SW.getProperty ( call SW.singleton en.block ) ( string ! type ) ) ( string min ) ( call SW.ensureNumericProperty ( string length ) ) ) )	overnight-blocks
find a block 6 inches or shorter	( call SW.listValue ( call SW.filter ( call SW.getProperty ( call SW.singleton en.block ) ( string ! type ) ) ( call SW.ensureNumericProperty ( string height ) ) ( string <= ) ( call SW.ensureNumericEntity ( call SW.concat ( number 3 en.inch ) ( number 6 en.inch ) ) ) ) )	overnight-blocks
find the block that has a height that does not surpass the height of block 1	( call SW.listValue ( call SW.filter ( call SW.getProperty ( call SW.singleton en.block ) ( string ! type ) ) ( call SW.ensureNumericProperty ( string height ) ) ( string <= ) ( call SW.ensureNumericEntity ( call SW.getProperty en.block.block1 ( string height ) ) ) ) )	overnight-blocks
what block is unique and shaped like a pyramid	( call SW.listValue ( call SW.filter ( call SW.filter ( call SW.getProperty ( call SW.singleton en.block ) ( string ! type ) ) ( string is_special ) ) ( string shape ) ( string = ) en.shape.pyramid ) )	overnight-blocks
find the block that has the most blocks to its right	( call SW.listValue ( call SW.countSuperlative ( call SW.getProperty ( call SW.singleton en.block ) ( string ! type ) ) ( string max ) ( call SW.reverse ( string right ) ) ( call SW.getProperty ( call SW.singleton en.block ) ( string ! type ) ) ) )	overnight-blocks
find me all the blocks that are special	( call SW.listValue ( call SW.filter ( call SW.getProperty ( call SW.singleton en.block ) ( string ! type ) ) ( call SW.reverse ( string left ) ) ( string = ) ( call SW.filter ( call SW.getProperty ( call SW.singleton en.block ) ( string ! type ) ) ( string is_special ) ) ) )	overnight-blocks
which brick is no longer than brick 1 is wide	( call SW.listValue ( call SW.filter ( call SW.getProperty ( call SW.singleton en.block ) ( string ! type ) ) ( call SW.ensureNumericProperty ( string length ) ) ( string <= ) ( call SW.ensureNumericEntity ( call SW.getProperty en.block.block1 ( string width ) ) ) ) )	overnight-blocks
choose a block that is under block 1	( call SW.listValue ( call SW.filter ( call SW.filter ( call SW.getProperty ( call SW.singleton en.block ) ( string ! type ) ) ( string below ) ( string = ) en.block.block1 ) ( string below ) ( string = ) en.block.block1 ) )	overnight-blocks
find a block that is at least 3 to 6 inches	( call SW.listValue ( call SW.filter ( call SW.getProperty ( call SW.singleton en.block ) ( string ! type ) ) ( call SW.ensureNumericProperty ( string length ) ) ( string >= ) ( call SW.ensureNumericEntity ( call SW.concat ( number 3 en.inch ) ( number 6 en.inch ) ) ) ) )	overnight-blocks
2nd block right of block 1	( call SW.listValue ( call SW.filter ( call SW.getProperty ( call SW.singleton en.block ) ( string ! type ) ) ( call SW.reverse ( string right ) ) ( string = ) ( call SW.filter ( call SW.getProperty ( call SW.singleton en.block ) ( string ! type ) ) ( string right ) ( string = ) en.block.block1 ) ) )	overnight-blocks
block that is below block that is below block 1	( call SW.listValue ( call SW.filter ( call SW.getProperty ( call SW.singleton en.block ) ( string ! type ) ) ( string below ) ( string = ) ( call SW.filter ( call SW.getProperty ( call SW.singleton en.block ) ( string ! type ) ) ( string below ) ( string = ) en.block.block1 ) ) )	overnight-blocks
block that has at most two shape	( call SW.listValue ( call SW.countComparative ( call SW.getProperty ( call SW.singleton en.block ) ( string ! type ) ) ( string shape ) ( string <= ) ( number 2 ) ) )	overnight-blocks
find me all blocks taller than block 1	( call SW.listValue ( call SW.filter ( call SW.getProperty ( call SW.singleton en.block ) ( string ! type ) ) ( call SW.ensureNumericProperty ( string length ) ) ( string > ) ( call SW.ensureNumericEntity ( call SW.getProperty en.block.block1 ( string height ) ) ) ) )	overnight-blocks
block that is left of block that is below block 1	( call SW.listValue ( call SW.filter ( call SW.getProperty ( call SW.singleton en.block ) ( string ! type ) ) ( string left ) ( string = ) ( call SW.filter ( call SW.getProperty ( call SW.singleton en.block ) ( string ! type ) ) ( string below ) ( string = ) en.block.block1 ) ) )	overnight-blocks
which block has the shortest length	( call SW.listValue ( call SW.superlative ( call SW.getProperty ( call SW.singleton en.block ) ( string ! type ) ) ( string min ) ( call SW.ensureNumericProperty ( string length ) ) ) )	overnight-blocks
find the block located beneath the second block that is located to the left of block 1	( call SW.listValue ( call SW.filter ( call SW.getProperty ( call SW.singleton en.block ) ( string ! type ) ) ( string below ) ( string = ) ( call SW.filter ( call SW.getProperty ( call SW.singleton en.block ) ( string ! type ) ) ( string left ) ( string = ) en.block.block1 ) ) )	overnight-blocks
block two spaces above block 1	( call SW.listValue ( call SW.filter ( call SW.getProperty ( call SW.singleton en.block ) ( string ! type ) ) ( string above ) ( string = ) ( call SW.filter ( call SW.getProperty ( call SW.singleton en.block ) ( string ! type ) ) ( string above ) ( string = ) en.block.block1 ) ) )	overnight-blocks
choose the block that is below and to the left of block 1	( call SW.listValue ( call SW.filter ( call SW.getProperty ( call SW.singleton en.block ) ( string ! type ) ) ( string left ) ( string = ) ( call SW.filter ( call SW.getProperty ( call SW.singleton en.block ) ( string ! type ) ) ( string below ) ( string = ) en.block.block1 ) ) )	overnight-blocks
block which has block 1s below and right	( call SW.listValue ( call SW.filter ( call SW.filter ( call SW.getProperty ( call SW.singleton en.block ) ( string ! type ) ) ( call SW.reverse ( string below ) ) ( string = ) en.block.block1 ) ( string left ) ( string = ) en.block.block1 ) )	overnight-blocks
find me all blocks above block 1	( call SW.listValue ( call SW.filter ( call SW.filter ( call SW.getProperty ( call SW.singleton en.block ) ( string ! type ) ) ( string above ) ( string = ) en.block.block1 ) ( call SW.reverse ( string below ) ) ( string = ) en.block.block1 ) )	overnight-blocks
find me all 3 inch wide and long blocks	( call SW.listValue ( call SW.filter ( call SW.filter ( call SW.getProperty ( call SW.singleton en.block ) ( string ! type ) ) ( string width ) ( string = ) ( number 3 en.inch ) ) ( string length ) ( string = ) ( number 3 en.inch ) ) )	overnight-blocks
which one is a 3 inch special block	( call SW.listValue ( call SW.filter ( call SW.filter ( call SW.getProperty ( call SW.singleton en.block ) ( string ! type ) ) ( string is_special ) ) ( string width ) ( string = ) ( number 3 en.inch ) ) )	overnight-blocks
find a block whose width is three inches that block 1 is to the right of	( call SW.listValue ( call SW.filter ( call SW.filter ( call SW.getProperty ( call SW.singleton en.block ) ( string ! type ) ) ( call SW.reverse ( string right ) ) ( string = ) en.block.block1 ) ( string width ) ( string = ) ( number 3 en.inch ) ) )	overnight-blocks
find me all 3 or 6 inch long blocks	( call SW.listValue ( call SW.filter ( call SW.getProperty ( call SW.singleton en.block ) ( string ! type ) ) ( string length ) ( string = ) ( call SW.concat ( number 3 en.inch ) ( number 6 en.inch ) ) ) )	overnight-blocks
right of block 1 and block 2	( call SW.listValue ( call SW.filter ( call SW.getProperty ( call SW.singleton en.block ) ( string ! type ) ) ( call SW.reverse ( string left ) ) ( string = ) ( call SW.concat en.block.block1 en.block.block2 ) ) )	overnight-blocks
what is the width of the block	( call SW.listValue ( call SW.aggregate ( string sum ) ( call SW.getProperty ( call SW.getProperty ( call SW.singleton en.block ) ( string ! type ) ) ( string width ) ) ) )	overnight-blocks
find the block that is shorer than block 1	( call SW.listValue ( call SW.filter ( call SW.getProperty ( call SW.singleton en.block ) ( string ! type ) ) ( call SW.ensureNumericProperty ( string length ) ) ( string < ) ( call SW.ensureNumericEntity ( call SW.getProperty en.block.block1 ( string height ) ) ) ) )	overnight-blocks
find a block that block 1 is longer than	( call SW.listValue ( call SW.filter ( call SW.getProperty ( call SW.singleton en.block ) ( string ! type ) ) ( call SW.ensureNumericProperty ( string length ) ) ( string < ) ( call SW.ensureNumericEntity ( call SW.getProperty en.block.block1 ( string length ) ) ) ) )	overnight-blocks
find the block below and to the left of block 1	( call SW.listValue ( call SW.filter ( call SW.getProperty ( call SW.singleton en.block ) ( string ! type ) ) ( string left ) ( string = ) ( call SW.filter ( call SW.getProperty ( call SW.singleton en.block ) ( string ! type ) ) ( string below ) ( string = ) en.block.block1 ) ) )	overnight-blocks
select a block with a height of 1 block width	( call SW.listValue ( call SW.filter ( call SW.getProperty ( call SW.singleton en.block ) ( string ! type ) ) ( string height ) ( string = ) ( call SW.getProperty en.block.block1 ( string width ) ) ) )	overnight-blocks
select the pyramidshaped blocks	( call SW.listValue ( call SW.filter ( call SW.getProperty ( call SW.singleton en.block ) ( string ! type ) ) ( call SW.reverse ( string left ) ) ( string = ) ( call SW.filter ( call SW.getProperty ( call SW.singleton en.block ) ( string ! type ) ) ( string shape ) ( string = ) en.shape.pyramid ) ) )	overnight-blocks
block taller or same height as the width of block 1	( call SW.listValue ( call SW.filter ( call SW.getProperty ( call SW.singleton en.block ) ( string ! type ) ) ( call SW.ensureNumericProperty ( string height ) ) ( string >= ) ( call SW.ensureNumericEntity ( call SW.getProperty en.block.block1 ( string width ) ) ) ) )	overnight-blocks
find the block that block 1 is above and below	( call SW.listValue ( call SW.filter ( call SW.getProperty ( call SW.singleton en.block ) ( string ! type ) ) ( call SW.reverse ( string below ) ) ( string = ) ( call SW.filter ( call SW.getProperty ( call SW.singleton en.block ) ( string ! type ) ) ( call SW.reverse ( string above ) ) ( string = ) en.block.block1 ) ) )	overnight-blocks
what brick is no more than 3 inches high	( call SW.listValue ( call SW.filter ( call SW.getProperty ( call SW.singleton en.block ) ( string ! type ) ) ( call SW.ensureNumericProperty ( string height ) ) ( string <= ) ( call SW.ensureNumericEntity ( number 3 en.inch ) ) ) )	overnight-blocks
choose a block that is below and to the left of block 1	( call SW.listValue ( call SW.filter ( call SW.getProperty ( call SW.singleton en.block ) ( string ! type ) ) ( string below ) ( string = ) ( call SW.filter ( call SW.getProperty ( call SW.singleton en.block ) ( string ! type ) ) ( string left ) ( string = ) en.block.block1 ) ) )	overnight-blocks
what is the width of block 1	( call SW.listValue ( call SW.getProperty en.block.block1 ( string width ) ) )	overnight-blocks
what block has the shape of a pyramid and is to the left of block 1	( call SW.listValue ( call SW.filter ( call SW.filter ( call SW.getProperty ( call SW.singleton en.block ) ( string ! type ) ) ( string shape ) ( string = ) en.shape.pyramid ) ( string left ) ( string = ) en.block.block1 ) )	overnight-blocks
find me all blocks left of that block 1 is below	( call SW.listValue ( call SW.filter ( call SW.getProperty ( call SW.singleton en.block ) ( string ! type ) ) ( string left ) ( string = ) ( call SW.filter ( call SW.getProperty ( call SW.singleton en.block ) ( string ! type ) ) ( call SW.reverse ( string below ) ) ( string = ) en.block.block1 ) ) )	overnight-blocks
find me all special blocks that is right of block 1	( call SW.listValue ( call SW.filter ( call SW.filter ( call SW.getProperty ( call SW.singleton en.block ) ( string ! type ) ) ( string right ) ( string = ) en.block.block1 ) ( string is_special ) ) )	overnight-blocks
block that is above block whose width is 3 inches	( call SW.listValue ( call SW.filter ( call SW.getProperty ( call SW.singleton en.block ) ( string ! type ) ) ( string above ) ( string = ) ( call SW.filter ( call SW.getProperty ( call SW.singleton en.block ) ( string ! type ) ) ( string width ) ( string = ) ( number 3 en.inch ) ) ) )	overnight-blocks
what brick is to the right of the 3 inch brick	( call SW.listValue ( call SW.filter ( call SW.getProperty ( call SW.singleton en.block ) ( string ! type ) ) ( string right ) ( string = ) ( call SW.filter ( call SW.getProperty ( call SW.singleton en.block ) ( string ! type ) ) ( string length ) ( string = ) ( number 3 en.inch ) ) ) )	overnight-blocks
which block has the largest number of blocks to its left	( call SW.listValue ( call SW.countSuperlative ( call SW.getProperty ( call SW.singleton en.block ) ( string ! type ) ) ( string max ) ( call SW.reverse ( string left ) ) ( call SW.getProperty ( call SW.singleton en.block ) ( string ! type ) ) ) )	overnight-blocks
choose the brick that is 3 inches high below brick 1	( call SW.listValue ( call SW.filter ( call SW.filter ( call SW.getProperty ( call SW.singleton en.block ) ( string ! type ) ) ( string height ) ( string = ) ( number 3 en.inch ) ) ( string below ) ( string = ) en.block.block1 ) )	overnight-blocks
select the block that block 1 is not to the left of	( call SW.listValue ( call SW.filter ( call SW.getProperty ( call SW.singleton en.block ) ( string ! type ) ) ( call SW.reverse ( string left ) ) ( string ! = ) en.block.block1 ) )	overnight-blocks
block with pyramid shape at the right of block	( call SW.listValue ( call SW.filter ( call SW.getProperty ( call SW.singleton en.block ) ( string ! type ) ) ( string right ) ( string = ) ( call SW.filter ( call SW.getProperty ( call SW.singleton en.block ) ( string ! type ) ) ( string shape ) ( string = ) en.shape.pyramid ) ) )	overnight-blocks
find me all blocks above at most 2 blocks	( call SW.listValue ( call SW.countComparative ( call SW.getProperty ( call SW.singleton en.block ) ( string ! type ) ) ( string above ) ( string <= ) ( number 2 ) ( call SW.getProperty ( call SW.singleton en.block ) ( string ! type ) ) ) )	overnight-blocks
block to the left of block 1 thats 3 inches wide	( call SW.listValue ( call SW.filter ( call SW.filter ( call SW.getProperty ( call SW.singleton en.block ) ( string ! type ) ) ( call SW.reverse ( string left ) ) ( string = ) en.block.block1 ) ( string width ) ( string = ) ( number 3 en.inch ) ) )	overnight-blocks
what block is block one above and to the right of	( call SW.listValue ( call SW.filter ( call SW.filter ( call SW.getProperty ( call SW.singleton en.block ) ( string ! type ) ) ( call SW.reverse ( string above ) ) ( string = ) en.block.block1 ) ( call SW.reverse ( string right ) ) ( string = ) en.block.block1 ) )	overnight-blocks
block in block 1	( call SW.listValue ( call SW.filter ( call SW.filter ( call SW.getProperty ( call SW.singleton en.block ) ( string ! type ) ) ( call SW.reverse ( string right ) ) ( string = ) en.block.block1 ) ( call SW.reverse ( string left ) ) ( string = ) en.block.block1 ) )	overnight-blocks
select a block that has a length of more than 3 inches	( call SW.listValue ( call SW.filter ( call SW.getProperty ( call SW.singleton en.block ) ( string ! type ) ) ( call SW.ensureNumericProperty ( string length ) ) ( string > ) ( call SW.ensureNumericEntity ( number 3 en.inch ) ) ) )	overnight-blocks
which blocks have a height equal to the width of block 1	( call SW.listValue ( call SW.filter ( call SW.getProperty ( call SW.singleton en.block ) ( string ! type ) ) ( string height ) ( string = ) ( call SW.getProperty en.block.block1 ( string width ) ) ) )	overnight-blocks
which brick is to the left of brick 1	( call SW.listValue ( call SW.filter ( call SW.getProperty ( call SW.singleton en.block ) ( string ! type ) ) ( string left ) ( string = ) en.block.block1 ) )	overnight-blocks
a block that is 3 inches long	( call SW.listValue ( call SW.filter ( call SW.filter ( call SW.getProperty ( call SW.singleton en.block ) ( string ! type ) ) ( string length ) ( string = ) ( number 3 en.inch ) ) ( string length ) ( string = ) ( number 3 en.inch ) ) )	overnight-blocks
select the brick that has the least blocks to the left of it	( call SW.listValue ( call SW.countSuperlative ( call SW.getProperty ( call SW.singleton en.block ) ( string ! type ) ) ( string max ) ( string right ) ( call SW.getProperty ( call SW.singleton en.block ) ( string ! type ) ) ) )	overnight-blocks
block whose width is smaller than length of block 1	( call SW.listValue ( call SW.filter ( call SW.getProperty ( call SW.singleton en.block ) ( string ! type ) ) ( call SW.ensureNumericProperty ( string width ) ) ( string < ) ( call SW.ensureNumericEntity ( call SW.getProperty en.block.block1 ( string length ) ) ) ) )	overnight-blocks
find the block underneath block 1 that is also 3 inches long	( call SW.listValue ( call SW.filter ( call SW.filter ( call SW.getProperty ( call SW.singleton en.block ) ( string ! type ) ) ( string below ) ( string = ) en.block.block1 ) ( string length ) ( string = ) ( number 3 en.inch ) ) )	overnight-blocks
find the shortest block	( call SW.listValue ( call SW.superlative ( call SW.getProperty ( call SW.singleton en.block ) ( string ! type ) ) ( string min ) ( call SW.ensureNumericProperty ( string height ) ) ) )	overnight-blocks
find the block that block 1 is below	( call SW.listValue ( call SW.filter ( call SW.getProperty ( call SW.singleton en.block ) ( string ! type ) ) ( call SW.reverse ( string above ) ) ( string = ) ( call SW.filter ( call SW.getProperty ( call SW.singleton en.block ) ( string ! type ) ) ( call SW.reverse ( string below ) ) ( string = ) en.block.block1 ) ) )	overnight-blocks
block whose width is smaller than 3 inches or 6 inches	( call SW.listValue ( call SW.filter ( call SW.getProperty ( call SW.singleton en.block ) ( string ! type ) ) ( call SW.ensureNumericProperty ( string width ) ) ( string < ) ( call SW.ensureNumericEntity ( call SW.concat ( number 3 en.inch ) ( number 6 en.inch ) ) ) ) )	overnight-blocks
select the block to the right of block 1	( call SW.listValue ( call SW.filter ( call SW.getProperty ( call SW.singleton en.block ) ( string ! type ) ) ( string right ) ( string = ) en.block.block1 ) )	overnight-blocks
which block is closest to the bottom	( call SW.listValue ( call SW.countSuperlative ( call SW.getProperty ( call SW.singleton en.block ) ( string ! type ) ) ( string max ) ( call SW.reverse ( string above ) ) ( call SW.getProperty ( call SW.singleton en.block ) ( string ! type ) ) ) )	overnight-blocks
find blocks that are at least 3 inches wide or 6 inches wide	( call SW.listValue ( call SW.filter ( call SW.getProperty ( call SW.singleton en.block ) ( string ! type ) ) ( call SW.ensureNumericProperty ( string width ) ) ( string >= ) ( call SW.ensureNumericEntity ( call SW.concat ( number 3 en.inch ) ( number 6 en.inch ) ) ) ) )	overnight-blocks
find the block that is above block 1	( call SW.listValue ( call SW.filter ( call SW.getProperty ( call SW.singleton en.block ) ( string ! type ) ) ( call SW.reverse ( string above ) ) ( string = ) ( call SW.filter ( call SW.getProperty ( call SW.singleton en.block ) ( string ! type ) ) ( string above ) ( string = ) en.block.block1 ) ) )	overnight-blocks
find the block that block 1 is above	( call SW.listValue ( call SW.filter ( call SW.filter ( call SW.getProperty ( call SW.singleton en.block ) ( string ! type ) ) ( call SW.reverse ( string above ) ) ( string = ) en.block.block1 ) ( string above ) ( string = ) en.block.block1 ) )	overnight-blocks
choose a block that is 3 inches and shaped like a pyramid	( call SW.listValue ( call SW.filter ( call SW.filter ( call SW.getProperty ( call SW.singleton en.block ) ( string ! type ) ) ( string width ) ( string = ) ( number 3 en.inch ) ) ( string shape ) ( string = ) en.shape.pyramid ) )	overnight-blocks
what block is above two blocks	( call SW.listValue ( call SW.countComparative ( call SW.getProperty ( call SW.singleton en.block ) ( string ! type ) ) ( string above ) ( string = ) ( number 2 ) ( call SW.getProperty ( call SW.singleton en.block ) ( string ! type ) ) ) )	overnight-blocks
block wider than block 1	( call SW.listValue ( call SW.filter ( call SW.getProperty ( call SW.singleton en.block ) ( string ! type ) ) ( call SW.ensureNumericProperty ( string width ) ) ( string > ) ( call SW.ensureNumericEntity ( call SW.getProperty en.block.block1 ( string width ) ) ) ) )	overnight-blocks
locate block one or block 2	( call SW.listValue ( call SW.concat en.block.block1 en.block.block2 ) )	overnight-blocks
find me all blocks  with at most two blocks left of it	( call SW.listValue ( call SW.countComparative ( call SW.getProperty ( call SW.singleton en.block ) ( string ! type ) ) ( call SW.reverse ( string left ) ) ( string <= ) ( number 2 ) ( call SW.getProperty ( call SW.singleton en.block ) ( string ! type ) ) ) )	overnight-blocks
what block is special and has block 1 on its right	( call SW.listValue ( call SW.filter ( call SW.filter ( call SW.getProperty ( call SW.singleton en.block ) ( string ! type ) ) ( string is_special ) ) ( call SW.reverse ( string right ) ) ( string = ) en.block.block1 ) )	overnight-blocks
choose a 3 inch block that is left of block 1	( call SW.listValue ( call SW.filter ( call SW.filter ( call SW.getProperty ( call SW.singleton en.block ) ( string ! type ) ) ( string left ) ( string = ) en.block.block1 ) ( string length ) ( string = ) ( number 3 en.inch ) ) )	overnight-blocks
what block is longer than 3 inches	( call SW.listValue ( call SW.filter ( call SW.getProperty ( call SW.singleton en.block ) ( string ! type ) ) ( call SW.ensureNumericProperty ( string length ) ) ( string > ) ( call SW.ensureNumericEntity ( number 3 en.inch ) ) ) )	overnight-blocks
find me all blocks right of that block 1 is above	( call SW.listValue ( call SW.filter ( call SW.getProperty ( call SW.singleton en.block ) ( string ! type ) ) ( string right ) ( string = ) ( call SW.filter ( call SW.getProperty ( call SW.singleton en.block ) ( string ! type ) ) ( call SW.reverse ( string above ) ) ( string = ) en.block.block1 ) ) )	overnight-blocks
block that is left of block that is left of block 1	( call SW.listValue ( call SW.filter ( call SW.getProperty ( call SW.singleton en.block ) ( string ! type ) ) ( string left ) ( string = ) ( call SW.filter ( call SW.getProperty ( call SW.singleton en.block ) ( string ! type ) ) ( string left ) ( string = ) en.block.block1 ) ) )	overnight-blocks
select the block that is to the left and above block 1	( call SW.listValue ( call SW.filter ( call SW.filter ( call SW.getProperty ( call SW.singleton en.block ) ( string ! type ) ) ( string left ) ( string = ) en.block.block1 ) ( string above ) ( string = ) en.block.block1 ) )	overnight-blocks
find me all the blocks that is not a pyramid	( call SW.listValue ( call SW.filter ( call SW.getProperty ( call SW.singleton en.block ) ( string ! type ) ) ( string shape ) ( string ! = ) en.shape.pyramid ) )	overnight-blocks
block whose width is width of block 1	( call SW.listValue ( call SW.filter ( call SW.getProperty ( call SW.singleton en.block ) ( string ! type ) ) ( string width ) ( string = ) ( call SW.getProperty en.block.block1 ( string width ) ) ) )	overnight-blocks
what brick has no more than two bricks to its left	( call SW.listValue ( call SW.countComparative ( call SW.getProperty ( call SW.singleton en.block ) ( string ! type ) ) ( call SW.reverse ( string left ) ) ( string <= ) ( number 2 ) ( call SW.getProperty ( call SW.singleton en.block ) ( string ! type ) ) ) )	overnight-blocks
which brick is below a brick that is 3 inches wide	( call SW.listValue ( call SW.filter ( call SW.getProperty ( call SW.singleton en.block ) ( string ! type ) ) ( string below ) ( string = ) ( call SW.filter ( call SW.getProperty ( call SW.singleton en.block ) ( string ! type ) ) ( string width ) ( string = ) ( number 3 en.inch ) ) ) )	overnight-blocks
what blocks are left of block 1	( call SW.listValue ( call SW.filter ( call SW.filter ( call SW.getProperty ( call SW.singleton en.block ) ( string ! type ) ) ( string left ) ( string = ) en.block.block1 ) ( string left ) ( string = ) en.block.block1 ) )	overnight-blocks
find me all blocks underneath at least 2 blocks	( call SW.listValue ( call SW.countComparative ( call SW.getProperty ( call SW.singleton en.block ) ( string ! type ) ) ( string below ) ( string > ) ( number 2 ) ( call SW.getProperty ( call SW.singleton en.block ) ( string ! type ) ) ) )	overnight-blocks
what brick is at least 3 or 6 inches	( call SW.listValue ( call SW.concat ( number 3 en.inch ) ( number 6 en.inch ) ) )	overnight-blocks
find me all blocks with at most 2 colors	( call SW.listValue ( call SW.countComparative ( call SW.getProperty ( call SW.singleton en.block ) ( string ! type ) ) ( string color ) ( string <= ) ( number 2 ) ) )	overnight-blocks
find me all pyramid blocks that block 1 is below	( call SW.listValue ( call SW.filter ( call SW.filter ( call SW.getProperty ( call SW.singleton en.block ) ( string ! type ) ) ( call SW.reverse ( string below ) ) ( string = ) en.block.block1 ) ( string shape ) ( string = ) en.shape.pyramid ) )	overnight-blocks
which brick is above a brick that is 3 inches wide	( call SW.listValue ( call SW.filter ( call SW.getProperty ( call SW.singleton en.block ) ( string ! type ) ) ( string above ) ( string = ) ( call SW.filter ( call SW.getProperty ( call SW.singleton en.block ) ( string ! type ) ) ( string width ) ( string = ) ( number 3 en.inch ) ) ) )	overnight-blocks
choose a block that is bigger than block 1	( call SW.listValue ( call SW.filter ( call SW.getProperty ( call SW.singleton en.block ) ( string ! type ) ) ( call SW.ensureNumericProperty ( string width ) ) ( string > ) ( call SW.ensureNumericEntity ( call SW.getProperty en.block.block1 ( string length ) ) ) ) )	overnight-blocks
block that is right of at most two block	( call SW.listValue ( call SW.countComparative ( call SW.getProperty ( call SW.singleton en.block ) ( string ! type ) ) ( string right ) ( string <= ) ( number 2 ) ( call SW.getProperty ( call SW.singleton en.block ) ( string ! type ) ) ) )	overnight-blocks
find me all blocks right and below block 1	( call SW.listValue ( call SW.filter ( call SW.getProperty ( call SW.singleton en.block ) ( string ! type ) ) ( call SW.reverse ( string below ) ) ( string = ) ( call SW.filter ( call SW.getProperty ( call SW.singleton en.block ) ( string ! type ) ) ( string right ) ( string = ) en.block.block1 ) ) )	overnight-blocks
find me all the blocks as long as block 1	( call SW.listValue ( call SW.filter ( call SW.getProperty ( call SW.singleton en.block ) ( string ! type ) ) ( string length ) ( string = ) ( call SW.getProperty en.block.block1 ( string length ) ) ) )	overnight-blocks
block above 3 inch tall block	( call SW.listValue ( call SW.filter ( call SW.getProperty ( call SW.singleton en.block ) ( string ! type ) ) ( call SW.reverse ( string below ) ) ( string = ) ( call SW.filter ( call SW.getProperty ( call SW.singleton en.block ) ( string ! type ) ) ( string height ) ( string = ) ( number 3 en.inch ) ) ) )	overnight-blocks
3 inch tall bock below block 1	( call SW.listValue ( call SW.filter ( call SW.filter ( call SW.getProperty ( call SW.singleton en.block ) ( string ! type ) ) ( call SW.reverse ( string above ) ) ( string = ) en.block.block1 ) ( string height ) ( string = ) ( number 3 en.inch ) ) )	overnight-blocks
select the brick that has the least blocks to the right of it	( call SW.listValue ( call SW.countSuperlative ( call SW.getProperty ( call SW.singleton en.block ) ( string ! type ) ) ( string min ) ( string left ) ( call SW.getProperty ( call SW.singleton en.block ) ( string ! type ) ) ) )	overnight-blocks
which special block is 3 inches wide	( call SW.listValue ( call SW.filter ( call SW.filter ( call SW.getProperty ( call SW.singleton en.block ) ( string ! type ) ) ( string is_special ) ) ( string width ) ( string = ) ( number 3 en.inch ) ) )	overnight-blocks
what is the total width of the brick	( call SW.listValue ( call SW.aggregate ( string sum ) ( call SW.getProperty ( call SW.getProperty ( call SW.singleton en.block ) ( string ! type ) ) ( string width ) ) ) )	overnight-blocks
what block is to the right and above block 1	( call SW.listValue ( call SW.filter ( call SW.filter ( call SW.getProperty ( call SW.singleton en.block ) ( string ! type ) ) ( string right ) ( string = ) en.block.block1 ) ( call SW.reverse ( string above ) ) ( string = ) en.block.block1 ) )	overnight-blocks
block that has the smallest height	( call SW.listValue ( call SW.superlative ( call SW.getProperty ( call SW.singleton en.block ) ( string ! type ) ) ( string min ) ( call SW.ensureNumericProperty ( string height ) ) ) )	overnight-blocks
find the block that is 3 inches in height and is on the right side of block 1	( call SW.listValue ( call SW.filter ( call SW.filter ( call SW.getProperty ( call SW.singleton en.block ) ( string ! type ) ) ( string height ) ( string = ) ( number 3 en.inch ) ) ( string right ) ( string = ) en.block.block1 ) )	overnight-blocks
what blocks are above the block that is to the right of block 1	( call SW.listValue ( call SW.filter ( call SW.getProperty ( call SW.singleton en.block ) ( string ! type ) ) ( string above ) ( string = ) ( call SW.filter ( call SW.getProperty ( call SW.singleton en.block ) ( string ! type ) ) ( call SW.reverse ( string right ) ) ( string = ) en.block.block1 ) ) )	overnight-blocks
find me a block as wide as block 1 or wider	( call SW.listValue ( call SW.filter ( call SW.getProperty ( call SW.singleton en.block ) ( string ! type ) ) ( call SW.ensureNumericProperty ( string width ) ) ( string >= ) ( call SW.ensureNumericEntity ( call SW.getProperty en.block.block1 ( string width ) ) ) ) )	overnight-blocks
find me all blocks that above and below block 1	( call SW.listValue ( call SW.filter ( call SW.filter ( call SW.getProperty ( call SW.singleton en.block ) ( string ! type ) ) ( call SW.reverse ( string above ) ) ( string = ) en.block.block1 ) ( call SW.reverse ( string below ) ) ( string = ) en.block.block1 ) )	overnight-blocks
block above the block at right of block 1	( call SW.listValue ( call SW.filter ( call SW.getProperty ( call SW.singleton en.block ) ( string ! type ) ) ( string above ) ( string = ) ( call SW.filter ( call SW.getProperty ( call SW.singleton en.block ) ( string ! type ) ) ( call SW.reverse ( string left ) ) ( string = ) en.block.block1 ) ) )	overnight-blocks
get a block to the left of block 1 or block 2	( call SW.listValue ( call SW.filter ( call SW.getProperty ( call SW.singleton en.block ) ( string ! type ) ) ( call SW.reverse ( string right ) ) ( string = ) ( call SW.concat en.block.block1 en.block.block2 ) ) )	overnight-blocks
find a block left of and below block 1	( call SW.listValue ( call SW.filter ( call SW.filter ( call SW.getProperty ( call SW.singleton en.block ) ( string ! type ) ) ( string left ) ( string = ) en.block.block1 ) ( call SW.reverse ( string above ) ) ( string = ) en.block.block1 ) )	overnight-blocks
block above and right from block 1	( call SW.listValue ( call SW.filter ( call SW.filter ( call SW.getProperty ( call SW.singleton en.block ) ( string ! type ) ) ( string above ) ( string = ) en.block.block1 ) ( string right ) ( string = ) en.block.block1 ) )	overnight-blocks
find me all blocks right of the block that block 1 is below	( call SW.listValue ( call SW.filter ( call SW.getProperty ( call SW.singleton en.block ) ( string ! type ) ) ( string right ) ( string = ) ( call SW.filter ( call SW.getProperty ( call SW.singleton en.block ) ( string ! type ) ) ( call SW.reverse ( string below ) ) ( string = ) en.block.block1 ) ) )	overnight-blocks
pyramid block left of block 1	( call SW.listValue ( call SW.filter ( call SW.filter ( call SW.getProperty ( call SW.singleton en.block ) ( string ! type ) ) ( call SW.reverse ( string right ) ) ( string = ) en.block.block1 ) ( string shape ) ( string = ) en.shape.pyramid ) )	overnight-blocks
what block is left of block 1 and 3 inches in length	( call SW.listValue ( call SW.filter ( call SW.filter ( call SW.getProperty ( call SW.singleton en.block ) ( string ! type ) ) ( string length ) ( string = ) ( number 3 en.inch ) ) ( call SW.reverse ( string left ) ) ( string = ) en.block.block1 ) )	overnight-blocks
block below two other blocks	( call SW.listValue ( call SW.countComparative ( call SW.getProperty ( call SW.singleton en.block ) ( string ! type ) ) ( string below ) ( string >= ) ( number 2 ) ( call SW.getProperty ( call SW.singleton en.block ) ( string ! type ) ) ) )	overnight-blocks
find pyramid shaped block below block 1	( call SW.listValue ( call SW.filter ( call SW.filter ( call SW.getProperty ( call SW.singleton en.block ) ( string ! type ) ) ( string shape ) ( string = ) en.shape.pyramid ) ( string below ) ( string = ) en.block.block1 ) )	overnight-blocks
3 inches long block and that is above block 1	( call SW.listValue ( call SW.filter ( call SW.filter ( call SW.getProperty ( call SW.singleton en.block ) ( string ! type ) ) ( string length ) ( string = ) ( number 3 en.inch ) ) ( call SW.reverse ( string above ) ) ( string = ) en.block.block1 ) )	overnight-blocks
find a block to the right of a block 3 in height	( call SW.listValue ( call SW.filter ( call SW.getProperty ( call SW.singleton en.block ) ( string ! type ) ) ( call SW.reverse ( string right ) ) ( string = ) ( call SW.filter ( call SW.getProperty ( call SW.singleton en.block ) ( string ! type ) ) ( string height ) ( string = ) ( number 3 en.inch ) ) ) )	overnight-blocks
select all which is 3 inches in width and pyramid in shape	( call SW.listValue ( call SW.filter ( call SW.filter ( call SW.getProperty ( call SW.singleton en.block ) ( string ! type ) ) ( string width ) ( string = ) ( number 3 en.inch ) ) ( string shape ) ( string = ) en.shape.pyramid ) )	overnight-blocks
what block is on the left of block 1 and is 3 inches in width	( call SW.listValue ( call SW.filter ( call SW.filter ( call SW.getProperty ( call SW.singleton en.block ) ( string ! type ) ) ( string left ) ( string = ) en.block.block1 ) ( string width ) ( string = ) ( number 3 en.inch ) ) )	overnight-blocks
find the special block with block 1 below it	( call SW.listValue ( call SW.filter ( call SW.filter ( call SW.getProperty ( call SW.singleton en.block ) ( string ! type ) ) ( string above ) ( string = ) en.block.block1 ) ( string is_special ) ) )	overnight-blocks
block that is shorter than block 1	( call SW.listValue ( call SW.filter ( call SW.getProperty ( call SW.singleton en.block ) ( string ! type ) ) ( call SW.ensureNumericProperty ( string length ) ) ( string < ) ( call SW.ensureNumericEntity ( call SW.getProperty en.block.block1 ( string length ) ) ) ) )	overnight-blocks
find me all 3 inch tall blocks that block 1 is right of	( call SW.listValue ( call SW.filter ( call SW.filter ( call SW.getProperty ( call SW.singleton en.block ) ( string ! type ) ) ( string height ) ( string = ) ( number 3 en.inch ) ) ( call SW.reverse ( string right ) ) ( string = ) en.block.block1 ) )	overnight-blocks
find me all blocks at most as wide as block 1	( call SW.listValue ( call SW.filter ( call SW.getProperty ( call SW.singleton en.block ) ( string ! type ) ) ( call SW.ensureNumericProperty ( string width ) ) ( string <= ) ( call SW.ensureNumericEntity ( call SW.getProperty en.block.block1 ( string length ) ) ) ) )	overnight-blocks
pyramid block rght of block 1	( call SW.listValue ( call SW.filter ( call SW.filter ( call SW.getProperty ( call SW.singleton en.block ) ( string ! type ) ) ( string right ) ( string = ) en.block.block1 ) ( string shape ) ( string = ) en.shape.pyramid ) )	overnight-blocks
find me all blocks that is right of block 1	( call SW.listValue ( call SW.filter ( call SW.getProperty ( call SW.singleton en.block ) ( string ! type ) ) ( call SW.reverse ( string right ) ) ( string = ) ( call SW.filter ( call SW.getProperty ( call SW.singleton en.block ) ( string ! type ) ) ( string right ) ( string = ) en.block.block1 ) ) )	overnight-blocks
what pyramidshaped block is left of block 1	( call SW.listValue ( call SW.filter ( call SW.filter ( call SW.getProperty ( call SW.singleton en.block ) ( string ! type ) ) ( string shape ) ( string = ) en.shape.pyramid ) ( string left ) ( string = ) en.block.block1 ) )	overnight-blocks
what block is to the left of block one	( call SW.listValue ( call SW.filter ( call SW.filter ( call SW.getProperty ( call SW.singleton en.block ) ( string ! type ) ) ( string left ) ( string = ) en.block.block1 ) ( string left ) ( string = ) en.block.block1 ) )	overnight-blocks
select a block that has the same width and height	( call SW.listValue ( call SW.filter ( call SW.getProperty ( call SW.singleton en.block ) ( string ! type ) ) ( string height ) ( string = ) ( call SW.getProperty en.block.block1 ( string width ) ) ) )	overnight-blocks
which brick is below the brick to the right of brick 1	( call SW.listValue ( call SW.filter ( call SW.getProperty ( call SW.singleton en.block ) ( string ! type ) ) ( string below ) ( string = ) ( call SW.filter ( call SW.getProperty ( call SW.singleton en.block ) ( string ! type ) ) ( string right ) ( string = ) en.block.block1 ) ) )	overnight-blocks
find me all blocks that is right of more than 2 blocks	( call SW.listValue ( call SW.countComparative ( call SW.getProperty ( call SW.singleton en.block ) ( string ! type ) ) ( string right ) ( string > ) ( number 2 ) ( call SW.getProperty ( call SW.singleton en.block ) ( string ! type ) ) ) )	overnight-blocks
select the block that block 1 is to the left and above	( call SW.listValue ( call SW.filter ( call SW.getProperty ( call SW.singleton en.block ) ( string ! type ) ) ( call SW.reverse ( string above ) ) ( string = ) ( call SW.filter ( call SW.getProperty ( call SW.singleton en.block ) ( string ! type ) ) ( call SW.reverse ( string left ) ) ( string = ) en.block.block1 ) ) )	overnight-blocks
is there a block piled on top of either block 1 or block 2	( call SW.listValue ( call SW.filter ( call SW.getProperty ( call SW.singleton en.block ) ( string ! type ) ) ( string above ) ( string = ) ( call SW.concat en.block.block1 en.block.block2 ) ) )	overnight-blocks
block two below block 1	( call SW.listValue ( call SW.filter ( call SW.getProperty ( call SW.singleton en.block ) ( string ! type ) ) ( call SW.reverse ( string below ) ) ( string = ) ( call SW.filter ( call SW.getProperty ( call SW.singleton en.block ) ( string ! type ) ) ( call SW.reverse ( string above ) ) ( string = ) en.block.block1 ) ) )	overnight-blocks
what special block is above block 1	( call SW.listValue ( call SW.filter ( call SW.filter ( call SW.getProperty ( call SW.singleton en.block ) ( string ! type ) ) ( string is_special ) ) ( string above ) ( string = ) en.block.block1 ) )	overnight-blocks
what is the block below and left of block 1	( call SW.listValue ( call SW.filter ( call SW.getProperty ( call SW.singleton en.block ) ( string ! type ) ) ( call SW.reverse ( string left ) ) ( string = ) ( call SW.filter ( call SW.getProperty ( call SW.singleton en.block ) ( string ! type ) ) ( call SW.reverse ( string above ) ) ( string = ) en.block.block1 ) ) )	overnight-blocks
what block has less than two blocks to the right of it	( call SW.listValue ( call SW.countComparative ( call SW.getProperty ( call SW.singleton en.block ) ( string ! type ) ) ( string left ) ( string < ) ( number 2 ) ( call SW.getProperty ( call SW.singleton en.block ) ( string ! type ) ) ) )	overnight-blocks
3 inch wide block above block 1	( call SW.listValue ( call SW.filter ( call SW.filter ( call SW.getProperty ( call SW.singleton en.block ) ( string ! type ) ) ( call SW.reverse ( string below ) ) ( string = ) en.block.block1 ) ( string width ) ( string = ) ( number 3 en.inch ) ) )	overnight-blocks
find me all blocks with less than 2 blocks below it	( call SW.listValue ( call SW.countComparative ( call SW.getProperty ( call SW.singleton en.block ) ( string ! type ) ) ( call SW.reverse ( string below ) ) ( string < ) ( number 2 ) ( call SW.getProperty ( call SW.singleton en.block ) ( string ! type ) ) ) )	overnight-blocks
2 blocks below block 1	( call SW.listValue ( call SW.filter ( call SW.getProperty ( call SW.singleton en.block ) ( string ! type ) ) ( call SW.reverse ( string below ) ) ( string = ) ( call SW.filter ( call SW.getProperty ( call SW.singleton en.block ) ( string ! type ) ) ( string below ) ( string = ) en.block.block1 ) ) )	overnight-blocks
find the block whose height is 3 inches	( call SW.listValue ( call SW.filter ( call SW.filter ( call SW.getProperty ( call SW.singleton en.block ) ( string ! type ) ) ( string height ) ( string = ) ( number 3 en.inch ) ) ( call SW.reverse ( string right ) ) ( string = ) en.block.block1 ) )	overnight-blocks
which block is above and to left of block 1 	( call SW.listValue ( call SW.filter ( call SW.filter ( call SW.getProperty ( call SW.singleton en.block ) ( string ! type ) ) ( call SW.reverse ( string left ) ) ( string = ) en.block.block1 ) ( string above ) ( string = ) en.block.block1 ) )	overnight-blocks
is there a block to the right of block 1 and to the left of block 1	( call SW.listValue ( call SW.filter ( call SW.filter ( call SW.getProperty ( call SW.singleton en.block ) ( string ! type ) ) ( call SW.reverse ( string left ) ) ( string = ) en.block.block1 ) ( string left ) ( string = ) en.block.block1 ) )	overnight-blocks
block which is at the left of the block below block 1	( call SW.listValue ( call SW.filter ( call SW.getProperty ( call SW.singleton en.block ) ( string ! type ) ) ( string left ) ( string = ) ( call SW.filter ( call SW.getProperty ( call SW.singleton en.block ) ( string ! type ) ) ( call SW.reverse ( string above ) ) ( string = ) en.block.block1 ) ) )	overnight-blocks
select the special block to the right of block 1	( call SW.listValue ( call SW.filter ( call SW.filter ( call SW.getProperty ( call SW.singleton en.block ) ( string ! type ) ) ( call SW.reverse ( string left ) ) ( string = ) en.block.block1 ) ( string is_special ) ) )	overnight-blocks
what block is to the left of the block that is to the right of block 1	( call SW.listValue ( call SW.filter ( call SW.getProperty ( call SW.singleton en.block ) ( string ! type ) ) ( string left ) ( string = ) ( call SW.filter ( call SW.getProperty ( call SW.singleton en.block ) ( string ! type ) ) ( string right ) ( string = ) en.block.block1 ) ) )	overnight-blocks
what color is block 1	( call SW.listValue ( call SW.getProperty en.block.block1 ( string color ) ) )	overnight-blocks
block two above block 1	( call SW.listValue ( call SW.filter ( call SW.getProperty ( call SW.singleton en.block ) ( string ! type ) ) ( call SW.reverse ( string above ) ) ( string = ) ( call SW.filter ( call SW.getProperty ( call SW.singleton en.block ) ( string ! type ) ) ( string above ) ( string = ) en.block.block1 ) ) )	overnight-blocks
select a block who has width greater than or equal to block 1s height	( call SW.listValue ( call SW.filter ( call SW.getProperty ( call SW.singleton en.block ) ( string ! type ) ) ( call SW.ensureNumericProperty ( string width ) ) ( string >= ) ( call SW.ensureNumericEntity ( call SW.getProperty en.block.block1 ( string height ) ) ) ) )	overnight-blocks
select the block on the right side of block 1	( call SW.listValue ( call SW.filter ( call SW.filter ( call SW.getProperty ( call SW.singleton en.block ) ( string ! type ) ) ( string right ) ( string = ) en.block.block1 ) ( call SW.reverse ( string left ) ) ( string = ) en.block.block1 ) )	overnight-blocks
left of block 1	( call SW.listValue ( call SW.filter ( call SW.filter ( call SW.getProperty ( call SW.singleton en.block ) ( string ! type ) ) ( call SW.reverse ( string right ) ) ( string = ) en.block.block1 ) ( call SW.reverse ( string right ) ) ( string = ) en.block.block1 ) )	overnight-blocks
find me all blocks right to whatever block 1 is left of	( call SW.listValue ( call SW.filter ( call SW.getProperty ( call SW.singleton en.block ) ( string ! type ) ) ( string right ) ( string = ) ( call SW.filter ( call SW.getProperty ( call SW.singleton en.block ) ( string ! type ) ) ( call SW.reverse ( string left ) ) ( string = ) en.block.block1 ) ) )	overnight-blocks
find a block wider than block 1 is tall	( call SW.listValue ( call SW.filter ( call SW.getProperty ( call SW.singleton en.block ) ( string ! type ) ) ( call SW.ensureNumericProperty ( string width ) ) ( string > ) ( call SW.ensureNumericEntity ( call SW.getProperty en.block.block1 ( string height ) ) ) ) )	overnight-blocks
find a block below and to the right of block 1	( call SW.listValue ( call SW.filter ( call SW.getProperty ( call SW.singleton en.block ) ( string ! type ) ) ( string right ) ( string = ) ( call SW.filter ( call SW.getProperty ( call SW.singleton en.block ) ( string ! type ) ) ( string below ) ( string = ) en.block.block1 ) ) )	overnight-blocks
find me all the blocks two blocks left of block 1	( call SW.listValue ( call SW.filter ( call SW.getProperty ( call SW.singleton en.block ) ( string ! type ) ) ( string left ) ( string = ) ( call SW.filter ( call SW.getProperty ( call SW.singleton en.block ) ( string ! type ) ) ( string left ) ( string = ) en.block.block1 ) ) )	overnight-blocks
what block is at least 3 inches wide	( call SW.listValue ( call SW.filter ( call SW.getProperty ( call SW.singleton en.block ) ( string ! type ) ) ( call SW.ensureNumericProperty ( string width ) ) ( string >= ) ( call SW.ensureNumericEntity ( number 3 en.inch ) ) ) )	overnight-blocks
find the total height of the blocks	( call SW.listValue ( call SW.aggregate ( string sum ) ( call SW.getProperty ( call SW.getProperty ( call SW.singleton en.block ) ( string ! type ) ) ( string height ) ) ) )	overnight-blocks
select the blocks above block 1 and 2	( call SW.listValue ( call SW.filter ( call SW.getProperty ( call SW.singleton en.block ) ( string ! type ) ) ( call SW.reverse ( string below ) ) ( string = ) ( call SW.concat en.block.block1 en.block.block2 ) ) )	overnight-blocks
a pyramid shaped block	( call SW.listValue ( call SW.filter ( call SW.filter ( call SW.getProperty ( call SW.singleton en.block ) ( string ! type ) ) ( string shape ) ( string = ) en.shape.pyramid ) ( string shape ) ( string = ) en.shape.pyramid ) )	overnight-blocks
block two right from block 1	( call SW.listValue ( call SW.filter ( call SW.getProperty ( call SW.singleton en.block ) ( string ! type ) ) ( call SW.reverse ( string right ) ) ( string = ) ( call SW.filter ( call SW.getProperty ( call SW.singleton en.block ) ( string ! type ) ) ( string right ) ( string = ) en.block.block1 ) ) )	overnight-blocks
what 3 inch brick is to the right of brick 1	( call SW.listValue ( call SW.filter ( call SW.filter ( call SW.getProperty ( call SW.singleton en.block ) ( string ! type ) ) ( string right ) ( string = ) en.block.block1 ) ( string length ) ( string = ) ( number 3 en.inch ) ) )	overnight-blocks
find me all blocks as wide or wider than block 1	( call SW.listValue ( call SW.filter ( call SW.getProperty ( call SW.singleton en.block ) ( string ! type ) ) ( call SW.ensureNumericProperty ( string width ) ) ( string >= ) ( call SW.ensureNumericEntity ( call SW.getProperty en.block.block1 ( string length ) ) ) ) )	overnight-blocks
what brick is at least as high as brick 1	( call SW.listValue ( call SW.filter ( call SW.getProperty ( call SW.singleton en.block ) ( string ! type ) ) ( call SW.ensureNumericProperty ( string height ) ) ( string >= ) ( call SW.ensureNumericEntity ( call SW.getProperty en.block.block1 ( string height ) ) ) ) )	overnight-blocks
what block has height less than or equal to the length of block 1	( call SW.listValue ( call SW.filter ( call SW.getProperty ( call SW.singleton en.block ) ( string ! type ) ) ( call SW.ensureNumericProperty ( string height ) ) ( string <= ) ( call SW.ensureNumericEntity ( call SW.getProperty en.block.block1 ( string length ) ) ) ) )	overnight-blocks
which brick is the same shape as brick 1	( call SW.listValue ( call SW.filter ( call SW.getProperty ( call SW.singleton en.block ) ( string ! type ) ) ( string shape ) ( string = ) ( call SW.getProperty en.block.block1 ( string shape ) ) ) )	overnight-blocks
find me all blocks left of block 1 or 2	( call SW.listValue ( call SW.filter ( call SW.getProperty ( call SW.singleton en.block ) ( string ! type ) ) ( string left ) ( string = ) ( call SW.concat en.block.block1 en.block.block2 ) ) )	overnight-blocks
which brick is 3 inches wide and 3 inches high	( call SW.listValue ( call SW.filter ( call SW.filter ( call SW.getProperty ( call SW.singleton en.block ) ( string ! type ) ) ( string height ) ( string = ) ( number 3 en.inch ) ) ( string width ) ( string = ) ( number 3 en.inch ) ) )	overnight-blocks
which block is below block 1 that is at least 3 inches high	( call SW.listValue ( call SW.filter ( call SW.filter ( call SW.getProperty ( call SW.singleton en.block ) ( string ! type ) ) ( string below ) ( string = ) en.block.block1 ) ( string width ) ( string = ) ( number 3 en.inch ) ) )	overnight-blocks
select the block on the left side of block 1	( call SW.listValue ( call SW.filter ( call SW.filter ( call SW.getProperty ( call SW.singleton en.block ) ( string ! type ) ) ( call SW.reverse ( string right ) ) ( string = ) en.block.block1 ) ( call SW.reverse ( string right ) ) ( string = ) en.block.block1 ) )	overnight-blocks
locate the block with a length that exceeds the width of block 1	( call SW.listValue ( call SW.filter ( call SW.getProperty ( call SW.singleton en.block ) ( string ! type ) ) ( call SW.ensureNumericProperty ( string length ) ) ( string > ) ( call SW.ensureNumericEntity ( call SW.getProperty en.block.block1 ( string width ) ) ) ) )	overnight-blocks
find me all the blocks taller than 3 inches	( call SW.listValue ( call SW.filter ( call SW.getProperty ( call SW.singleton en.block ) ( string ! type ) ) ( call SW.ensureNumericProperty ( string height ) ) ( string > ) ( call SW.ensureNumericEntity ( call SW.concat ( number 3 en.inch ) ( number 6 en.inch ) ) ) ) )	overnight-blocks
find me all the blocks right of block 1	( call SW.listValue ( call SW.filter ( call SW.getProperty ( call SW.singleton en.block ) ( string ! type ) ) ( string right ) ( string = ) en.block.block1 ) )	overnight-blocks
find the block that has a height of 3 inches and that block 1 is to the right of	( call SW.listValue ( call SW.filter ( call SW.filter ( call SW.getProperty ( call SW.singleton en.block ) ( string ! type ) ) ( string height ) ( string = ) ( number 3 en.inch ) ) ( call SW.reverse ( string right ) ) ( string = ) en.block.block1 ) )	overnight-blocks
which block is below the block below block 1	( call SW.listValue ( call SW.filter ( call SW.getProperty ( call SW.singleton en.block ) ( string ! type ) ) ( call SW.reverse ( string below ) ) ( string = ) ( call SW.filter ( call SW.getProperty ( call SW.singleton en.block ) ( string ! type ) ) ( call SW.reverse ( string above ) ) ( string = ) en.block.block1 ) ) )	overnight-blocks
find me all blocks left of more than 2 blocks	( call SW.listValue ( call SW.countComparative ( call SW.getProperty ( call SW.singleton en.block ) ( string ! type ) ) ( string left ) ( string > ) ( number 2 ) ( call SW.getProperty ( call SW.singleton en.block ) ( string ! type ) ) ) )	overnight-blocks
block of height not more than width of block 1	( call SW.listValue ( call SW.filter ( call SW.getProperty ( call SW.singleton en.block ) ( string ! type ) ) ( call SW.ensureNumericProperty ( string height ) ) ( string <= ) ( call SW.ensureNumericEntity ( call SW.getProperty en.block.block1 ( string width ) ) ) ) )	overnight-blocks
what block is as long as block 1 is wide	( call SW.listValue ( call SW.filter ( call SW.getProperty ( call SW.singleton en.block ) ( string ! type ) ) ( string length ) ( string = ) ( call SW.getProperty en.block.block1 ( string width ) ) ) )	overnight-blocks
select the block that is to the left of two or more blocks	( call SW.listValue ( call SW.countComparative ( call SW.getProperty ( call SW.singleton en.block ) ( string ! type ) ) ( string left ) ( string >= ) ( number 2 ) ( call SW.getProperty ( call SW.singleton en.block ) ( string ! type ) ) ) )	overnight-blocks
find me all blocks 2 below block 1	( call SW.listValue ( call SW.filter ( call SW.getProperty ( call SW.singleton en.block ) ( string ! type ) ) ( call SW.reverse ( string below ) ) ( string = ) ( call SW.filter ( call SW.getProperty ( call SW.singleton en.block ) ( string ! type ) ) ( string below ) ( string = ) en.block.block1 ) ) )	overnight-blocks
block whose width is at least height of block 1	( call SW.listValue ( call SW.filter ( call SW.getProperty ( call SW.singleton en.block ) ( string ! type ) ) ( call SW.ensureNumericProperty ( string width ) ) ( string >= ) ( call SW.ensureNumericEntity ( call SW.getProperty en.block.block1 ( string height ) ) ) ) )	overnight-blocks
what block below block 1 is 3 inches wide	( call SW.listValue ( call SW.filter ( call SW.filter ( call SW.getProperty ( call SW.singleton en.block ) ( string ! type ) ) ( string width ) ( string = ) ( number 3 en.inch ) ) ( string below ) ( string = ) en.block.block1 ) )	overnight-blocks
block whose length is at least width of block 1	( call SW.listValue ( call SW.filter ( call SW.getProperty ( call SW.singleton en.block ) ( string ! type ) ) ( call SW.ensureNumericProperty ( string length ) ) ( string >= ) ( call SW.ensureNumericEntity ( call SW.getProperty en.block.block1 ( string width ) ) ) ) )	overnight-blocks
find blocks above block 1 and below block 1 	( call SW.listValue ( call SW.filter ( call SW.filter ( call SW.getProperty ( call SW.singleton en.block ) ( string ! type ) ) ( string above ) ( string = ) en.block.block1 ) ( string below ) ( string = ) en.block.block1 ) )	overnight-blocks
what blocks are special and are below block 1	( call SW.listValue ( call SW.filter ( call SW.filter ( call SW.getProperty ( call SW.singleton en.block ) ( string ! type ) ) ( string is_special ) ) ( call SW.reverse ( string above ) ) ( string = ) en.block.block1 ) )	overnight-blocks
find me all blocks that is to the right of the least number of blocks	( call SW.listValue ( call SW.countSuperlative ( call SW.getProperty ( call SW.singleton en.block ) ( string ! type ) ) ( string min ) ( string right ) ( call SW.getProperty ( call SW.singleton en.block ) ( string ! type ) ) ) )	overnight-blocks
block whose length is 3 inches	( call SW.listValue ( call SW.filter ( call SW.getProperty ( call SW.singleton en.block ) ( string ! type ) ) ( string length ) ( string = ) ( number 3 en.inch ) ) )	overnight-blocks
find the block that is left to the block of 3 inches 	( call SW.listValue ( call SW.filter ( call SW.getProperty ( call SW.singleton en.block ) ( string ! type ) ) ( call SW.reverse ( string left ) ) ( string = ) ( call SW.filter ( call SW.getProperty ( call SW.singleton en.block ) ( string ! type ) ) ( string width ) ( string = ) ( number 3 en.inch ) ) ) )	overnight-blocks
find me all blocks with at least 2 blocks below	( call SW.listValue ( call SW.countComparative ( call SW.getProperty ( call SW.singleton en.block ) ( string ! type ) ) ( call SW.reverse ( string below ) ) ( string >= ) ( number 2 ) ( call SW.getProperty ( call SW.singleton en.block ) ( string ! type ) ) ) )	overnight-blocks
a pyramid or a cube	( call SW.listValue ( call SW.concat en.shape.pyramid en.shape.cube ) )	overnight-blocks
block above block one	( call SW.listValue ( call SW.filter ( call SW.filter ( call SW.getProperty ( call SW.singleton en.block ) ( string ! type ) ) ( call SW.reverse ( string below ) ) ( string = ) en.block.block1 ) ( string above ) ( string = ) en.block.block1 ) )	overnight-blocks
which brick is 3 or 6 inches high	( call SW.listValue ( call SW.filter ( call SW.getProperty ( call SW.singleton en.block ) ( string ! type ) ) ( string height ) ( string = ) ( call SW.concat ( number 3 en.inch ) ( number 6 en.inch ) ) ) )	overnight-blocks
block to right of two or more blocks	( call SW.listValue ( call SW.countComparative ( call SW.getProperty ( call SW.singleton en.block ) ( string ! type ) ) ( string right ) ( string > ) ( number 2 ) ( call SW.getProperty ( call SW.singleton en.block ) ( string ! type ) ) ) )	overnight-blocks
find me all blocks wider than the height of block 1	( call SW.listValue ( call SW.filter ( call SW.getProperty ( call SW.singleton en.block ) ( string ! type ) ) ( call SW.ensureNumericProperty ( string width ) ) ( string > ) ( call SW.ensureNumericEntity ( call SW.getProperty en.block.block1 ( string height ) ) ) ) )	overnight-blocks
select the blocks above and below block 1	( call SW.listValue ( call SW.filter ( call SW.filter ( call SW.getProperty ( call SW.singleton en.block ) ( string ! type ) ) ( call SW.reverse ( string below ) ) ( string = ) en.block.block1 ) ( string below ) ( string = ) en.block.block1 ) )	overnight-blocks
find me all blocks that block 1 is left and under	( call SW.listValue ( call SW.filter ( call SW.filter ( call SW.getProperty ( call SW.singleton en.block ) ( string ! type ) ) ( call SW.reverse ( string left ) ) ( string = ) en.block.block1 ) ( call SW.reverse ( string below ) ) ( string = ) en.block.block1 ) )	overnight-blocks
find me the blocks that are more than two shapes	( call SW.listValue ( call SW.countComparative ( call SW.getProperty ( call SW.singleton en.block ) ( string ! type ) ) ( string shape ) ( string > ) ( number 2 ) ) )	overnight-blocks
block with same color as of block 1	( call SW.listValue ( call SW.filter ( call SW.getProperty ( call SW.singleton en.block ) ( string ! type ) ) ( string color ) ( string = ) ( call SW.getProperty en.block.block1 ( string color ) ) ) )	overnight-blocks
pyramid block 3 inches wide	( call SW.listValue ( call SW.filter ( call SW.filter ( call SW.getProperty ( call SW.singleton en.block ) ( string ! type ) ) ( string shape ) ( string = ) en.shape.pyramid ) ( string width ) ( string = ) ( number 3 en.inch ) ) )	overnight-blocks
block that the most number of block is left of	( call SW.listValue ( call SW.countSuperlative ( call SW.getProperty ( call SW.singleton en.block ) ( string ! type ) ) ( string max ) ( call SW.reverse ( string left ) ) ( call SW.getProperty ( call SW.singleton en.block ) ( string ! type ) ) ) )	overnight-blocks
cannot paraphase	( call SW.listValue ( call SW.filter ( call SW.getProperty ( call SW.singleton en.block ) ( string ! type ) ) ( string left ) ( string = ) ( call SW.filter ( call SW.getProperty ( call SW.singleton en.block ) ( string ! type ) ) ( string right ) ( string = ) en.block.block1 ) ) )	overnight-blocks
find me all blocks that blocks 1 or 2 is below	( call SW.listValue ( call SW.filter ( call SW.getProperty ( call SW.singleton en.block ) ( string ! type ) ) ( call SW.reverse ( string below ) ) ( string = ) ( call SW.concat en.block.block1 en.block.block2 ) ) )	overnight-blocks
second left of block 1	( call SW.listValue ( call SW.filter ( call SW.getProperty ( call SW.singleton en.block ) ( string ! type ) ) ( string left ) ( string = ) ( call SW.filter ( call SW.getProperty ( call SW.singleton en.block ) ( string ! type ) ) ( call SW.reverse ( string right ) ) ( string = ) en.block.block1 ) ) )	overnight-blocks
find all blocks that are below blocks with height equal to 3 inches	( call SW.listValue ( call SW.filter ( call SW.getProperty ( call SW.singleton en.block ) ( string ! type ) ) ( string below ) ( string = ) ( call SW.filter ( call SW.getProperty ( call SW.singleton en.block ) ( string ! type ) ) ( string height ) ( string = ) ( number 3 en.inch ) ) ) )	overnight-blocks
what block has the most blocks above it	( call SW.listValue ( call SW.countSuperlative ( call SW.getProperty ( call SW.singleton en.block ) ( string ! type ) ) ( string max ) ( string below ) ( call SW.getProperty ( call SW.singleton en.block ) ( string ! type ) ) ) )	overnight-blocks
choose a block to the left of block 1	( call SW.listValue ( call SW.filter ( call SW.getProperty ( call SW.singleton en.block ) ( string ! type ) ) ( string above ) ( string = ) ( call SW.filter ( call SW.getProperty ( call SW.singleton en.block ) ( string ! type ) ) ( string left ) ( string = ) en.block.block1 ) ) )	overnight-blocks
which brick is to the right of the brick to the left of brick 1	( call SW.listValue ( call SW.filter ( call SW.getProperty ( call SW.singleton en.block ) ( string ! type ) ) ( string right ) ( string = ) ( call SW.filter ( call SW.getProperty ( call SW.singleton en.block ) ( string ! type ) ) ( string left ) ( string = ) en.block.block1 ) ) )	overnight-blocks
find me all blocks with at least 2 blocks above it	( call SW.listValue ( call SW.countComparative ( call SW.getProperty ( call SW.singleton en.block ) ( string ! type ) ) ( call SW.reverse ( string above ) ) ( string >= ) ( number 2 ) ( call SW.getProperty ( call SW.singleton en.block ) ( string ! type ) ) ) )	overnight-blocks
find me all special 3 inch long blocks	( call SW.listValue ( call SW.filter ( call SW.filter ( call SW.getProperty ( call SW.singleton en.block ) ( string ! type ) ) ( string is_special ) ) ( string length ) ( string = ) ( number 3 en.inch ) ) )	overnight-blocks
find the blocks to the right and left of block 1 	( call SW.listValue ( call SW.filter ( call SW.filter ( call SW.getProperty ( call SW.singleton en.block ) ( string ! type ) ) ( call SW.reverse ( string right ) ) ( string = ) en.block.block1 ) ( call SW.reverse ( string left ) ) ( string = ) en.block.block1 ) )	overnight-blocks
find me a 3 inch long special block	( call SW.listValue ( call SW.filter ( call SW.filter ( call SW.getProperty ( call SW.singleton en.block ) ( string ! type ) ) ( string is_special ) ) ( string length ) ( string = ) ( number 3 en.inch ) ) )	overnight-blocks
find me the block that is to the right of the special block	( call SW.listValue ( call SW.filter ( call SW.getProperty ( call SW.singleton en.block ) ( string ! type ) ) ( string right ) ( string = ) ( call SW.filter ( call SW.getProperty ( call SW.singleton en.block ) ( string ! type ) ) ( string is_special ) ) ) )	overnight-blocks
which brick is taller than brick 1	( call SW.listValue ( call SW.filter ( call SW.getProperty ( call SW.singleton en.block ) ( string ! type ) ) ( call SW.ensureNumericProperty ( string height ) ) ( string > ) ( call SW.ensureNumericEntity ( call SW.getProperty en.block.block1 ( string height ) ) ) ) )	overnight-blocks
select the block with a width of 3 inches	( call SW.listValue ( call SW.filter ( call SW.filter ( call SW.getProperty ( call SW.singleton en.block ) ( string ! type ) ) ( string width ) ( string = ) ( number 3 en.inch ) ) ( call SW.reverse ( string right ) ) ( string = ) en.block.block1 ) )	overnight-blocks
what block is to the left of more than two blocks	( call SW.listValue ( call SW.countComparative ( call SW.getProperty ( call SW.singleton en.block ) ( string ! type ) ) ( string left ) ( string > ) ( number 2 ) ( call SW.getProperty ( call SW.singleton en.block ) ( string ! type ) ) ) )	overnight-blocks
find me all special blocks that block 1 is left of	( call SW.listValue ( call SW.filter ( call SW.filter ( call SW.getProperty ( call SW.singleton en.block ) ( string ! type ) ) ( call SW.reverse ( string left ) ) ( string = ) en.block.block1 ) ( string is_special ) ) )	overnight-blocks
find me all blocks below the smallest numbers of blocks	( call SW.listValue ( call SW.countSuperlative ( call SW.getProperty ( call SW.singleton en.block ) ( string ! type ) ) ( string min ) ( string below ) ( call SW.getProperty ( call SW.singleton en.block ) ( string ! type ) ) ) )	overnight-blocks
which brick is below the brick that is above brick 1	( call SW.listValue ( call SW.filter ( call SW.getProperty ( call SW.singleton en.block ) ( string ! type ) ) ( string below ) ( string = ) ( call SW.filter ( call SW.getProperty ( call SW.singleton en.block ) ( string ! type ) ) ( string above ) ( string = ) en.block.block1 ) ) )	overnight-blocks
block not to right of block 1	( call SW.listValue ( call SW.filter ( call SW.getProperty ( call SW.singleton en.block ) ( string ! type ) ) ( call SW.reverse ( string right ) ) ( string ! = ) en.block.block1 ) )	overnight-blocks
find me all 3 inch high special blocks	( call SW.listValue ( call SW.filter ( call SW.filter ( call SW.getProperty ( call SW.singleton en.block ) ( string ! type ) ) ( string is_special ) ) ( string height ) ( string = ) ( number 3 en.inch ) ) )	overnight-blocks
which block is at least 3 or 6 inches long	( call SW.listValue ( call SW.filter ( call SW.getProperty ( call SW.singleton en.block ) ( string ! type ) ) ( call SW.ensureNumericProperty ( string length ) ) ( string >= ) ( call SW.ensureNumericEntity ( call SW.concat ( number 3 en.inch ) ( number 6 en.inch ) ) ) ) )	overnight-blocks
which special brick is pyramidshaped	( call SW.listValue ( call SW.filter ( call SW.filter ( call SW.getProperty ( call SW.singleton en.block ) ( string ! type ) ) ( string shape ) ( string = ) en.shape.pyramid ) ( string is_special ) ) )	overnight-blocks
choose the most colorful block	( call SW.listValue ( call SW.countSuperlative ( call SW.getProperty ( call SW.singleton en.block ) ( string ! type ) ) ( string max ) ( string color ) ) )	overnight-blocks
find me all blocks over and right of block 1	( call SW.listValue ( call SW.filter ( call SW.filter ( call SW.getProperty ( call SW.singleton en.block ) ( string ! type ) ) ( string above ) ( string = ) en.block.block1 ) ( string right ) ( string = ) en.block.block1 ) )	overnight-blocks
block below block 1 which is 3 inches long	( call SW.listValue ( call SW.filter ( call SW.filter ( call SW.getProperty ( call SW.singleton en.block ) ( string ! type ) ) ( call SW.reverse ( string below ) ) ( string = ) en.block.block1 ) ( string length ) ( string = ) ( number 3 en.inch ) ) )	overnight-blocks
find a block that is below no more than two blocks	( call SW.listValue ( call SW.countComparative ( call SW.getProperty ( call SW.singleton en.block ) ( string ! type ) ) ( string below ) ( string <= ) ( number 2 ) ( call SW.getProperty ( call SW.singleton en.block ) ( string ! type ) ) ) )	overnight-blocks
find all blocks that are as long as or longer than block 1	( call SW.listValue ( call SW.filter ( call SW.getProperty ( call SW.singleton en.block ) ( string ! type ) ) ( call SW.ensureNumericProperty ( string width ) ) ( string >= ) ( call SW.ensureNumericEntity ( call SW.getProperty en.block.block1 ( string length ) ) ) ) )	overnight-blocks
what block is to the left of the block that block 1 is below	( call SW.listValue ( call SW.filter ( call SW.getProperty ( call SW.singleton en.block ) ( string ! type ) ) ( string left ) ( string = ) ( call SW.filter ( call SW.getProperty ( call SW.singleton en.block ) ( string ! type ) ) ( call SW.reverse ( string below ) ) ( string = ) en.block.block1 ) ) )	overnight-blocks
find a wider block than block 1	( call SW.listValue ( call SW.filter ( call SW.getProperty ( call SW.singleton en.block ) ( string ! type ) ) ( call SW.ensureNumericProperty ( string width ) ) ( string > ) ( call SW.ensureNumericEntity ( call SW.getProperty en.block.block1 ( string width ) ) ) ) )	overnight-blocks
block that the least number of block is right of	( call SW.listValue ( call SW.countSuperlative ( call SW.getProperty ( call SW.singleton en.block ) ( string ! type ) ) ( string min ) ( call SW.reverse ( string right ) ) ( call SW.getProperty ( call SW.singleton en.block ) ( string ! type ) ) ) )	overnight-blocks
find me all blocks above which block 1 is right of	( call SW.listValue ( call SW.filter ( call SW.filter ( call SW.getProperty ( call SW.singleton en.block ) ( string ! type ) ) ( call SW.reverse ( string right ) ) ( string = ) en.block.block1 ) ( string above ) ( string = ) en.block.block1 ) )	overnight-blocks
find the block that is left of block 1 or block 2	( call SW.listValue ( call SW.filter ( call SW.getProperty ( call SW.singleton en.block ) ( string ! type ) ) ( call SW.reverse ( string left ) ) ( string = ) ( call SW.concat en.block.block1 en.block.block2 ) ) )	overnight-blocks
which block is wider than block 1 is long	( call SW.listValue ( call SW.filter ( call SW.getProperty ( call SW.singleton en.block ) ( string ! type ) ) ( call SW.ensureNumericProperty ( string width ) ) ( string > ) ( call SW.ensureNumericEntity ( call SW.getProperty en.block.block1 ( string length ) ) ) ) )	overnight-blocks
which block is at least as wide as block 1 is tall	( call SW.listValue ( call SW.filter ( call SW.getProperty ( call SW.singleton en.block ) ( string ! type ) ) ( call SW.ensureNumericProperty ( string width ) ) ( string >= ) ( call SW.ensureNumericEntity ( call SW.getProperty en.block.block1 ( string height ) ) ) ) )	overnight-blocks
locate the block that has a shape other than that of a pyramid	( call SW.listValue ( call SW.filter ( call SW.getProperty ( call SW.singleton en.block ) ( string ! type ) ) ( string shape ) ( string ! = ) en.shape.pyramid ) )	overnight-blocks
block that the most number of block is below	( call SW.listValue ( call SW.countSuperlative ( call SW.getProperty ( call SW.singleton en.block ) ( string ! type ) ) ( string max ) ( call SW.reverse ( string below ) ) ( call SW.getProperty ( call SW.singleton en.block ) ( string ! type ) ) ) )	overnight-blocks
is there a block no wider than 3 or 6 inches	( call SW.listValue ( call SW.filter ( call SW.getProperty ( call SW.singleton en.block ) ( string ! type ) ) ( call SW.ensureNumericProperty ( string width ) ) ( string < ) ( call SW.ensureNumericEntity ( call SW.concat ( number 3 en.inch ) ( number 6 en.inch ) ) ) ) )	overnight-blocks
select the blocks below block 2	( call SW.listValue ( call SW.countComparative ( call SW.getProperty ( call SW.singleton en.block ) ( string ! type ) ) ( string below ) ( string >= ) ( number 2 ) ( call SW.getProperty ( call SW.singleton en.block ) ( string ! type ) ) ) )	overnight-blocks
