article cited more than twice	( call SW.listValue ( call SW.countComparative ( call SW.getProperty ( call SW.singleton en.article ) ( string ! type ) ) ( call SW.reverse ( string cites ) ) ( string > ) ( number 2 ) ( call SW.getProperty ( call SW.singleton en.article ) ( string ! type ) ) ) )	overnight-publications
what venue has the fewest articles	( call SW.listValue ( call SW.countSuperlative ( call SW.getProperty ( call SW.singleton en.venue ) ( string ! type ) ) ( string min ) ( call SW.reverse ( string venue ) ) ( call SW.getProperty ( call SW.singleton en.article ) ( string ! type ) ) ) )	overnight-publications
what are some articles written by efron or lakoff	( call SW.listValue ( call SW.filter ( call SW.getProperty ( call SW.singleton en.article ) ( string ! type ) ) ( string author ) ( string = ) ( call SW.concat en.person.efron en.person.lakoff ) ) )	overnight-publications
articles written by the multivariate data analysis writer	( call SW.listValue ( call SW.filter ( call SW.getProperty ( call SW.singleton en.article ) ( string ! type ) ) ( string author ) ( string = ) ( call SW.getProperty en.article.multivariate_data_analysis ( string author ) ) ) )	overnight-publications
article with venue anals of statistics that multivariate data analysis cites	( call SW.listValue ( call SW.filter ( call SW.filter ( call SW.getProperty ( call SW.singleton en.article ) ( string ! type ) ) ( string venue ) ( string = ) en.venue.annals_of_statistics ) ( call SW.reverse ( string cites ) ) ( string = ) en.article.multivariate_data_analysis ) )	overnight-publications
articles written by efron and cited by multivariate data analysis	( call SW.listValue ( call SW.filter ( call SW.filter ( call SW.getProperty ( call SW.singleton en.article ) ( string ! type ) ) ( string author ) ( string = ) en.person.efron ) ( call SW.reverse ( string cites ) ) ( string = ) en.article.multivariate_data_analysis ) )	overnight-publications
find an article with no more than two venues	( call SW.listValue ( call SW.countComparative ( call SW.getProperty ( call SW.singleton en.article ) ( string ! type ) ) ( string venue ) ( string <= ) ( number 2 ) ) )	overnight-publications
who is the author of the article who won an award	( call SW.listValue ( call SW.filter ( call SW.getProperty ( call SW.singleton en.person ) ( string ! type ) ) ( call SW.reverse ( string author ) ) ( string = ) ( call SW.filter ( call SW.getProperty ( call SW.singleton en.article ) ( string ! type ) ) ( string won_award ) ) ) )	overnight-publications
article published before multivariate data analysis	( call SW.listValue ( call SW.filter ( call SW.getProperty ( call SW.singleton en.article ) ( string ! type ) ) ( call SW.ensureNumericProperty ( string publication_date ) ) ( string < ) ( call SW.ensureNumericEntity ( call SW.getProperty en.article.multivariate_data_analysis ( string publication_date ) ) ) ) )	overnight-publications
writers who published in 2004	( call SW.listValue ( call SW.filter ( call SW.getProperty ( call SW.singleton en.person ) ( string ! type ) ) ( call SW.reverse ( string author ) ) ( string = ) ( call SW.filter ( call SW.getProperty ( call SW.singleton en.article ) ( string ! type ) ) ( string publication_date ) ( string = ) ( date 2004 -1 -1 ) ) ) )	overnight-publications
name an article about multivariate data analysis from the annals of statistics	( call SW.listValue ( call SW.filter ( call SW.filter ( call SW.getProperty ( call SW.singleton en.article ) ( string ! type ) ) ( string cites ) ( string = ) en.article.multivariate_data_analysis ) ( string venue ) ( string = ) en.venue.annals_of_statistics ) )	overnight-publications
what articles are written by authors of multivariate data analysis	( call SW.listValue ( call SW.filter ( call SW.getProperty ( call SW.singleton en.article ) ( string ! type ) ) ( string author ) ( string = ) ( call SW.filter ( call SW.getProperty ( call SW.singleton en.person ) ( string ! type ) ) ( call SW.reverse ( string author ) ) ( string = ) en.article.multivariate_data_analysis ) ) )	overnight-publications
what article was published in 2004 or later	( call SW.listValue ( call SW.filter ( call SW.getProperty ( call SW.singleton en.article ) ( string ! type ) ) ( call SW.ensureNumericProperty ( string publication_date ) ) ( string >= ) ( call SW.ensureNumericEntity ( date 2004 -1 -1 ) ) ) )	overnight-publications
name an article with fewer than two authors	( call SW.listValue ( call SW.countComparative ( call SW.getProperty ( call SW.singleton en.article ) ( string ! type ) ) ( string author ) ( string < ) ( number 2 ) ) )	overnight-publications
what article cites multivariate data analysis	( call SW.listValue ( call SW.filter ( call SW.getProperty ( call SW.singleton en.article ) ( string ! type ) ) ( call SW.reverse ( string cites ) ) ( string = ) ( call SW.filter ( call SW.getProperty ( call SW.singleton en.article ) ( string ! type ) ) ( string cites ) ( string = ) en.article.multivariate_data_analysis ) ) )	overnight-publications
all articles by efron	( call SW.listValue ( call SW.filter ( call SW.getProperty ( call SW.singleton en.article ) ( string ! type ) ) ( string author ) ( string = ) en.person.efron ) )	overnight-publications
find an article that makes two or fewer citations	( call SW.listValue ( call SW.countComparative ( call SW.getProperty ( call SW.singleton en.article ) ( string ! type ) ) ( string cites ) ( string <= ) ( number 2 ) ( call SW.getProperty ( call SW.singleton en.article ) ( string ! type ) ) ) )	overnight-publications
article published in 2004 or 2010	( call SW.listValue ( call SW.filter ( call SW.getProperty ( call SW.singleton en.article ) ( string ! type ) ) ( string publication_date ) ( string = ) ( call SW.concat ( date 2004 -1 -1 ) ( date 2010 -1 -1 ) ) ) )	overnight-publications
author of more than two articles	( call SW.listValue ( call SW.countComparative ( call SW.getProperty ( call SW.singleton en.person ) ( string ! type ) ) ( call SW.reverse ( string author ) ) ( string > ) ( number 2 ) ( call SW.getProperty ( call SW.singleton en.article ) ( string ! type ) ) ) )	overnight-publications
article that cite articles published in 2004	( call SW.listValue ( call SW.filter ( call SW.getProperty ( call SW.singleton en.article ) ( string ! type ) ) ( string cites ) ( string = ) ( call SW.filter ( call SW.getProperty ( call SW.singleton en.article ) ( string ! type ) ) ( string publication_date ) ( string = ) ( date 2004 -1 -1 ) ) ) )	overnight-publications
name an article that won an award	( call SW.listValue ( call SW.filter ( call SW.getProperty ( call SW.singleton en.article ) ( string ! type ) ) ( call SW.reverse ( string cites ) ) ( string = ) ( call SW.filter ( call SW.getProperty ( call SW.singleton en.article ) ( string ! type ) ) ( string won_award ) ) ) )	overnight-publications
name someone who has written an article about multivariate data analysis	( call SW.listValue ( call SW.filter ( call SW.filter ( call SW.getProperty ( call SW.singleton en.person ) ( string ! type ) ) ( call SW.reverse ( string author ) ) ( string = ) en.article.multivariate_data_analysis ) ( call SW.reverse ( string author ) ) ( string = ) en.article.multivariate_data_analysis ) )	overnight-publications
which article  that cites multivariate data analysis was published on 2004 	( call SW.listValue ( call SW.filter ( call SW.filter ( call SW.getProperty ( call SW.singleton en.article ) ( string ! type ) ) ( string publication_date ) ( string = ) ( date 2004 -1 -1 ) ) ( string cites ) ( string = ) en.article.multivariate_data_analysis ) )	overnight-publications
articles that cite multivariate data analysis published in 2004	( call SW.listValue ( call SW.filter ( call SW.filter ( call SW.getProperty ( call SW.singleton en.article ) ( string ! type ) ) ( string cites ) ( string = ) en.article.multivariate_data_analysis ) ( string publication_date ) ( string = ) ( date 2004 -1 -1 ) ) )	overnight-publications
articles that have a publication date close to the date of multivariate data analysis	( call SW.listValue ( call SW.filter ( call SW.getProperty ( call SW.singleton en.article ) ( string ! type ) ) ( call SW.ensureNumericProperty ( string publication_date ) ) ( string <= ) ( call SW.ensureNumericEntity ( call SW.getProperty en.article.multivariate_data_analysis ( string publication_date ) ) ) ) )	overnight-publications
what venue is multivariate data analysis in	( call SW.listValue ( call SW.filter ( call SW.getProperty ( call SW.singleton en.venue ) ( string ! type ) ) ( call SW.reverse ( string venue ) ) ( string = ) en.article.multivariate_data_analysis ) )	overnight-publications
articles that cite multivariate data analysis and are cited in multivariate data analysis	( call SW.listValue ( call SW.filter ( call SW.filter ( call SW.getProperty ( call SW.singleton en.article ) ( string ! type ) ) ( call SW.reverse ( string cites ) ) ( string = ) en.article.multivariate_data_analysis ) ( string cites ) ( string = ) en.article.multivariate_data_analysis ) )	overnight-publications
find an article with the same venue as multivariate data analysis	( call SW.listValue ( call SW.filter ( call SW.getProperty ( call SW.singleton en.article ) ( string ! type ) ) ( string venue ) ( string = ) ( call SW.getProperty en.article.multivariate_data_analysis ( string venue ) ) ) )	overnight-publications
author of one or two articles	( call SW.listValue ( call SW.countComparative ( call SW.getProperty ( call SW.singleton en.person ) ( string ! type ) ) ( call SW.reverse ( string author ) ) ( string <= ) ( number 2 ) ( call SW.getProperty ( call SW.singleton en.article ) ( string ! type ) ) ) )	overnight-publications
what article cites other articles about annals of statistics	( call SW.listValue ( call SW.filter ( call SW.getProperty ( call SW.singleton en.article ) ( string ! type ) ) ( string cites ) ( string = ) ( call SW.filter ( call SW.getProperty ( call SW.singleton en.article ) ( string ! type ) ) ( string venue ) ( string = ) en.venue.annals_of_statistics ) ) )	overnight-publications
multivariate data analysis venue	( call SW.listValue ( call SW.getProperty en.article.multivariate_data_analysis ( string venue ) ) )	overnight-publications
article authored by efron and has the annals of statistics as its venue	( call SW.listValue ( call SW.filter ( call SW.filter ( call SW.getProperty ( call SW.singleton en.article ) ( string ! type ) ) ( string author ) ( string = ) en.person.efron ) ( string venue ) ( string = ) en.venue.annals_of_statistics ) )	overnight-publications
articles published in 2004 or before	( call SW.listValue ( call SW.filter ( call SW.getProperty ( call SW.singleton en.article ) ( string ! type ) ) ( call SW.ensureNumericProperty ( string publication_date ) ) ( string <= ) ( call SW.ensureNumericEntity ( date 2004 -1 -1 ) ) ) )	overnight-publications
what article written by efron cites multivariate data analysis	( call SW.listValue ( call SW.filter ( call SW.filter ( call SW.getProperty ( call SW.singleton en.article ) ( string ! type ) ) ( string author ) ( string = ) en.person.efron ) ( string cites ) ( string = ) en.article.multivariate_data_analysis ) )	overnight-publications
articles published in the same venue as multivariate data analysis	( call SW.listValue ( call SW.filter ( call SW.getProperty ( call SW.singleton en.article ) ( string ! type ) ) ( string venue ) ( string = ) ( call SW.filter ( call SW.getProperty ( call SW.singleton en.venue ) ( string ! type ) ) ( call SW.reverse ( string venue ) ) ( string = ) en.article.multivariate_data_analysis ) ) )	overnight-publications
people who did not author multivariate data analysis	( call SW.listValue ( call SW.filter ( call SW.getProperty ( call SW.singleton en.person ) ( string ! type ) ) ( call SW.reverse ( string author ) ) ( string ! = ) en.article.multivariate_data_analysis ) )	overnight-publications
articles published except in 2004	( call SW.listValue ( call SW.filter ( call SW.getProperty ( call SW.singleton en.article ) ( string ! type ) ) ( string publication_date ) ( string ! = ) ( date 2004 -1 -1 ) ) )	overnight-publications
what article has over two authors	( call SW.listValue ( call SW.countComparative ( call SW.getProperty ( call SW.singleton en.article ) ( string ! type ) ) ( string author ) ( string > ) ( number 2 ) ) )	overnight-publications
an article by efron that cites multivariate data analysis	( call SW.listValue ( call SW.filter ( call SW.filter ( call SW.getProperty ( call SW.singleton en.article ) ( string ! type ) ) ( string author ) ( string = ) en.person.efron ) ( call SW.reverse ( string cites ) ) ( string = ) en.article.multivariate_data_analysis ) )	overnight-publications
articles published in two or more venues	( call SW.listValue ( call SW.countComparative ( call SW.getProperty ( call SW.singleton en.article ) ( string ! type ) ) ( string venue ) ( string >= ) ( number 2 ) ) )	overnight-publications
article that won an award and cites multivariate data analysis	( call SW.listValue ( call SW.filter ( call SW.filter ( call SW.getProperty ( call SW.singleton en.article ) ( string ! type ) ) ( string cites ) ( string = ) en.article.multivariate_data_analysis ) ( string won_award ) ) )	overnight-publications
which article is mentioned in least number of other articles	( call SW.listValue ( call SW.countSuperlative ( call SW.getProperty ( call SW.singleton en.article ) ( string ! type ) ) ( string min ) ( call SW.reverse ( string cites ) ) ( call SW.getProperty ( call SW.singleton en.article ) ( string ! type ) ) ) )	overnight-publications
article cited two or fewer times	( call SW.listValue ( call SW.countComparative ( call SW.getProperty ( call SW.singleton en.article ) ( string ! type ) ) ( call SW.reverse ( string cites ) ) ( string <= ) ( number 2 ) ( call SW.getProperty ( call SW.singleton en.article ) ( string ! type ) ) ) )	overnight-publications
what is a venue with fewer than two articles	( call SW.listValue ( call SW.countComparative ( call SW.getProperty ( call SW.singleton en.venue ) ( string ! type ) ) ( call SW.reverse ( string venue ) ) ( string < ) ( number 2 ) ( call SW.getProperty ( call SW.singleton en.article ) ( string ! type ) ) ) )	overnight-publications
article not in annals of statistics	( call SW.listValue ( call SW.filter ( call SW.getProperty ( call SW.singleton en.article ) ( string ! type ) ) ( string venue ) ( string ! = ) en.venue.annals_of_statistics ) )	overnight-publications
find an article by efron	( call SW.listValue ( call SW.filter ( call SW.filter ( call SW.getProperty ( call SW.singleton en.article ) ( string ! type ) ) ( string author ) ( string = ) en.person.efron ) ( string author ) ( string = ) en.person.efron ) )	overnight-publications
what venue has two or less articles	( call SW.listValue ( call SW.countComparative ( call SW.getProperty ( call SW.singleton en.venue ) ( string ! type ) ) ( call SW.reverse ( string venue ) ) ( string <= ) ( number 2 ) ( call SW.getProperty ( call SW.singleton en.article ) ( string ! type ) ) ) )	overnight-publications
writers of more than two articles	( call SW.listValue ( call SW.countComparative ( call SW.getProperty ( call SW.singleton en.person ) ( string ! type ) ) ( call SW.reverse ( string author ) ) ( string > ) ( number 2 ) ( call SW.getProperty ( call SW.singleton en.article ) ( string ! type ) ) ) )	overnight-publications
publications with at least two articles	( call SW.listValue ( call SW.countComparative ( call SW.getProperty ( call SW.singleton en.venue ) ( string ! type ) ) ( call SW.reverse ( string venue ) ) ( string >= ) ( number 2 ) ( call SW.getProperty ( call SW.singleton en.article ) ( string ! type ) ) ) )	overnight-publications
articles that cite two or fewer articles	( call SW.listValue ( call SW.countComparative ( call SW.getProperty ( call SW.singleton en.article ) ( string ! type ) ) ( call SW.reverse ( string cites ) ) ( string <= ) ( number 2 ) ( call SW.getProperty ( call SW.singleton en.article ) ( string ! type ) ) ) )	overnight-publications
what article about multivariate data analysis was published in 2004	( call SW.listValue ( call SW.filter ( call SW.filter ( call SW.getProperty ( call SW.singleton en.article ) ( string ! type ) ) ( call SW.reverse ( string cites ) ) ( string = ) en.article.multivariate_data_analysis ) ( string publication_date ) ( string = ) ( date 2004 -1 -1 ) ) )	overnight-publications
find an author of an article in annals of statistics	( call SW.listValue ( call SW.filter ( call SW.getProperty ( call SW.singleton en.person ) ( string ! type ) ) ( call SW.reverse ( string author ) ) ( string = ) ( call SW.filter ( call SW.getProperty ( call SW.singleton en.article ) ( string ! type ) ) ( string venue ) ( string = ) en.venue.annals_of_statistics ) ) )	overnight-publications
what article was published before multivariate data analysis	( call SW.listValue ( call SW.filter ( call SW.getProperty ( call SW.singleton en.article ) ( string ! type ) ) ( call SW.ensureNumericProperty ( string publication_date ) ) ( string < ) ( call SW.ensureNumericEntity ( call SW.getProperty en.article.multivariate_data_analysis ( string publication_date ) ) ) ) )	overnight-publications
award winning article cited by multivariate data analysis	( call SW.listValue ( call SW.filter ( call SW.filter ( call SW.getProperty ( call SW.singleton en.article ) ( string ! type ) ) ( string won_award ) ) ( call SW.reverse ( string cites ) ) ( string = ) en.article.multivariate_data_analysis ) )	overnight-publications
venue of two articles	( call SW.listValue ( call SW.countComparative ( call SW.getProperty ( call SW.singleton en.venue ) ( string ! type ) ) ( call SW.reverse ( string venue ) ) ( string = ) ( number 2 ) ( call SW.getProperty ( call SW.singleton en.article ) ( string ! type ) ) ) )	overnight-publications
articles that were written before 2004	( call SW.listValue ( call SW.filter ( call SW.getProperty ( call SW.singleton en.article ) ( string ! type ) ) ( call SW.ensureNumericProperty ( string publication_date ) ) ( string <= ) ( call SW.ensureNumericEntity ( date 2004 -1 -1 ) ) ) )	overnight-publications
what article has a publication date of 2003 and won an award	( call SW.listValue ( call SW.filter ( call SW.filter ( call SW.getProperty ( call SW.singleton en.article ) ( string ! type ) ) ( string publication_date ) ( string = ) ( date 2004 -1 -1 ) ) ( string won_award ) ) )	overnight-publications
articles published in two venues	( call SW.listValue ( call SW.countComparative ( call SW.getProperty ( call SW.singleton en.article ) ( string ! type ) ) ( string venue ) ( string = ) ( number 2 ) ) )	overnight-publications
articles with more than two authors	( call SW.listValue ( call SW.countComparative ( call SW.getProperty ( call SW.singleton en.article ) ( string ! type ) ) ( string author ) ( string > ) ( number 2 ) ) )	overnight-publications
articles cited by fewer than two articles	( call SW.listValue ( call SW.countComparative ( call SW.getProperty ( call SW.singleton en.article ) ( string ! type ) ) ( call SW.reverse ( string cites ) ) ( string < ) ( number 2 ) ( call SW.getProperty ( call SW.singleton en.article ) ( string ! type ) ) ) )	overnight-publications
name a person who has written two articles	( call SW.listValue ( call SW.countComparative ( call SW.getProperty ( call SW.singleton en.person ) ( string ! type ) ) ( call SW.reverse ( string author ) ) ( string = ) ( number 2 ) ( call SW.getProperty ( call SW.singleton en.article ) ( string ! type ) ) ) )	overnight-publications
what person wrote articles than won an award	( call SW.listValue ( call SW.filter ( call SW.getProperty ( call SW.singleton en.person ) ( string ! type ) ) ( call SW.reverse ( string author ) ) ( string = ) ( call SW.filter ( call SW.getProperty ( call SW.singleton en.article ) ( string ! type ) ) ( string won_award ) ) ) )	overnight-publications
who is the author of multivariate date analysis articles	( call SW.listValue ( call SW.filter ( call SW.filter ( call SW.getProperty ( call SW.singleton en.person ) ( string ! type ) ) ( call SW.reverse ( string author ) ) ( string = ) en.article.multivariate_data_analysis ) ( call SW.reverse ( string author ) ) ( string = ) en.article.multivariate_data_analysis ) )	overnight-publications
articles that cite more than two articles	( call SW.listValue ( call SW.countComparative ( call SW.getProperty ( call SW.singleton en.article ) ( string ! type ) ) ( string cites ) ( string > ) ( number 2 ) ( call SW.getProperty ( call SW.singleton en.article ) ( string ! type ) ) ) )	overnight-publications
articles citing articles cited in multivariate data analysis	( call SW.listValue ( call SW.filter ( call SW.getProperty ( call SW.singleton en.article ) ( string ! type ) ) ( string cites ) ( string = ) ( call SW.filter ( call SW.getProperty ( call SW.singleton en.article ) ( string ! type ) ) ( call SW.reverse ( string cites ) ) ( string = ) en.article.multivariate_data_analysis ) ) )	overnight-publications
publications that contains articles that are also published in annals of statistics	( call SW.listValue ( call SW.filter ( call SW.getProperty ( call SW.singleton en.venue ) ( string ! type ) ) ( call SW.reverse ( string venue ) ) ( string = ) ( call SW.filter ( call SW.getProperty ( call SW.singleton en.article ) ( string ! type ) ) ( string venue ) ( string = ) en.venue.annals_of_statistics ) ) )	overnight-publications
which article was published in 2004 at annals of statistics	( call SW.listValue ( call SW.filter ( call SW.filter ( call SW.getProperty ( call SW.singleton en.article ) ( string ! type ) ) ( string publication_date ) ( string = ) ( date 2004 -1 -1 ) ) ( string venue ) ( string = ) en.venue.annals_of_statistics ) )	overnight-publications
article published in 2004 that cites multivariate data analysis	( call SW.listValue ( call SW.filter ( call SW.filter ( call SW.getProperty ( call SW.singleton en.article ) ( string ! type ) ) ( string cites ) ( string = ) en.article.multivariate_data_analysis ) ( string publication_date ) ( string = ) ( date 2004 -1 -1 ) ) )	overnight-publications
which articles author is efron	( call SW.listValue ( call SW.filter ( call SW.getProperty ( call SW.singleton en.article ) ( string ! type ) ) ( string author ) ( string = ) en.person.efron ) )	overnight-publications
what article has less than two authors	( call SW.listValue ( call SW.countComparative ( call SW.getProperty ( call SW.singleton en.article ) ( string ! type ) ) ( string author ) ( string < ) ( number 2 ) ) )	overnight-publications
articles published before 2004 or before 2010	( call SW.listValue ( call SW.filter ( call SW.getProperty ( call SW.singleton en.article ) ( string ! type ) ) ( call SW.ensureNumericProperty ( string publication_date ) ) ( string <= ) ( call SW.ensureNumericEntity ( call SW.concat ( date 2004 -1 -1 ) ( date 2010 -1 -1 ) ) ) ) )	overnight-publications
publication with the fewest articles	( call SW.listValue ( call SW.countSuperlative ( call SW.getProperty ( call SW.singleton en.venue ) ( string ! type ) ) ( string min ) ( call SW.reverse ( string venue ) ) ( call SW.getProperty ( call SW.singleton en.article ) ( string ! type ) ) ) )	overnight-publications
articles published after multivariate data analysis	( call SW.listValue ( call SW.filter ( call SW.getProperty ( call SW.singleton en.article ) ( string ! type ) ) ( call SW.ensureNumericProperty ( string publication_date ) ) ( string > ) ( call SW.ensureNumericEntity ( call SW.getProperty en.article.multivariate_data_analysis ( string publication_date ) ) ) ) )	overnight-publications
articles with a venue	( call SW.listValue ( call SW.countComparative ( call SW.getProperty ( call SW.singleton en.article ) ( string ! type ) ) ( string venue ) ( string < ) ( number 2 ) ) )	overnight-publications
what article doesnt cite multivariate data analysis	( call SW.listValue ( call SW.filter ( call SW.getProperty ( call SW.singleton en.article ) ( string ! type ) ) ( string cites ) ( string ! = ) en.article.multivariate_data_analysis ) )	overnight-publications
who has written the fewest articles	( call SW.listValue ( call SW.countSuperlative ( call SW.getProperty ( call SW.singleton en.person ) ( string ! type ) ) ( string min ) ( call SW.reverse ( string author ) ) ( call SW.getProperty ( call SW.singleton en.article ) ( string ! type ) ) ) )	overnight-publications
article that cites multivariate data analysis in the annals of statistics	( call SW.listValue ( call SW.filter ( call SW.filter ( call SW.getProperty ( call SW.singleton en.article ) ( string ! type ) ) ( call SW.reverse ( string cites ) ) ( string = ) en.article.multivariate_data_analysis ) ( string venue ) ( string = ) en.venue.annals_of_statistics ) )	overnight-publications
find an article published in 2004	( call SW.listValue ( call SW.filter ( call SW.getProperty ( call SW.singleton en.article ) ( string ! type ) ) ( string publication_date ) ( string = ) ( date 2004 -1 -1 ) ) )	overnight-publications
article that at least two article cites	( call SW.listValue ( call SW.countComparative ( call SW.getProperty ( call SW.singleton en.article ) ( string ! type ) ) ( call SW.reverse ( string cites ) ) ( string >= ) ( number 2 ) ( call SW.getProperty ( call SW.singleton en.article ) ( string ! type ) ) ) )	overnight-publications
article that refernces a single article	( call SW.listValue ( call SW.countComparative ( call SW.getProperty ( call SW.singleton en.article ) ( string ! type ) ) ( string cites ) ( string >= ) ( number 2 ) ( call SW.getProperty ( call SW.singleton en.article ) ( string ! type ) ) ) )	overnight-publications
what article is about multivariate data analysis	( call SW.listValue ( call SW.filter ( call SW.getProperty ( call SW.singleton en.venue ) ( string ! type ) ) ( call SW.reverse ( string venue ) ) ( string = ) ( call SW.filter ( call SW.getProperty ( call SW.singleton en.article ) ( string ! type ) ) ( string cites ) ( string = ) en.article.multivariate_data_analysis ) ) )	overnight-publications
find an article published on or before multivariate data analysis	( call SW.listValue ( call SW.filter ( call SW.getProperty ( call SW.singleton en.article ) ( string ! type ) ) ( call SW.ensureNumericProperty ( string publication_date ) ) ( string <= ) ( call SW.ensureNumericEntity ( call SW.getProperty en.article.multivariate_data_analysis ( string publication_date ) ) ) ) )	overnight-publications
what article has the most authors	( call SW.listValue ( call SW.countSuperlative ( call SW.getProperty ( call SW.singleton en.article ) ( string ! type ) ) ( string max ) ( string author ) ) )	overnight-publications
article that cite at least two articles	( call SW.listValue ( call SW.countComparative ( call SW.getProperty ( call SW.singleton en.article ) ( string ! type ) ) ( string cites ) ( string >= ) ( number 2 ) ( call SW.getProperty ( call SW.singleton en.article ) ( string ! type ) ) ) )	overnight-publications
which author wrote two articles maximum	( call SW.listValue ( call SW.countComparative ( call SW.getProperty ( call SW.singleton en.person ) ( string ! type ) ) ( call SW.reverse ( string author ) ) ( string <= ) ( number 2 ) ( call SW.getProperty ( call SW.singleton en.article ) ( string ! type ) ) ) )	overnight-publications
articles published before 2010	( call SW.listValue ( call SW.filter ( call SW.getProperty ( call SW.singleton en.article ) ( string ! type ) ) ( call SW.ensureNumericProperty ( string publication_date ) ) ( string <= ) ( call SW.ensureNumericEntity ( call SW.concat ( date 2004 -1 -1 ) ( date 2010 -1 -1 ) ) ) ) )	overnight-publications
articles published in 2004 cited by multivariate data analysis	( call SW.listValue ( call SW.filter ( call SW.filter ( call SW.getProperty ( call SW.singleton en.article ) ( string ! type ) ) ( string publication_date ) ( string = ) ( date 2004 -1 -1 ) ) ( call SW.reverse ( string cites ) ) ( string = ) en.article.multivariate_data_analysis ) )	overnight-publications
who is the author of the two articles	( call SW.listValue ( call SW.countComparative ( call SW.getProperty ( call SW.singleton en.person ) ( string ! type ) ) ( call SW.reverse ( string author ) ) ( string = ) ( number 2 ) ( call SW.getProperty ( call SW.singleton en.article ) ( string ! type ) ) ) )	overnight-publications
what article was written by efron and has a publication date of 2004	( call SW.listValue ( call SW.filter ( call SW.filter ( call SW.getProperty ( call SW.singleton en.article ) ( string ! type ) ) ( string author ) ( string = ) en.person.efron ) ( string publication_date ) ( string = ) ( date 2004 -1 -1 ) ) )	overnight-publications
what is the earliest published article	( call SW.listValue ( call SW.superlative ( call SW.getProperty ( call SW.singleton en.article ) ( string ! type ) ) ( string min ) ( call SW.ensureNumericProperty ( string publication_date ) ) ) )	overnight-publications
article written by efron that cites multivariate data analysis	( call SW.listValue ( call SW.filter ( call SW.filter ( call SW.getProperty ( call SW.singleton en.article ) ( string ! type ) ) ( string author ) ( string = ) en.person.efron ) ( string cites ) ( string = ) en.article.multivariate_data_analysis ) )	overnight-publications
articles published in annals of statistics cited by multivariate data analysis	( call SW.listValue ( call SW.filter ( call SW.filter ( call SW.getProperty ( call SW.singleton en.article ) ( string ! type ) ) ( string venue ) ( string = ) en.venue.annals_of_statistics ) ( call SW.reverse ( string cites ) ) ( string = ) en.article.multivariate_data_analysis ) )	overnight-publications
articles that have won an award	( call SW.listValue ( call SW.filter ( call SW.getProperty ( call SW.singleton en.article ) ( string ! type ) ) ( string won_award ) ) )	overnight-publications
what article was cited by a 2004 article	( call SW.listValue ( call SW.filter ( call SW.getProperty ( call SW.singleton en.article ) ( string ! type ) ) ( call SW.reverse ( string cites ) ) ( string = ) ( call SW.filter ( call SW.getProperty ( call SW.singleton en.article ) ( string ! type ) ) ( string publication_date ) ( string = ) ( date 2004 -1 -1 ) ) ) )	overnight-publications
an article citing multivariate data analysis	( call SW.listValue ( call SW.filter ( call SW.filter ( call SW.getProperty ( call SW.singleton en.article ) ( string ! type ) ) ( string cites ) ( string = ) en.article.multivariate_data_analysis ) ( call SW.reverse ( string cites ) ) ( string = ) en.article.multivariate_data_analysis ) )	overnight-publications
find an article in annals of statistics that was published in 2004	( call SW.listValue ( call SW.filter ( call SW.filter ( call SW.getProperty ( call SW.singleton en.article ) ( string ! type ) ) ( string venue ) ( string = ) en.venue.annals_of_statistics ) ( string publication_date ) ( string = ) ( date 2004 -1 -1 ) ) )	overnight-publications
what article was written before the publication date of articles about multivariate data analysis	( call SW.listValue ( call SW.filter ( call SW.getProperty ( call SW.singleton en.article ) ( string ! type ) ) ( call SW.ensureNumericProperty ( string publication_date ) ) ( string < ) ( call SW.ensureNumericEntity ( call SW.getProperty en.article.multivariate_data_analysis ( string publication_date ) ) ) ) )	overnight-publications
what article cites an efron article	( call SW.listValue ( call SW.filter ( call SW.getProperty ( call SW.singleton en.article ) ( string ! type ) ) ( string cites ) ( string = ) ( call SW.filter ( call SW.getProperty ( call SW.singleton en.article ) ( string ! type ) ) ( string author ) ( string = ) en.person.efron ) ) )	overnight-publications
articles published in or before 2004	( call SW.listValue ( call SW.filter ( call SW.getProperty ( call SW.singleton en.article ) ( string ! type ) ) ( call SW.ensureNumericProperty ( string publication_date ) ) ( string <= ) ( call SW.ensureNumericEntity ( date 2004 -1 -1 ) ) ) )	overnight-publications
article published in 2004 and that cites multivariate data analysis	( call SW.listValue ( call SW.filter ( call SW.filter ( call SW.getProperty ( call SW.singleton en.article ) ( string ! type ) ) ( string publication_date ) ( string = ) ( date 2004 -1 -1 ) ) ( string cites ) ( string = ) en.article.multivariate_data_analysis ) )	overnight-publications
what article cites less than two other articles	( call SW.listValue ( call SW.countComparative ( call SW.getProperty ( call SW.singleton en.article ) ( string ! type ) ) ( call SW.reverse ( string cites ) ) ( string < ) ( number 2 ) ( call SW.getProperty ( call SW.singleton en.article ) ( string ! type ) ) ) )	overnight-publications
article cited the fewest times	( call SW.listValue ( call SW.countSuperlative ( call SW.getProperty ( call SW.singleton en.article ) ( string ! type ) ) ( string min ) ( call SW.reverse ( string cites ) ) ( call SW.getProperty ( call SW.singleton en.article ) ( string ! type ) ) ) )	overnight-publications
find an article making a citation of a 2004 published article	( call SW.listValue ( call SW.filter ( call SW.getProperty ( call SW.singleton en.article ) ( string ! type ) ) ( string cites ) ( string = ) ( call SW.filter ( call SW.getProperty ( call SW.singleton en.article ) ( string ! type ) ) ( string publication_date ) ( string = ) ( date 2004 -1 -1 ) ) ) )	overnight-publications
find an article in the annals of statistics venue	( call SW.listValue ( call SW.filter ( call SW.getProperty ( call SW.singleton en.article ) ( string ! type ) ) ( string venue ) ( string = ) en.venue.annals_of_statistics ) )	overnight-publications
what article won an award and has a publication date of 2004	( call SW.listValue ( call SW.filter ( call SW.filter ( call SW.getProperty ( call SW.singleton en.article ) ( string ! type ) ) ( string won_award ) ) ( string publication_date ) ( string = ) ( date 2004 -1 -1 ) ) )	overnight-publications
award winning articles cited by multivariate data analysis	( call SW.listValue ( call SW.filter ( call SW.filter ( call SW.getProperty ( call SW.singleton en.article ) ( string ! type ) ) ( string won_award ) ) ( call SW.reverse ( string cites ) ) ( string = ) en.article.multivariate_data_analysis ) )	overnight-publications
awardwinning articles cited in multivariate data analysis	( call SW.listValue ( call SW.filter ( call SW.filter ( call SW.getProperty ( call SW.singleton en.article ) ( string ! type ) ) ( call SW.reverse ( string cites ) ) ( string = ) en.article.multivariate_data_analysis ) ( string won_award ) ) )	overnight-publications
articles cited by multivariate data analysis and published in annals of statistics	( call SW.listValue ( call SW.filter ( call SW.filter ( call SW.getProperty ( call SW.singleton en.article ) ( string ! type ) ) ( call SW.reverse ( string cites ) ) ( string = ) en.article.multivariate_data_analysis ) ( string venue ) ( string = ) en.venue.annals_of_statistics ) )	overnight-publications
what is an article cited in a publication about multivariate data analysis	( call SW.listValue ( call SW.filter ( call SW.getProperty ( call SW.singleton en.article ) ( string ! type ) ) ( call SW.reverse ( string cites ) ) ( string = ) ( call SW.filter ( call SW.getProperty ( call SW.singleton en.article ) ( string ! type ) ) ( call SW.reverse ( string cites ) ) ( string = ) en.article.multivariate_data_analysis ) ) )	overnight-publications
name an article about multivariate data analysis by the author efron	( call SW.listValue ( call SW.filter ( call SW.filter ( call SW.getProperty ( call SW.singleton en.article ) ( string ! type ) ) ( string author ) ( string = ) en.person.efron ) ( call SW.reverse ( string cites ) ) ( string = ) en.article.multivariate_data_analysis ) )	overnight-publications
what is the publication date of a multivariate data analysis article	( call SW.listValue ( call SW.getProperty en.article.multivariate_data_analysis ( string publication_date ) ) )	overnight-publications
article with the maximum number of venues	( call SW.listValue ( call SW.countSuperlative ( call SW.getProperty ( call SW.singleton en.article ) ( string ! type ) ) ( string max ) ( string venue ) ) )	overnight-publications
articles that does not cites multivariate data analysis	( call SW.listValue ( call SW.filter ( call SW.getProperty ( call SW.singleton en.article ) ( string ! type ) ) ( call SW.reverse ( string cites ) ) ( string ! = ) en.article.multivariate_data_analysis ) )	overnight-publications
find me an article that is in two venues	( call SW.listValue ( call SW.countComparative ( call SW.getProperty ( call SW.singleton en.article ) ( string ! type ) ) ( string venue ) ( string = ) ( number 2 ) ) )	overnight-publications
article whose author is author of multivariate data analysis	( call SW.listValue ( call SW.filter ( call SW.getProperty ( call SW.singleton en.article ) ( string ! type ) ) ( string author ) ( string = ) ( call SW.getProperty en.article.multivariate_data_analysis ( string author ) ) ) )	overnight-publications
articles published in 2004 citing multivariate data analysis	( call SW.listValue ( call SW.filter ( call SW.filter ( call SW.getProperty ( call SW.singleton en.article ) ( string ! type ) ) ( string publication_date ) ( string = ) ( date 2004 -1 -1 ) ) ( string cites ) ( string = ) en.article.multivariate_data_analysis ) )	overnight-publications
article publication of multivariate data analysis	( call SW.listValue ( call SW.filter ( call SW.getProperty ( call SW.singleton en.article ) ( string ! type ) ) ( string venue ) ( string = ) ( call SW.filter ( call SW.getProperty ( call SW.singleton en.venue ) ( string ! type ) ) ( call SW.reverse ( string venue ) ) ( string = ) en.article.multivariate_data_analysis ) ) )	overnight-publications
when was multivariate data analysis published	( call SW.listValue ( call SW.getProperty en.article.multivariate_data_analysis ( string publication_date ) ) )	overnight-publications
what article was in less than two venues	( call SW.listValue ( call SW.countComparative ( call SW.getProperty ( call SW.singleton en.article ) ( string ! type ) ) ( string venue ) ( string < ) ( number 2 ) ) )	overnight-publications
how many people	( call SW.listValue ( call .size ( call SW.getProperty ( call SW.singleton en.person ) ( string ! type ) ) ) )	overnight-publications
articles by efron published in 2004	( call SW.listValue ( call SW.filter ( call SW.filter ( call SW.getProperty ( call SW.singleton en.article ) ( string ! type ) ) ( string author ) ( string = ) en.person.efron ) ( string publication_date ) ( string = ) ( date 2004 -1 -1 ) ) )	overnight-publications
article whose publication date is smaller than publication date of multivariate data analysis	( call SW.listValue ( call SW.filter ( call SW.getProperty ( call SW.singleton en.article ) ( string ! type ) ) ( call SW.ensureNumericProperty ( string publication_date ) ) ( string < ) ( call SW.ensureNumericEntity ( call SW.getProperty en.article.multivariate_data_analysis ( string publication_date ) ) ) ) )	overnight-publications
article whose author is efron	( call SW.listValue ( call SW.filter ( call SW.getProperty ( call SW.singleton en.article ) ( string ! type ) ) ( call SW.reverse ( string cites ) ) ( string = ) ( call SW.filter ( call SW.getProperty ( call SW.singleton en.article ) ( string ! type ) ) ( string author ) ( string = ) en.person.efron ) ) )	overnight-publications
which article cites the fewest articles	( call SW.listValue ( call SW.countSuperlative ( call SW.getProperty ( call SW.singleton en.article ) ( string ! type ) ) ( string min ) ( string cites ) ( call SW.getProperty ( call SW.singleton en.article ) ( string ! type ) ) ) )	overnight-publications
articles cited by multivariate data analysis and published in annals of statistics	( call SW.listValue ( call SW.filter ( call SW.filter ( call SW.getProperty ( call SW.singleton en.article ) ( string ! type ) ) ( call SW.reverse ( string cites ) ) ( string = ) en.article.multivariate_data_analysis ) ( string venue ) ( string = ) en.venue.annals_of_statistics ) )	overnight-publications
what venue has two articles	( call SW.listValue ( call SW.countComparative ( call SW.getProperty ( call SW.singleton en.venue ) ( string ! type ) ) ( call SW.reverse ( string venue ) ) ( string = ) ( number 2 ) ( call SW.getProperty ( call SW.singleton en.article ) ( string ! type ) ) ) )	overnight-publications
articles published contemporaneous to or before the multivariate data analysis	( call SW.listValue ( call SW.filter ( call SW.getProperty ( call SW.singleton en.article ) ( string ! type ) ) ( call SW.ensureNumericProperty ( string publication_date ) ) ( string <= ) ( call SW.ensureNumericEntity ( call SW.getProperty en.article.multivariate_data_analysis ( string publication_date ) ) ) ) )	overnight-publications
author of two articles	( call SW.listValue ( call SW.countComparative ( call SW.getProperty ( call SW.singleton en.person ) ( string ! type ) ) ( call SW.reverse ( string author ) ) ( string = ) ( number 2 ) ( call SW.getProperty ( call SW.singleton en.article ) ( string ! type ) ) ) )	overnight-publications
article that has the least number of venue	( call SW.listValue ( call SW.countSuperlative ( call SW.getProperty ( call SW.singleton en.article ) ( string ! type ) ) ( string min ) ( string venue ) ) )	overnight-publications
articles published in two or more venues	( call SW.listValue ( call SW.countComparative ( call SW.getProperty ( call SW.singleton en.article ) ( string ! type ) ) ( string venue ) ( string >= ) ( number 2 ) ) )	overnight-publications
article that does not cite multivariate data analysis	( call SW.listValue ( call SW.filter ( call SW.getProperty ( call SW.singleton en.article ) ( string ! type ) ) ( call SW.reverse ( string cites ) ) ( string ! = ) en.article.multivariate_data_analysis ) )	overnight-publications
what articles are published in annals of statistics	( call SW.listValue ( call SW.filter ( call SW.getProperty ( call SW.singleton en.article ) ( string ! type ) ) ( call SW.reverse ( string cites ) ) ( string = ) ( call SW.filter ( call SW.getProperty ( call SW.singleton en.article ) ( string ! type ) ) ( string venue ) ( string = ) en.venue.annals_of_statistics ) ) )	overnight-publications
an article on statistics that cites multivariate data analysis	( call SW.listValue ( call SW.filter ( call SW.filter ( call SW.getProperty ( call SW.singleton en.article ) ( string ! type ) ) ( string cites ) ( string = ) en.article.multivariate_data_analysis ) ( string venue ) ( string = ) en.venue.annals_of_statistics ) )	overnight-publications
venues of articles cited by multivariate data analysis	( call SW.listValue ( call SW.filter ( call SW.getProperty ( call SW.singleton en.venue ) ( string ! type ) ) ( call SW.reverse ( string venue ) ) ( string = ) ( call SW.filter ( call SW.getProperty ( call SW.singleton en.article ) ( string ! type ) ) ( call SW.reverse ( string cites ) ) ( string = ) en.article.multivariate_data_analysis ) ) )	overnight-publications
article with two or more publishers	( call SW.listValue ( call SW.countComparative ( call SW.getProperty ( call SW.singleton en.article ) ( string ! type ) ) ( string venue ) ( string >= ) ( number 2 ) ) )	overnight-publications
who is someone that has not authored an article about multivariate data analysis	( call SW.listValue ( call SW.filter ( call SW.getProperty ( call SW.singleton en.person ) ( string ! type ) ) ( call SW.reverse ( string author ) ) ( string ! = ) en.article.multivariate_data_analysis ) )	overnight-publications
which article was published in 2004 authored by efron	( call SW.listValue ( call SW.filter ( call SW.filter ( call SW.getProperty ( call SW.singleton en.article ) ( string ! type ) ) ( string author ) ( string = ) en.person.efron ) ( string publication_date ) ( string = ) ( date 2004 -1 -1 ) ) )	overnight-publications
name a person who is the author of an article about multivariate data analysis	( call SW.listValue ( call SW.filter ( call SW.filter ( call SW.getProperty ( call SW.singleton en.person ) ( string ! type ) ) ( call SW.reverse ( string author ) ) ( string = ) en.article.multivariate_data_analysis ) ( call SW.reverse ( string author ) ) ( string = ) en.article.multivariate_data_analysis ) )	overnight-publications
what author wrote about annals of statistics	( call SW.listValue ( call SW.filter ( call SW.getProperty ( call SW.singleton en.person ) ( string ! type ) ) ( call SW.reverse ( string author ) ) ( string = ) ( call SW.filter ( call SW.getProperty ( call SW.singleton en.article ) ( string ! type ) ) ( string venue ) ( string = ) en.venue.annals_of_statistics ) ) )	overnight-publications
venue that is mentioned in at least  two articles	( call SW.listValue ( call SW.countComparative ( call SW.getProperty ( call SW.singleton en.venue ) ( string ! type ) ) ( call SW.reverse ( string venue ) ) ( string >= ) ( number 2 ) ( call SW.getProperty ( call SW.singleton en.article ) ( string ! type ) ) ) )	overnight-publications
articles with fewer than two authors	( call SW.listValue ( call SW.countComparative ( call SW.getProperty ( call SW.singleton en.article ) ( string ! type ) ) ( string author ) ( string < ) ( number 2 ) ) )	overnight-publications
find any article that efron didnt write	( call SW.listValue ( call SW.filter ( call SW.getProperty ( call SW.singleton en.article ) ( string ! type ) ) ( string author ) ( string ! = ) en.person.efron ) )	overnight-publications
what article cites articles written by efron	( call SW.listValue ( call SW.filter ( call SW.getProperty ( call SW.singleton en.article ) ( string ! type ) ) ( string cites ) ( string = ) ( call SW.filter ( call SW.getProperty ( call SW.singleton en.article ) ( string ! type ) ) ( string author ) ( string = ) en.person.efron ) ) )	overnight-publications
article whose publication date is 2004 and cited by multivariate data analysis	( call SW.listValue ( call SW.filter ( call SW.filter ( call SW.getProperty ( call SW.singleton en.article ) ( string ! type ) ) ( string publication_date ) ( string = ) ( date 2004 -1 -1 ) ) ( call SW.reverse ( string cites ) ) ( string = ) en.article.multivariate_data_analysis ) )	overnight-publications
in what publication was multivariate data analysis published	( call SW.listValue ( call SW.filter ( call SW.getProperty ( call SW.singleton en.venue ) ( string ! type ) ) ( call SW.reverse ( string venue ) ) ( string = ) en.article.multivariate_data_analysis ) )	overnight-publications
articles that cite the most articles	( call SW.listValue ( call SW.countSuperlative ( call SW.getProperty ( call SW.singleton en.article ) ( string ! type ) ) ( string max ) ( string cites ) ( call SW.getProperty ( call SW.singleton en.article ) ( string ! type ) ) ) )	overnight-publications
name an article with more than two authors	( call SW.listValue ( call SW.countComparative ( call SW.getProperty ( call SW.singleton en.article ) ( string ! type ) ) ( string author ) ( string > ) ( number 2 ) ) )	overnight-publications
articles cited by multivariate data analysis published in 2004	( call SW.listValue ( call SW.filter ( call SW.filter ( call SW.getProperty ( call SW.singleton en.article ) ( string ! type ) ) ( call SW.reverse ( string cites ) ) ( string = ) en.article.multivariate_data_analysis ) ( string publication_date ) ( string = ) ( date 2004 -1 -1 ) ) )	overnight-publications
articles published in or after 2004	( call SW.listValue ( call SW.filter ( call SW.getProperty ( call SW.singleton en.article ) ( string ! type ) ) ( call SW.ensureNumericProperty ( string publication_date ) ) ( string >= ) ( call SW.ensureNumericEntity ( date 2004 -1 -1 ) ) ) )	overnight-publications
which articles cite more than two articles	( call SW.listValue ( call SW.countComparative ( call SW.getProperty ( call SW.singleton en.article ) ( string ! type ) ) ( call SW.reverse ( string cites ) ) ( string > ) ( number 2 ) ( call SW.getProperty ( call SW.singleton en.article ) ( string ! type ) ) ) )	overnight-publications
article citing awardwinning article	( call SW.listValue ( call SW.filter ( call SW.getProperty ( call SW.singleton en.article ) ( string ! type ) ) ( call SW.reverse ( string cites ) ) ( string = ) ( call SW.filter ( call SW.getProperty ( call SW.singleton en.article ) ( string ! type ) ) ( string won_award ) ) ) )	overnight-publications
what article is written by efron and won an award	( call SW.listValue ( call SW.filter ( call SW.filter ( call SW.getProperty ( call SW.singleton en.article ) ( string ! type ) ) ( string author ) ( string = ) en.person.efron ) ( string won_award ) ) )	overnight-publications
article that does not cite multivariate data analysis	( call SW.listValue ( call SW.filter ( call SW.getProperty ( call SW.singleton en.article ) ( string ! type ) ) ( call SW.reverse ( string cites ) ) ( string ! = ) en.article.multivariate_data_analysis ) )	overnight-publications
article that cites multivariate data analysis	( call SW.listValue ( call SW.filter ( call SW.filter ( call SW.getProperty ( call SW.singleton en.article ) ( string ! type ) ) ( call SW.reverse ( string cites ) ) ( string = ) en.article.multivariate_data_analysis ) ( string cites ) ( string = ) en.article.multivariate_data_analysis ) )	overnight-publications
publications that do not publish multivariate data analysis	( call SW.listValue ( call SW.filter ( call SW.getProperty ( call SW.singleton en.venue ) ( string ! type ) ) ( call SW.reverse ( string venue ) ) ( string ! = ) en.article.multivariate_data_analysis ) )	overnight-publications
articles written by at least two authors	( call SW.listValue ( call SW.countComparative ( call SW.getProperty ( call SW.singleton en.article ) ( string ! type ) ) ( string author ) ( string >= ) ( number 2 ) ) )	overnight-publications
article whose publication date is 2004 and whose author is efron	( call SW.listValue ( call SW.filter ( call SW.filter ( call SW.getProperty ( call SW.singleton en.article ) ( string ! type ) ) ( string publication_date ) ( string = ) ( date 2004 -1 -1 ) ) ( string author ) ( string = ) en.person.efron ) )	overnight-publications
article that the least number of article cites	( call SW.listValue ( call SW.countSuperlative ( call SW.getProperty ( call SW.singleton en.article ) ( string ! type ) ) ( string min ) ( call SW.reverse ( string cites ) ) ( call SW.getProperty ( call SW.singleton en.article ) ( string ! type ) ) ) )	overnight-publications
articles written by two authors at most	( call SW.listValue ( call SW.countComparative ( call SW.getProperty ( call SW.singleton en.article ) ( string ! type ) ) ( string author ) ( string <= ) ( number 2 ) ) )	overnight-publications
article that cited multivariate data analysis in annals of statistics	( call SW.listValue ( call SW.filter ( call SW.filter ( call SW.getProperty ( call SW.singleton en.article ) ( string ! type ) ) ( string venue ) ( string = ) en.venue.annals_of_statistics ) ( string cites ) ( string = ) en.article.multivariate_data_analysis ) )	overnight-publications
articles that cite articles published in 2004	( call SW.listValue ( call SW.filter ( call SW.getProperty ( call SW.singleton en.article ) ( string ! type ) ) ( string cites ) ( string = ) ( call SW.filter ( call SW.getProperty ( call SW.singleton en.article ) ( string ! type ) ) ( string publication_date ) ( string = ) ( date 2004 -1 -1 ) ) ) )	overnight-publications
what is the venue of the article published in 2004	( call SW.listValue ( call SW.filter ( call SW.getProperty ( call SW.singleton en.venue ) ( string ! type ) ) ( call SW.reverse ( string venue ) ) ( string = ) ( call SW.filter ( call SW.getProperty ( call SW.singleton en.article ) ( string ! type ) ) ( string publication_date ) ( string = ) ( date 2004 -1 -1 ) ) ) )	overnight-publications
articles written by efron published in 2004	( call SW.listValue ( call SW.filter ( call SW.filter ( call SW.getProperty ( call SW.singleton en.article ) ( string ! type ) ) ( string publication_date ) ( string = ) ( date 2004 -1 -1 ) ) ( string author ) ( string = ) en.person.efron ) )	overnight-publications
what article has a publication date of at least 2004	( call SW.listValue ( call SW.filter ( call SW.getProperty ( call SW.singleton en.article ) ( string ! type ) ) ( call SW.ensureNumericProperty ( string publication_date ) ) ( string >= ) ( call SW.ensureNumericEntity ( date 2004 -1 -1 ) ) ) )	overnight-publications
what article cites two other articles	( call SW.listValue ( call SW.countComparative ( call SW.getProperty ( call SW.singleton en.article ) ( string ! type ) ) ( string cites ) ( string = ) ( number 2 ) ( call SW.getProperty ( call SW.singleton en.article ) ( string ! type ) ) ) )	overnight-publications
what article won an award	( call SW.listValue ( call SW.filter ( call SW.getProperty ( call SW.singleton en.article ) ( string ! type ) ) ( string won_award ) ) )	overnight-publications
articles citing two articles	( call SW.listValue ( call SW.countComparative ( call SW.getProperty ( call SW.singleton en.article ) ( string ! type ) ) ( string cites ) ( string = ) ( number 2 ) ( call SW.getProperty ( call SW.singleton en.article ) ( string ! type ) ) ) )	overnight-publications
article that cites multivariate data analysis that is published in 2004	( call SW.listValue ( call SW.filter ( call SW.filter ( call SW.getProperty ( call SW.singleton en.article ) ( string ! type ) ) ( string cites ) ( string = ) en.article.multivariate_data_analysis ) ( string publication_date ) ( string = ) ( date 2004 -1 -1 ) ) )	overnight-publications
what article is not cited in multivariate data analysis	( call SW.listValue ( call SW.filter ( call SW.getProperty ( call SW.singleton en.article ) ( string ! type ) ) ( call SW.reverse ( string cites ) ) ( string ! = ) en.article.multivariate_data_analysis ) )	overnight-publications
article citing article published in annals of statistics	( call SW.listValue ( call SW.filter ( call SW.getProperty ( call SW.singleton en.article ) ( string ! type ) ) ( call SW.reverse ( string cites ) ) ( string = ) ( call SW.filter ( call SW.getProperty ( call SW.singleton en.article ) ( string ! type ) ) ( string venue ) ( string = ) en.venue.annals_of_statistics ) ) )	overnight-publications
what article was written by efron and cities multivariate data analysis	( call SW.listValue ( call SW.filter ( call SW.filter ( call SW.getProperty ( call SW.singleton en.article ) ( string ! type ) ) ( string cites ) ( string = ) en.article.multivariate_data_analysis ) ( string author ) ( string = ) en.person.efron ) )	overnight-publications
author of article cited by multivariate data analysis	( call SW.listValue ( call SW.filter ( call SW.getProperty ( call SW.singleton en.person ) ( string ! type ) ) ( call SW.reverse ( string author ) ) ( string = ) ( call SW.filter ( call SW.getProperty ( call SW.singleton en.article ) ( string ! type ) ) ( call SW.reverse ( string cites ) ) ( string = ) en.article.multivariate_data_analysis ) ) )	overnight-publications
what article exchanged citations with multivariate data analysis	( call SW.listValue ( call SW.filter ( call SW.filter ( call SW.getProperty ( call SW.singleton en.article ) ( string ! type ) ) ( call SW.reverse ( string cites ) ) ( string = ) en.article.multivariate_data_analysis ) ( string cites ) ( string = ) en.article.multivariate_data_analysis ) )	overnight-publications
what article has a publication date of 2004	( call SW.listValue ( call SW.filter ( call SW.getProperty ( call SW.singleton en.venue ) ( string ! type ) ) ( call SW.reverse ( string venue ) ) ( string = ) ( call SW.filter ( call SW.getProperty ( call SW.singleton en.article ) ( string ! type ) ) ( string publication_date ) ( string = ) ( date 2004 -1 -1 ) ) ) )	overnight-publications
what article was published on or before 2004	( call SW.listValue ( call SW.filter ( call SW.getProperty ( call SW.singleton en.article ) ( string ! type ) ) ( call SW.ensureNumericProperty ( string publication_date ) ) ( string <= ) ( call SW.ensureNumericEntity ( date 2004 -1 -1 ) ) ) )	overnight-publications
what article cites an article cited by multivariate data analysis	( call SW.listValue ( call SW.filter ( call SW.getProperty ( call SW.singleton en.article ) ( string ! type ) ) ( string cites ) ( string = ) ( call SW.filter ( call SW.getProperty ( call SW.singleton en.article ) ( string ! type ) ) ( call SW.reverse ( string cites ) ) ( string = ) en.article.multivariate_data_analysis ) ) )	overnight-publications
award winning article cited bymultivariate data analysis	( call SW.listValue ( call SW.filter ( call SW.filter ( call SW.getProperty ( call SW.singleton en.article ) ( string ! type ) ) ( call SW.reverse ( string cites ) ) ( string = ) en.article.multivariate_data_analysis ) ( string won_award ) ) )	overnight-publications
article with two publishers	( call SW.listValue ( call SW.countComparative ( call SW.getProperty ( call SW.singleton en.article ) ( string ! type ) ) ( string venue ) ( string = ) ( number 2 ) ) )	overnight-publications
any article that cites another article published in annals of statistics	( call SW.listValue ( call SW.filter ( call SW.getProperty ( call SW.singleton en.article ) ( string ! type ) ) ( string cites ) ( string = ) ( call SW.filter ( call SW.getProperty ( call SW.singleton en.article ) ( string ! type ) ) ( string venue ) ( string = ) en.venue.annals_of_statistics ) ) )	overnight-publications
name an author of at least two articles	( call SW.listValue ( call SW.countComparative ( call SW.getProperty ( call SW.singleton en.person ) ( string ! type ) ) ( call SW.reverse ( string author ) ) ( string >= ) ( number 2 ) ( call SW.getProperty ( call SW.singleton en.article ) ( string ! type ) ) ) )	overnight-publications
article whose venue is annals of statistics and that won an award	( call SW.listValue ( call SW.filter ( call SW.filter ( call SW.getProperty ( call SW.singleton en.article ) ( string ! type ) ) ( string venue ) ( string = ) en.venue.annals_of_statistics ) ( string won_award ) ) )	overnight-publications
what article is cited by an article in annals of statistics	( call SW.listValue ( call SW.filter ( call SW.getProperty ( call SW.singleton en.article ) ( string ! type ) ) ( call SW.reverse ( string cites ) ) ( string = ) ( call SW.filter ( call SW.getProperty ( call SW.singleton en.article ) ( string ! type ) ) ( string venue ) ( string = ) en.venue.annals_of_statistics ) ) )	overnight-publications
which articles cite two or fewer articles	( call SW.listValue ( call SW.countComparative ( call SW.getProperty ( call SW.singleton en.article ) ( string ! type ) ) ( call SW.reverse ( string cites ) ) ( string <= ) ( number 2 ) ( call SW.getProperty ( call SW.singleton en.article ) ( string ! type ) ) ) )	overnight-publications
articles published in 2004 that have won an award	( call SW.listValue ( call SW.filter ( call SW.filter ( call SW.getProperty ( call SW.singleton en.article ) ( string ! type ) ) ( string won_award ) ) ( string publication_date ) ( string = ) ( date 2004 -1 -1 ) ) )	overnight-publications
who is the author of multivariate data analysis	( call SW.listValue ( call SW.filter ( call SW.getProperty ( call SW.singleton en.person ) ( string ! type ) ) ( call SW.reverse ( string author ) ) ( string = ) en.article.multivariate_data_analysis ) )	overnight-publications
what article makes the fewest citations	( call SW.listValue ( call SW.countSuperlative ( call SW.getProperty ( call SW.singleton en.article ) ( string ! type ) ) ( string min ) ( call SW.reverse ( string cites ) ) ( call SW.getProperty ( call SW.singleton en.article ) ( string ! type ) ) ) )	overnight-publications
articles that won an award published in annals of statistics	( call SW.listValue ( call SW.filter ( call SW.filter ( call SW.getProperty ( call SW.singleton en.article ) ( string ! type ) ) ( string won_award ) ) ( string venue ) ( string = ) en.venue.annals_of_statistics ) )	overnight-publications
name an article from 2004 about multivariate data analysis	( call SW.listValue ( call SW.filter ( call SW.filter ( call SW.getProperty ( call SW.singleton en.article ) ( string ! type ) ) ( call SW.reverse ( string cites ) ) ( string = ) en.article.multivariate_data_analysis ) ( string publication_date ) ( string = ) ( date 2004 -1 -1 ) ) )	overnight-publications
articles with two authors	( call SW.listValue ( call SW.countComparative ( call SW.getProperty ( call SW.singleton en.article ) ( string ! type ) ) ( string author ) ( string = ) ( number 2 ) ) )	overnight-publications
article that multivariate data analysis cites	( call SW.listValue ( call SW.filter ( call SW.filter ( call SW.getProperty ( call SW.singleton en.article ) ( string ! type ) ) ( call SW.reverse ( string cites ) ) ( string = ) en.article.multivariate_data_analysis ) ( call SW.reverse ( string cites ) ) ( string = ) en.article.multivariate_data_analysis ) )	overnight-publications
articles cited by multivariate data analysis that won awards	( call SW.listValue ( call SW.filter ( call SW.filter ( call SW.getProperty ( call SW.singleton en.article ) ( string ! type ) ) ( call SW.reverse ( string cites ) ) ( string = ) en.article.multivariate_data_analysis ) ( string won_award ) ) )	overnight-publications
what article has fewer than two venues	( call SW.listValue ( call SW.countComparative ( call SW.getProperty ( call SW.singleton en.article ) ( string ! type ) ) ( string venue ) ( string < ) ( number 2 ) ) )	overnight-publications
