total points of kob bryant over a season	( call SW.listValue ( call SW.getProperty ( call SW.getProperty en.player.kobe_bryant ( call SW.reverse ( string player ) ) ) ( string num_points ) ) )	overnight-basketball
how many fouls did kobe bryant have when he had 3 rebounds	( call SW.listValue ( call SW.getProperty ( call SW.filter ( call SW.getProperty en.player.kobe_bryant ( call SW.reverse ( string player ) ) ) ( string num_rebounds ) ( string = ) ( number 3 rebound ) ) ( string num_fouls ) ) )	overnight-basketball
what position did kobe bryant play when he had 3 blocks in a season	( call SW.listValue ( call SW.getProperty ( call SW.filter ( call SW.getProperty en.player.kobe_bryant ( call SW.reverse ( string player ) ) ) ( string num_blocks ) ( string = ) ( number 3 block ) ) ( string position ) ) )	overnight-basketball
which player has played for the most teams	( call SW.listValue ( call SW.getProperty ( ( lambda s ( call SW.countSuperlative ( var s ) ( string max ) ( string team ) ) ) ( call SW.domain ( string player ) ) ) ( string player ) ) )	overnight-basketball
whos made the most assists from the start of the season	( call SW.listValue ( call SW.getProperty ( ( lambda s ( call SW.superlative ( var s ) ( string max ) ( call SW.ensureNumericProperty ( string num_assists ) ) ) ) ( call SW.domain ( string player ) ) ) ( string player ) ) )	overnight-basketball
how many steals did kobe bryant make	( call SW.listValue ( call SW.getProperty ( call SW.getProperty en.player.kobe_bryant ( call SW.reverse ( string player ) ) ) ( string num_steals ) ) )	overnight-basketball
is there a player with the same number of turnovers in a specific season as kobe bryant has in a specific season as well	( call SW.listValue ( call SW.getProperty ( ( lambda s ( call SW.filter ( var s ) ( string num_turnovers ) ( string = ) ( call SW.getProperty ( call SW.getProperty en.player.kobe_bryant ( call SW.reverse ( string player ) ) ) ( string num_turnovers ) ) ) ) ( call SW.domain ( string player ) ) ) ( string player ) ) )	overnight-basketball
which player leads kobe bryant for rebounds per season	( call SW.listValue ( call SW.getProperty ( ( lambda s ( call SW.filter ( var s ) ( call SW.ensureNumericProperty ( string num_rebounds ) ) ( string >= ) ( call SW.ensureNumericEntity ( call SW.getProperty ( call SW.getProperty en.player.kobe_bryant ( call SW.reverse ( string player ) ) ) ( string num_rebounds ) ) ) ) ) ( call SW.domain ( string player ) ) ) ( string player ) ) )	overnight-basketball
find the season in which kobe bryant had a total number of 3 steals	( call SW.listValue ( call SW.getProperty ( call SW.filter ( call SW.getProperty en.player.kobe_bryant ( call SW.reverse ( string player ) ) ) ( string num_steals ) ( string = ) ( number 3 steal ) ) ( string num_steals ) ) )	overnight-basketball
how many fouls did kobe bryant have after 3 games	( call SW.listValue ( call SW.getProperty ( call SW.filter ( call SW.getProperty en.player.kobe_bryant ( call SW.reverse ( string player ) ) ) ( string num_games_played ) ( string = ) ( number 3 game ) ) ( string num_fouls ) ) )	overnight-basketball
the number of turnovers of player kobe bryant over this season is 3	( call SW.listValue ( call SW.getProperty ( call SW.filter ( call SW.getProperty en.player.kobe_bryant ( call SW.reverse ( string player ) ) ) ( string num_turnovers ) ( string = ) ( number 3 turnover ) ) ( string num_turnovers ) ) )	overnight-basketball
what player has as much fouls as maximum fouls kob bryant made over a season	( call SW.listValue ( call SW.getProperty ( ( lambda s ( call SW.filter ( var s ) ( call SW.ensureNumericProperty ( string num_fouls ) ) ( string <= ) ( call SW.ensureNumericEntity ( call SW.getProperty ( call SW.getProperty en.player.kobe_bryant ( call SW.reverse ( string player ) ) ) ( string num_fouls ) ) ) ) ) ( call SW.domain ( string player ) ) ) ( string player ) ) )	overnight-basketball
how many games did kobe bryant have three turnovers over the season	( call SW.listValue ( call SW.getProperty ( call SW.filter ( call SW.getProperty en.player.kobe_bryant ( call SW.reverse ( string player ) ) ) ( string num_turnovers ) ( string = ) ( number 3 turnover ) ) ( string num_games_played ) ) )	overnight-basketball
number of fouls over a season of player kobe bryant from los angeles lakers team	( call SW.listValue ( call SW.getProperty ( call SW.filter ( call SW.getProperty en.player.kobe_bryant ( call SW.reverse ( string player ) ) ) ( string team ) ( string = ) en.team.lakers ) ( string num_fouls ) ) )	overnight-basketball
players with less blocks than kobe bryant over all seasons	( call SW.listValue ( call SW.getProperty ( ( lambda s ( call SW.filter ( var s ) ( call SW.ensureNumericProperty ( string num_blocks ) ) ( string < ) ( call SW.ensureNumericEntity ( call SW.getProperty ( call SW.getProperty en.player.kobe_bryant ( call SW.reverse ( string player ) ) ) ( string num_blocks ) ) ) ) ) ( call SW.domain ( string player ) ) ) ( string player ) ) )	overnight-basketball
player with most number of steals over a season	( call SW.listValue ( call SW.getProperty ( ( lambda s ( call SW.superlative ( var s ) ( string max ) ( call SW.ensureNumericProperty ( string num_steals ) ) ) ) ( call SW.domain ( string player ) ) ) ( string player ) ) )	overnight-basketball
players with no more than 3 steals a season	( call SW.listValue ( call SW.getProperty ( ( lambda s ( call SW.filter ( var s ) ( call SW.ensureNumericProperty ( string num_steals ) ) ( string <= ) ( call SW.ensureNumericEntity ( number 3 steal ) ) ) ) ( call SW.domain ( string player ) ) ) ( string player ) ) )	overnight-basketball
what is the position of player kobe bryant with 3 rebounds over this season	( call SW.listValue ( call SW.getProperty ( call SW.filter ( call SW.getProperty en.player.kobe_bryant ( call SW.reverse ( string player ) ) ) ( string num_rebounds ) ( string = ) ( number 3 rebound ) ) ( string position ) ) )	overnight-basketball
player whose number of turnovers over a season is more than that of player kobe bryant over a season	( call SW.listValue ( call SW.getProperty ( ( lambda s ( call SW.filter ( var s ) ( call SW.ensureNumericProperty ( string num_turnovers ) ) ( string > ) ( call SW.ensureNumericEntity ( call SW.getProperty ( call SW.getProperty en.player.kobe_bryant ( call SW.reverse ( string player ) ) ) ( string num_turnovers ) ) ) ) ) ( call SW.domain ( string player ) ) ) ( string player ) ) )	overnight-basketball
player whoplayed less games over a season than player kobe bryant has played over a season	( call SW.listValue ( call SW.getProperty ( ( lambda s ( call SW.filter ( var s ) ( call SW.ensureNumericProperty ( string num_games_played ) ) ( string < ) ( call SW.ensureNumericEntity ( call SW.getProperty ( call SW.getProperty en.player.kobe_bryant ( call SW.reverse ( string player ) ) ) ( string num_games_played ) ) ) ) ) ( call SW.domain ( string player ) ) ) ( string player ) ) )	overnight-basketball
how many points did kobe bryant score after 3 games	( call SW.listValue ( call SW.getProperty ( call SW.filter ( call SW.getProperty en.player.kobe_bryant ( call SW.reverse ( string player ) ) ) ( string num_games_played ) ( string = ) ( number 3 game ) ) ( string num_points ) ) )	overnight-basketball
what season did kobe bryant get 3 assists	( call SW.listValue ( call SW.getProperty ( call SW.filter ( call SW.getProperty en.player.kobe_bryant ( call SW.reverse ( string player ) ) ) ( string num_assists ) ( string = ) ( number 3 assist ) ) ( string season ) ) )	overnight-basketball
find players responsible for the same amount of assists in any one specific season as kobe bryant	( call SW.listValue ( call SW.getProperty ( ( lambda s ( call SW.filter ( var s ) ( string num_assists ) ( string = ) ( call SW.getProperty ( call SW.getProperty en.player.kobe_bryant ( call SW.reverse ( string player ) ) ) ( string num_assists ) ) ) ) ( call SW.domain ( string player ) ) ) ( string player ) ) )	overnight-basketball
how many blocks does kobe bryant have in a season with at least 3 turnovers	( call SW.listValue ( call SW.getProperty ( call SW.filter ( call SW.getProperty en.player.kobe_bryant ( call SW.reverse ( string player ) ) ) ( string num_turnovers ) ( string = ) ( number 3 turnover ) ) ( string num_blocks ) ) )	overnight-basketball
who leads the points race so far this season	( call SW.listValue ( call SW.getProperty ( ( lambda s ( call SW.superlative ( var s ) ( string max ) ( call SW.ensureNumericProperty ( string num_points ) ) ) ) ( call SW.domain ( string player ) ) ) ( string player ) ) )	overnight-basketball
which year 2004 or 2010	( call SW.listValue ( call SW.concat ( date 2004 -1 -1 ) ( date 2010 -1 -1 ) ) )	overnight-basketball
what players had more 3 or more turnovers in a game	( call SW.listValue ( call SW.getProperty ( ( lambda s ( call SW.filter ( var s ) ( call SW.ensureNumericProperty ( string num_turnovers ) ) ( string >= ) ( call SW.ensureNumericEntity ( number 3 turnover ) ) ) ) ( call SW.domain ( string player ) ) ) ( string player ) ) )	overnight-basketball
who has had more than 3 assists	( call SW.listValue ( call SW.getProperty ( ( lambda s ( call SW.filter ( var s ) ( call SW.ensureNumericProperty ( string num_assists ) ) ( string > ) ( call SW.ensureNumericEntity ( number 3 assist ) ) ) ) ( call SW.domain ( string player ) ) ) ( string player ) ) )	overnight-basketball
what was the total number of games played by kobe bryant in season where he had only three rebounds	( call SW.listValue ( call SW.getProperty ( call SW.filter ( call SW.getProperty en.player.kobe_bryant ( call SW.reverse ( string player ) ) ) ( string num_rebounds ) ( string = ) ( number 3 rebound ) ) ( string num_games_played ) ) )	overnight-basketball
how many assists did kobe get after scoring 3 points 	( call SW.listValue ( call SW.getProperty ( call SW.filter ( call SW.getProperty en.player.kobe_bryant ( call SW.reverse ( string player ) ) ) ( string num_points ) ( string = ) ( number 3 point ) ) ( string num_assists ) ) )	overnight-basketball
which player had the most career blocks per season	( call SW.listValue ( call SW.getProperty ( ( lambda s ( call SW.superlative ( var s ) ( string max ) ( call SW.ensureNumericProperty ( string num_blocks ) ) ) ) ( call SW.domain ( string player ) ) ) ( string player ) ) )	overnight-basketball
how many blocks did kobe bryant make when he had three points	( call SW.listValue ( call SW.getProperty ( call SW.filter ( call SW.getProperty en.player.kobe_bryant ( call SW.reverse ( string player ) ) ) ( string num_points ) ( string = ) ( number 3 point ) ) ( string num_blocks ) ) )	overnight-basketball
how many points does kobe bryant average over a season	( call SW.listValue ( call SW.getProperty ( ( lambda s ( call SW.filter ( var s ) ( string num_points ) ( string ! = ) ( number 3 point ) ) ) ( call SW.domain ( string player ) ) ) ( string player ) ) )	overnight-basketball
player who has most rebounds over a season	( call SW.listValue ( call SW.getProperty ( ( lambda s ( call SW.superlative ( var s ) ( string max ) ( call SW.ensureNumericProperty ( string num_rebounds ) ) ) ) ( call SW.domain ( string player ) ) ) ( string player ) ) )	overnight-basketball
what player had less than 3 points	( call SW.listValue ( call SW.getProperty ( ( lambda s ( call SW.filter ( var s ) ( call SW.ensureNumericProperty ( string num_points ) ) ( string < ) ( call SW.ensureNumericEntity ( number 3 point ) ) ) ) ( call SW.domain ( string player ) ) ) ( string player ) ) )	overnight-basketball
who has at most 3 assists total in a season	( call SW.listValue ( call SW.getProperty ( ( lambda s ( call SW.filter ( var s ) ( call SW.ensureNumericProperty ( string num_assists ) ) ( string <= ) ( call SW.ensureNumericEntity ( number 3 assist ) ) ) ) ( call SW.domain ( string player ) ) ) ( string player ) ) )	overnight-basketball
number of steals of point guard kobe bryant	( call SW.listValue ( call SW.getProperty ( call SW.filter ( call SW.getProperty en.player.kobe_bryant ( call SW.reverse ( string player ) ) ) ( string position ) ( string = ) en.position.point_guard ) ( string num_steals ) ) )	overnight-basketball
how many allseason points did kobe bryant score when rebounds equaled 3	( call SW.listValue ( call SW.getProperty ( call SW.filter ( call SW.getProperty en.player.kobe_bryant ( call SW.reverse ( string player ) ) ) ( string num_rebounds ) ( string = ) ( number 3 rebound ) ) ( string num_points ) ) )	overnight-basketball
player who has less than 3 blocks over a season	( call SW.listValue ( call SW.getProperty ( ( lambda s ( call SW.filter ( var s ) ( call SW.ensureNumericProperty ( string num_blocks ) ) ( string < ) ( call SW.ensureNumericEntity ( number 3 block ) ) ) ) ( call SW.domain ( string player ) ) ) ( string player ) ) )	overnight-basketball
which player had no more than three turnovers	( call SW.listValue ( call SW.getProperty ( ( lambda s ( call SW.filter ( var s ) ( call SW.ensureNumericProperty ( string num_turnovers ) ) ( string <= ) ( call SW.ensureNumericEntity ( number 3 turnover ) ) ) ) ( call SW.domain ( string player ) ) ) ( string player ) ) )	overnight-basketball
how many threepoint turnovers did kobe bryant have	( call SW.listValue ( call SW.getProperty ( call SW.filter ( call SW.getProperty en.player.kobe_bryant ( call SW.reverse ( string player ) ) ) ( string num_points ) ( string = ) ( number 3 point ) ) ( string num_turnovers ) ) )	overnight-basketball
how many fouls does kobe bryant have at point guard	( call SW.listValue ( call SW.getProperty ( call SW.filter ( call SW.getProperty en.player.kobe_bryant ( call SW.reverse ( string player ) ) ) ( string position ) ( string = ) en.position.point_guard ) ( string num_fouls ) ) )	overnight-basketball
how many turnovers has kobe bryant had	( call SW.listValue ( call SW.getProperty ( call SW.filter ( call SW.getProperty en.player.kobe_bryant ( call SW.reverse ( string player ) ) ) ( string position ) ( string = ) en.position.point_guard ) ( string num_turnovers ) ) )	overnight-basketball
what player had less fouls than kobe bryant this season	( call SW.listValue ( call SW.getProperty ( ( lambda s ( call SW.filter ( var s ) ( call SW.ensureNumericProperty ( string num_fouls ) ) ( string < ) ( call SW.ensureNumericEntity ( call SW.getProperty ( call SW.getProperty en.player.kobe_bryant ( call SW.reverse ( string player ) ) ) ( string num_fouls ) ) ) ) ) ( call SW.domain ( string player ) ) ) ( string player ) ) )	overnight-basketball
whats the per season average for points scored while kobe bryant was at point guard	( call SW.listValue ( call SW.getProperty ( call SW.filter ( call SW.getProperty en.player.kobe_bryant ( call SW.reverse ( string player ) ) ) ( string position ) ( string = ) en.position.point_guard ) ( string num_points ) ) )	overnight-basketball
how many seasons has kobe bryant played for the los angeles lakers	( call SW.listValue ( call SW.getProperty ( call SW.filter ( call SW.getProperty en.player.kobe_bryant ( call SW.reverse ( string player ) ) ) ( string team ) ( string = ) en.team.lakers ) ( string season ) ) )	overnight-basketball
what position did kobe bryant play when he had three blocks	( call SW.listValue ( call SW.getProperty ( call SW.filter ( call SW.getProperty en.player.kobe_bryant ( call SW.reverse ( string player ) ) ) ( string num_blocks ) ( string = ) ( number 3 block ) ) ( string position ) ) )	overnight-basketball
who had few steals over the season than kobe bryant	( call SW.listValue ( call SW.getProperty ( ( lambda s ( call SW.filter ( var s ) ( call SW.ensureNumericProperty ( string num_steals ) ) ( string < ) ( call SW.ensureNumericEntity ( call SW.getProperty ( call SW.getProperty en.player.kobe_bryant ( call SW.reverse ( string player ) ) ) ( string num_steals ) ) ) ) ) ( call SW.domain ( string player ) ) ) ( string player ) ) )	overnight-basketball
position of player kobe bryant who has 3 turnovers over a season	( call SW.listValue ( call SW.getProperty ( call SW.filter ( call SW.getProperty en.player.kobe_bryant ( call SW.reverse ( string player ) ) ) ( string num_turnovers ) ( string = ) ( number 3 turnover ) ) ( string position ) ) )	overnight-basketball
player with maximum 3 steals over a season	( call SW.listValue ( call SW.getProperty ( ( lambda s ( call SW.filter ( var s ) ( call SW.ensureNumericProperty ( string num_steals ) ) ( string <= ) ( call SW.ensureNumericEntity ( number 3 steal ) ) ) ) ( call SW.domain ( string player ) ) ) ( string player ) ) )	overnight-basketball
who plays on the same team as kobe bryant	( call SW.listValue ( call SW.getProperty ( ( lambda s ( call SW.filter ( var s ) ( string team ) ( string = ) ( call SW.getProperty ( call SW.getProperty en.player.kobe_bryant ( call SW.reverse ( string player ) ) ) ( string team ) ) ) ) ( call SW.domain ( string player ) ) ) ( string player ) ) )	overnight-basketball
name those players with rebounds in any one season equalling less than 3	( call SW.listValue ( call SW.getProperty ( ( lambda s ( call SW.filter ( var s ) ( call SW.ensureNumericProperty ( string num_rebounds ) ) ( string < ) ( call SW.ensureNumericEntity ( number 3 rebound ) ) ) ) ( call SW.domain ( string player ) ) ) ( string player ) ) )	overnight-basketball
what players had a total number of rebounds in a season not equal to three	( call SW.listValue ( call SW.getProperty ( ( lambda s ( call SW.filter ( var s ) ( string num_rebounds ) ( string ! = ) ( number 3 rebound ) ) ) ( call SW.domain ( string player ) ) ) ( string player ) ) )	overnight-basketball
the player who made most fouls over a season	( call SW.listValue ( call SW.getProperty ( ( lambda s ( call SW.superlative ( var s ) ( string max ) ( call SW.ensureNumericProperty ( string num_fouls ) ) ) ) ( call SW.domain ( string player ) ) ) ( string player ) ) )	overnight-basketball
what position kob bryant played in the season he made 3 rebounds	( call SW.listValue ( call SW.getProperty ( call SW.filter ( call SW.getProperty en.player.kobe_bryant ( call SW.reverse ( string player ) ) ) ( string num_rebounds ) ( string = ) ( number 3 rebound ) ) ( string position ) ) )	overnight-basketball
how many turnovers did kobe bryant have when he had 3 steals	( call SW.listValue ( call SW.getProperty ( call SW.filter ( call SW.getProperty en.player.kobe_bryant ( call SW.reverse ( string player ) ) ) ( string num_steals ) ( string = ) ( number 3 steal ) ) ( string num_turnovers ) ) )	overnight-basketball
who were kobe bryants team mates	( call SW.listValue ( call SW.getProperty ( ( lambda s ( call SW.filter ( var s ) ( string team ) ( string = ) ( call SW.getProperty ( call SW.getProperty en.player.kobe_bryant ( call SW.reverse ( string player ) ) ) ( string team ) ) ) ) ( call SW.domain ( string player ) ) ) ( string player ) ) )	overnight-basketball
number of steals over a season of player kobe bryant who has 3 played games over a season	( call SW.listValue ( call SW.getProperty ( call SW.filter ( call SW.getProperty en.player.kobe_bryant ( call SW.reverse ( string player ) ) ) ( string num_games_played ) ( string = ) ( number 3 game ) ) ( string num_steals ) ) )	overnight-basketball
what position did kobe bryant play 3 games as	( call SW.listValue ( call SW.getProperty ( call SW.filter ( call SW.getProperty en.player.kobe_bryant ( call SW.reverse ( string player ) ) ) ( string num_games_played ) ( string = ) ( number 3 game ) ) ( string position ) ) )	overnight-basketball
which player scored less than 3 points in a full season	( call SW.listValue ( call SW.getProperty ( ( lambda s ( call SW.filter ( var s ) ( call SW.ensureNumericProperty ( string num_points ) ) ( string < ) ( call SW.ensureNumericEntity ( number 3 point ) ) ) ) ( call SW.domain ( string player ) ) ) ( string player ) ) )	overnight-basketball
how many points did kobe bryant score allseason when his steals equaled 3	( call SW.listValue ( call SW.getProperty ( call SW.filter ( call SW.getProperty en.player.kobe_bryant ( call SW.reverse ( string player ) ) ) ( string num_steals ) ( string = ) ( number 3 steal ) ) ( string num_points ) ) )	overnight-basketball
how many assists does kobe bryant manage in seasons limited to 3 fouls	( call SW.listValue ( call SW.getProperty ( call SW.filter ( call SW.getProperty en.player.kobe_bryant ( call SW.reverse ( string player ) ) ) ( string num_fouls ) ( string = ) ( number 3 foul ) ) ( string num_assists ) ) )	overnight-basketball
how many positions	( call SW.listValue ( call .size ( call SW.getProperty ( call SW.singleton en.position ) ( string ! type ) ) ) )	overnight-basketball
who has played the fewest games in a season	( call SW.listValue ( call SW.getProperty ( ( lambda s ( call SW.superlative ( var s ) ( string min ) ( call SW.ensureNumericProperty ( string num_games_played ) ) ) ) ( call SW.domain ( string player ) ) ) ( string player ) ) )	overnight-basketball
which player has had the most steals per season	( call SW.listValue ( call SW.getProperty ( ( lambda s ( call SW.superlative ( var s ) ( string max ) ( call SW.ensureNumericProperty ( string num_steals ) ) ) ) ( call SW.domain ( string player ) ) ) ( string player ) ) )	overnight-basketball
players that play the same position as kobe bryant	( call SW.listValue ( call SW.getProperty ( ( lambda s ( call SW.filter ( var s ) ( string position ) ( string = ) ( call SW.getProperty ( call SW.getProperty en.player.kobe_bryant ( call SW.reverse ( string player ) ) ) ( string position ) ) ) ) ( call SW.domain ( string player ) ) ) ( string player ) ) )	overnight-basketball
how many rebounds did kobe have in 04	( call SW.listValue ( call SW.getProperty ( call SW.filter ( call SW.getProperty en.player.kobe_bryant ( call SW.reverse ( string player ) ) ) ( string season ) ( string = ) ( date 2004 -1 -1 ) ) ( string num_rebounds ) ) )	overnight-basketball
what player played in the most games this season	( call SW.listValue ( call SW.getProperty ( ( lambda s ( call SW.superlative ( var s ) ( string max ) ( call SW.ensureNumericProperty ( string num_games_played ) ) ) ) ( call SW.domain ( string player ) ) ) ( string player ) ) )	overnight-basketball
who has had less than 3 turnovers	( call SW.listValue ( call SW.getProperty ( ( lambda s ( call SW.filter ( var s ) ( call SW.ensureNumericProperty ( string num_turnovers ) ) ( string < ) ( call SW.ensureNumericEntity ( number 3 turnover ) ) ) ) ( call SW.domain ( string player ) ) ) ( string player ) ) )	overnight-basketball
what team did kobe bryant have 3 steals on	( call SW.listValue ( call SW.getProperty ( call SW.filter ( call SW.getProperty en.player.kobe_bryant ( call SW.reverse ( string player ) ) ) ( string num_steals ) ( string = ) ( number 3 steal ) ) ( string team ) ) )	overnight-basketball
what player has as much steals as most number of steals kob bryant made over a season	( call SW.listValue ( call SW.getProperty ( ( lambda s ( call SW.filter ( var s ) ( call SW.ensureNumericProperty ( string num_steals ) ) ( string <= ) ( call SW.ensureNumericEntity ( call SW.getProperty ( call SW.getProperty en.player.kobe_bryant ( call SW.reverse ( string player ) ) ) ( string num_steals ) ) ) ) ) ( call SW.domain ( string player ) ) ) ( string player ) ) )	overnight-basketball
which player belongs to kobe bryant  steam	( call SW.listValue ( call SW.getProperty ( ( lambda s ( call SW.filter ( var s ) ( string team ) ( string = ) ( call SW.getProperty ( call SW.getProperty en.player.kobe_bryant ( call SW.reverse ( string player ) ) ) ( string team ) ) ) ) ( call SW.domain ( string player ) ) ) ( string player ) ) )	overnight-basketball
which player doesnt have 3 assists	( call SW.listValue ( call SW.getProperty ( ( lambda s ( call SW.filter ( var s ) ( string num_assists ) ( string ! = ) ( number 3 assist ) ) ) ( call SW.domain ( string player ) ) ) ( string player ) ) )	overnight-basketball
what team is kobe bryant on	( call SW.listValue ( call SW.getProperty ( call SW.filter ( call SW.getProperty en.player.kobe_bryant ( call SW.reverse ( string player ) ) ) ( string num_games_played ) ( string = ) ( number 3 game ) ) ( string team ) ) )	overnight-basketball
who has had more or less than 3 steals	( call SW.listValue ( call SW.getProperty ( ( lambda s ( call SW.filter ( var s ) ( string num_steals ) ( string ! = ) ( number 3 steal ) ) ) ( call SW.domain ( string player ) ) ) ( string player ) ) )	overnight-basketball
how many rebounds has kobe bryant had	( call SW.listValue ( call SW.getProperty ( call SW.filter ( call SW.getProperty en.player.kobe_bryant ( call SW.reverse ( string player ) ) ) ( string num_games_played ) ( string = ) ( number 3 game ) ) ( string num_rebounds ) ) )	overnight-basketball
which player had a maximum of 3 assists	( call SW.listValue ( call SW.getProperty ( ( lambda s ( call SW.filter ( var s ) ( call SW.ensureNumericProperty ( string num_assists ) ) ( string <= ) ( call SW.ensureNumericEntity ( number 3 assist ) ) ) ) ( call SW.domain ( string player ) ) ) ( string player ) ) )	overnight-basketball
players that have more and less than 3 steals over all seasons	( call SW.listValue ( call SW.getProperty ( ( lambda s ( call SW.filter ( var s ) ( string num_steals ) ( string ! = ) ( number 3 steal ) ) ) ( call SW.domain ( string player ) ) ) ( string player ) ) )	overnight-basketball
what players have gotten time in at least 3 games	( call SW.listValue ( call SW.getProperty ( ( lambda s ( call SW.filter ( var s ) ( call SW.ensureNumericProperty ( string num_games_played ) ) ( string >= ) ( call SW.ensureNumericEntity ( number 3 game ) ) ) ) ( call SW.domain ( string player ) ) ) ( string player ) ) )	overnight-basketball
over a season which player has the largest number of rebounds	( call SW.listValue ( call SW.getProperty ( ( lambda s ( call SW.superlative ( var s ) ( string max ) ( call SW.ensureNumericProperty ( string num_rebounds ) ) ) ) ( call SW.domain ( string player ) ) ) ( string player ) ) )	overnight-basketball
how many assists did kobe bryant get after 3 turnovers	( call SW.listValue ( call SW.getProperty ( call SW.filter ( call SW.getProperty en.player.kobe_bryant ( call SW.reverse ( string player ) ) ) ( string num_turnovers ) ( string = ) ( number 3 turnover ) ) ( string num_assists ) ) )	overnight-basketball
note those players who accrued a total of points in any one season totalling more than 3	( call SW.listValue ( call SW.getProperty ( ( lambda s ( call SW.filter ( var s ) ( call SW.ensureNumericProperty ( string num_points ) ) ( string > ) ( call SW.ensureNumericEntity ( number 3 point ) ) ) ) ( call SW.domain ( string player ) ) ) ( string player ) ) )	overnight-basketball
who had the most steals	( call SW.listValue ( call SW.getProperty ( ( lambda s ( call SW.superlative ( var s ) ( string max ) ( call SW.ensureNumericProperty ( string num_steals ) ) ) ) ( call SW.domain ( string player ) ) ) ( string player ) ) )	overnight-basketball
what season did kobe bryant score 3 points	( call SW.listValue ( call SW.getProperty ( call SW.filter ( call SW.getProperty en.player.kobe_bryant ( call SW.reverse ( string player ) ) ) ( string num_points ) ( string = ) ( number 3 point ) ) ( string season ) ) )	overnight-basketball
which player made as many blocks over the season as kobe bryant	( call SW.listValue ( call SW.getProperty ( ( lambda s ( call SW.filter ( var s ) ( call SW.ensureNumericProperty ( string num_blocks ) ) ( string <= ) ( call SW.ensureNumericEntity ( call SW.getProperty ( call SW.getProperty en.player.kobe_bryant ( call SW.reverse ( string player ) ) ) ( string num_blocks ) ) ) ) ) ( call SW.domain ( string player ) ) ) ( string player ) ) )	overnight-basketball
player with more than 3 blocks over a season	( call SW.listValue ( call SW.getProperty ( ( lambda s ( call SW.filter ( var s ) ( call SW.ensureNumericProperty ( string num_blocks ) ) ( string > ) ( call SW.ensureNumericEntity ( number 3 block ) ) ) ) ( call SW.domain ( string player ) ) ) ( string player ) ) )	overnight-basketball
player whose number of assists over a season is same as that of player kobe bryant over a season	( call SW.listValue ( call SW.getProperty ( ( lambda s ( call SW.filter ( var s ) ( string num_assists ) ( string = ) ( call SW.getProperty ( call SW.getProperty en.player.kobe_bryant ( call SW.reverse ( string player ) ) ) ( string num_assists ) ) ) ) ( call SW.domain ( string player ) ) ) ( string player ) ) )	overnight-basketball
team of player kobe bryant 2004 season	( call SW.listValue ( call SW.getProperty ( call SW.filter ( call SW.getProperty en.player.kobe_bryant ( call SW.reverse ( string player ) ) ) ( string season ) ( string = ) ( date 2004 -1 -1 ) ) ( string team ) ) )	overnight-basketball
how many rebounds did kobe bryant make in 2004	( call SW.listValue ( call SW.getProperty ( call SW.filter ( call SW.getProperty en.player.kobe_bryant ( call SW.reverse ( string player ) ) ) ( string season ) ( string = ) ( date 2004 -1 -1 ) ) ( string num_rebounds ) ) )	overnight-basketball
player who made lesser steals than kob bryant over a season	( call SW.listValue ( call SW.getProperty ( ( lambda s ( call SW.filter ( var s ) ( call SW.ensureNumericProperty ( string num_steals ) ) ( string < ) ( call SW.ensureNumericEntity ( call SW.getProperty ( call SW.getProperty en.player.kobe_bryant ( call SW.reverse ( string player ) ) ) ( string num_steals ) ) ) ) ) ( call SW.domain ( string player ) ) ) ( string player ) ) )	overnight-basketball
player whose number of assists over a season is more than that of  of player kobe bryant over a season	( call SW.listValue ( call SW.getProperty ( ( lambda s ( call SW.filter ( var s ) ( call SW.ensureNumericProperty ( string num_assists ) ) ( string > ) ( call SW.ensureNumericEntity ( call SW.getProperty ( call SW.getProperty en.player.kobe_bryant ( call SW.reverse ( string player ) ) ) ( string num_assists ) ) ) ) ) ( call SW.domain ( string player ) ) ) ( string player ) ) )	overnight-basketball
how many points in a season did kobe bryant have when he had only three assists	( call SW.listValue ( call SW.getProperty ( call SW.filter ( call SW.getProperty en.player.kobe_bryant ( call SW.reverse ( string player ) ) ) ( string num_assists ) ( string = ) ( number 3 assist ) ) ( string num_points ) ) )	overnight-basketball
what players have as many rebounds as kobe bryant over all seasons	( call SW.listValue ( call SW.getProperty ( ( lambda s ( call SW.filter ( var s ) ( call SW.ensureNumericProperty ( string num_rebounds ) ) ( string >= ) ( call SW.ensureNumericEntity ( call SW.getProperty ( call SW.getProperty en.player.kobe_bryant ( call SW.reverse ( string player ) ) ) ( string num_rebounds ) ) ) ) ) ( call SW.domain ( string player ) ) ) ( string player ) ) )	overnight-basketball
what player scored equal or less points as kobe bryant	( call SW.listValue ( call SW.getProperty ( ( lambda s ( call SW.filter ( var s ) ( call SW.ensureNumericProperty ( string num_points ) ) ( string >= ) ( call SW.ensureNumericEntity ( call SW.getProperty ( call SW.getProperty en.player.kobe_bryant ( call SW.reverse ( string player ) ) ) ( string num_points ) ) ) ) ) ( call SW.domain ( string player ) ) ) ( string player ) ) )	overnight-basketball
what player has fewer blocks per season than kobe bryant	( call SW.listValue ( call SW.getProperty ( ( lambda s ( call SW.filter ( var s ) ( call SW.ensureNumericProperty ( string num_blocks ) ) ( string < ) ( call SW.ensureNumericEntity ( call SW.getProperty ( call SW.getProperty en.player.kobe_bryant ( call SW.reverse ( string player ) ) ) ( string num_blocks ) ) ) ) ) ( call SW.domain ( string player ) ) ) ( string player ) ) )	overnight-basketball
name a player with fewer turnovers during the season than kobe bryant	( call SW.listValue ( call SW.getProperty ( ( lambda s ( call SW.filter ( var s ) ( call SW.ensureNumericProperty ( string num_turnovers ) ) ( string < ) ( call SW.ensureNumericEntity ( call SW.getProperty ( call SW.getProperty en.player.kobe_bryant ( call SW.reverse ( string player ) ) ) ( string num_turnovers ) ) ) ) ) ( call SW.domain ( string player ) ) ) ( string player ) ) )	overnight-basketball
who has played 3 or less games	( call SW.listValue ( call SW.getProperty ( ( lambda s ( call SW.filter ( var s ) ( call SW.ensureNumericProperty ( string num_games_played ) ) ( string <= ) ( call SW.ensureNumericEntity ( number 3 game ) ) ) ) ( call SW.domain ( string player ) ) ) ( string player ) ) )	overnight-basketball
what player has held the most positions	( call SW.listValue ( call SW.getProperty ( ( lambda s ( call SW.countSuperlative ( var s ) ( string max ) ( string position ) ) ) ( call SW.domain ( string player ) ) ) ( string player ) ) )	overnight-basketball
what year did kobe bryants points total three	( call SW.listValue ( call SW.getProperty ( call SW.filter ( call SW.getProperty en.player.kobe_bryant ( call SW.reverse ( string player ) ) ) ( string num_points ) ( string = ) ( number 3 point ) ) ( string season ) ) )	overnight-basketball
number of steals over a season of player kobe bryant with 3 points over a season	( call SW.listValue ( call SW.getProperty ( call SW.filter ( call SW.getProperty en.player.kobe_bryant ( call SW.reverse ( string player ) ) ) ( string num_points ) ( string = ) ( number 3 point ) ) ( string num_steals ) ) )	overnight-basketball
how many games did kobe bryant play in the 2004 season	( call SW.listValue ( call SW.getProperty ( call SW.filter ( call SW.getProperty en.player.kobe_bryant ( call SW.reverse ( string player ) ) ) ( string season ) ( string = ) ( date 2004 -1 -1 ) ) ( string num_games_played ) ) )	overnight-basketball
how many points did kobe bryant who had three fouls have	( call SW.listValue ( call SW.getProperty ( call SW.filter ( call SW.getProperty en.player.kobe_bryant ( call SW.reverse ( string player ) ) ) ( string num_fouls ) ( string = ) ( number 3 foul ) ) ( string num_points ) ) )	overnight-basketball
who had less than or equal to 3 points	( call SW.listValue ( call SW.getProperty ( ( lambda s ( call SW.filter ( var s ) ( call SW.ensureNumericProperty ( string num_points ) ) ( string <= ) ( call SW.ensureNumericEntity ( number 3 point ) ) ) ) ( call SW.domain ( string player ) ) ) ( string player ) ) )	overnight-basketball
which player has the most assists over a season other than kobe bryant	( call SW.listValue ( call SW.getProperty ( ( lambda s ( call SW.filter ( var s ) ( call SW.ensureNumericProperty ( string num_assists ) ) ( string > ) ( call SW.ensureNumericEntity ( call SW.getProperty ( call SW.getProperty en.player.kobe_bryant ( call SW.reverse ( string player ) ) ) ( string num_assists ) ) ) ) ) ( call SW.domain ( string player ) ) ) ( string player ) ) )	overnight-basketball
which player has the smallest number on the team	( call SW.listValue ( call SW.getProperty ( ( lambda s ( call SW.countSuperlative ( var s ) ( string min ) ( string team ) ) ) ( call SW.domain ( string player ) ) ) ( string player ) ) )	overnight-basketball
players that did no play in 2004	( call SW.listValue ( call SW.getProperty ( ( lambda s ( call SW.filter ( var s ) ( string season ) ( string ! = ) ( date 2004 -1 -1 ) ) ) ( call SW.domain ( string player ) ) ) ( string player ) ) )	overnight-basketball
how many assists has kobe bryant had	( call SW.listValue ( call SW.getProperty ( call SW.filter ( call SW.getProperty en.player.kobe_bryant ( call SW.reverse ( string player ) ) ) ( string num_games_played ) ( string = ) ( number 3 game ) ) ( string num_assists ) ) )	overnight-basketball
how many assists did kobe bryant have with three blocks	( call SW.listValue ( call SW.getProperty ( call SW.filter ( call SW.getProperty en.player.kobe_bryant ( call SW.reverse ( string player ) ) ) ( string num_blocks ) ( string = ) ( number 3 block ) ) ( string num_assists ) ) )	overnight-basketball
player whose fouls are not 3 over a season	( call SW.listValue ( call SW.getProperty ( ( lambda s ( call SW.filter ( var s ) ( string num_fouls ) ( string ! = ) ( number 3 foul ) ) ) ( call SW.domain ( string player ) ) ) ( string player ) ) )	overnight-basketball
how many points did la laker kobe bryant score	( call SW.listValue ( call SW.getProperty ( call SW.filter ( call SW.getProperty en.player.kobe_bryant ( call SW.reverse ( string player ) ) ) ( string team ) ( string = ) en.team.lakers ) ( string num_points ) ) )	overnight-basketball
what was the total number of assists in seasons where kobe bryant had just three points	( call SW.listValue ( call SW.getProperty ( call SW.filter ( call SW.getProperty en.player.kobe_bryant ( call SW.reverse ( string player ) ) ) ( string num_points ) ( string = ) ( number 3 point ) ) ( string num_assists ) ) )	overnight-basketball
how many steals did kobe bryant have in season where he had only three rebounds	( call SW.listValue ( call SW.getProperty ( call SW.filter ( call SW.getProperty en.player.kobe_bryant ( call SW.reverse ( string player ) ) ) ( string num_rebounds ) ( string = ) ( number 3 rebound ) ) ( string num_steals ) ) )	overnight-basketball
how many games has kobe bryant had more than 3 turnovers in all seasons	( call SW.listValue ( call SW.getProperty ( call SW.filter ( call SW.getProperty en.player.kobe_bryant ( call SW.reverse ( string player ) ) ) ( string num_blocks ) ( string = ) ( number 3 block ) ) ( string num_turnovers ) ) )	overnight-basketball
who has played less games than kobe bryant	( call SW.listValue ( call SW.getProperty ( ( lambda s ( call SW.filter ( var s ) ( call SW.ensureNumericProperty ( string num_games_played ) ) ( string < ) ( call SW.ensureNumericEntity ( call SW.getProperty ( call SW.getProperty en.player.kobe_bryant ( call SW.reverse ( string player ) ) ) ( string num_games_played ) ) ) ) ) ( call SW.domain ( string player ) ) ) ( string player ) ) )	overnight-basketball
how many rebounds did kobe bryant have this season	( call SW.listValue ( call SW.getProperty ( call SW.getProperty en.player.kobe_bryant ( call SW.reverse ( string player ) ) ) ( string num_rebounds ) ) )	overnight-basketball
how many steals did kobe bryant have during the season when averaging three assists	( call SW.listValue ( call SW.getProperty ( call SW.filter ( call SW.getProperty en.player.kobe_bryant ( call SW.reverse ( string player ) ) ) ( string num_assists ) ( string = ) ( number 3 assist ) ) ( string num_steals ) ) )	overnight-basketball
how many assists did kobe bryant have when he had 3 points	( call SW.listValue ( call SW.getProperty ( call SW.filter ( call SW.getProperty en.player.kobe_bryant ( call SW.reverse ( string player ) ) ) ( string num_points ) ( string = ) ( number 3 point ) ) ( string num_assists ) ) )	overnight-basketball
how many steals did kobe bryant have in the game in which he had three blocks	( call SW.listValue ( call SW.getProperty ( call SW.filter ( call SW.getProperty en.player.kobe_bryant ( call SW.reverse ( string player ) ) ) ( string num_blocks ) ( string = ) ( number 3 block ) ) ( string num_steals ) ) )	overnight-basketball
name of a player with no more rebounds each season than kobe bryant	( call SW.listValue ( call SW.getProperty ( ( lambda s ( call SW.filter ( var s ) ( call SW.ensureNumericProperty ( string num_rebounds ) ) ( string <= ) ( call SW.ensureNumericEntity ( call SW.getProperty ( call SW.getProperty en.player.kobe_bryant ( call SW.reverse ( string player ) ) ) ( string num_rebounds ) ) ) ) ) ( call SW.domain ( string player ) ) ) ( string player ) ) )	overnight-basketball
in what season did kobe only give up 3 fouls	( call SW.listValue ( call SW.getProperty ( call SW.filter ( call SW.getProperty en.player.kobe_bryant ( call SW.reverse ( string player ) ) ) ( string num_fouls ) ( string = ) ( number 3 foul ) ) ( string season ) ) )	overnight-basketball
how many points did kobe bryant score during the season	( call SW.listValue ( call SW.getProperty ( call SW.filter ( call SW.getProperty en.player.kobe_bryant ( call SW.reverse ( string player ) ) ) ( string num_points ) ( string = ) ( number 3 point ) ) ( string num_points ) ) )	overnight-basketball
which players played the most games in a season	( call SW.listValue ( call SW.getProperty ( ( lambda s ( call SW.superlative ( var s ) ( string max ) ( call SW.ensureNumericProperty ( string num_games_played ) ) ) ) ( call SW.domain ( string player ) ) ) ( string player ) ) )	overnight-basketball
how many blocks were made by  kobe bryant	( call SW.listValue ( call SW.getProperty ( call SW.getProperty en.player.kobe_bryant ( call SW.reverse ( string player ) ) ) ( string num_blocks ) ) )	overnight-basketball
whos averaged no more than 3 rebounds each season	( call SW.listValue ( call SW.getProperty ( ( lambda s ( call SW.filter ( var s ) ( call SW.ensureNumericProperty ( string num_rebounds ) ) ( string <= ) ( call SW.ensureNumericEntity ( number 3 rebound ) ) ) ) ( call SW.domain ( string player ) ) ) ( string player ) ) )	overnight-basketball
which player has played for the fewest teams	( call SW.listValue ( call SW.getProperty ( ( lambda s ( call SW.countSuperlative ( var s ) ( string min ) ( string team ) ) ) ( call SW.domain ( string player ) ) ) ( string player ) ) )	overnight-basketball
number of fouls over a season of player kobe bryant who has played 3 games over a season	( call SW.listValue ( call SW.getProperty ( call SW.filter ( call SW.getProperty en.player.kobe_bryant ( call SW.reverse ( string player ) ) ) ( string num_games_played ) ( string = ) ( number 3 game ) ) ( string num_fouls ) ) )	overnight-basketball
how many assists did kobe bryant have when he had 3 blocks	( call SW.listValue ( call SW.getProperty ( call SW.filter ( call SW.getProperty en.player.kobe_bryant ( call SW.reverse ( string player ) ) ) ( string num_blocks ) ( string = ) ( number 3 block ) ) ( string num_assists ) ) )	overnight-basketball
how many blocks did kobe bryant make after getting 3 steals	( call SW.listValue ( call SW.getProperty ( call SW.filter ( call SW.getProperty en.player.kobe_bryant ( call SW.reverse ( string player ) ) ) ( string num_steals ) ( string = ) ( number 3 steal ) ) ( string num_blocks ) ) )	overnight-basketball
how many games has kobe bryant played	( call SW.listValue ( call SW.getProperty ( call SW.filter ( call SW.getProperty en.player.kobe_bryant ( call SW.reverse ( string player ) ) ) ( string num_points ) ( string = ) ( number 3 point ) ) ( string num_games_played ) ) )	overnight-basketball
number of turnovers over a season of player kobe bryant who has 3 turnovers over a season	( call SW.listValue ( call SW.getProperty ( call SW.filter ( call SW.getProperty en.player.kobe_bryant ( call SW.reverse ( string player ) ) ) ( string num_turnovers ) ( string = ) ( number 3 turnover ) ) ( string num_turnovers ) ) )	overnight-basketball
how many fouls did kobe bryant have this season	( call SW.listValue ( call SW.getProperty ( call SW.getProperty en.player.kobe_bryant ( call SW.reverse ( string player ) ) ) ( string num_fouls ) ) )	overnight-basketball
what player had 3 or less turnovers	( call SW.listValue ( call SW.getProperty ( ( lambda s ( call SW.filter ( var s ) ( call SW.ensureNumericProperty ( string num_turnovers ) ) ( string <= ) ( call SW.ensureNumericEntity ( number 3 turnover ) ) ) ) ( call SW.domain ( string player ) ) ) ( string player ) ) )	overnight-basketball
name the player with fewer than three assists	( call SW.listValue ( call SW.getProperty ( ( lambda s ( call SW.filter ( var s ) ( call SW.ensureNumericProperty ( string num_assists ) ) ( string < ) ( call SW.ensureNumericEntity ( number 3 assist ) ) ) ) ( call SW.domain ( string player ) ) ) ( string player ) ) )	overnight-basketball
what player had more steals than kobe bryant this season	( call SW.listValue ( call SW.getProperty ( ( lambda s ( call SW.filter ( var s ) ( call SW.ensureNumericProperty ( string num_steals ) ) ( string > ) ( call SW.ensureNumericEntity ( call SW.getProperty ( call SW.getProperty en.player.kobe_bryant ( call SW.reverse ( string player ) ) ) ( string num_steals ) ) ) ) ) ( call SW.domain ( string player ) ) ) ( string player ) ) )	overnight-basketball
how many rebounds did kobe bryant make in 2004	( call SW.listValue ( call SW.getProperty ( call SW.filter ( call SW.getProperty en.player.kobe_bryant ( call SW.reverse ( string player ) ) ) ( string season ) ( string = ) ( date 2004 -1 -1 ) ) ( string num_rebounds ) ) )	overnight-basketball
what is the number of assists by player kobe bryant over the season	( call SW.listValue ( call SW.getProperty ( call SW.getProperty en.player.kobe_bryant ( call SW.reverse ( string player ) ) ) ( string num_assists ) ) )	overnight-basketball
player with most turnovers over a season	( call SW.listValue ( call SW.getProperty ( ( lambda s ( call SW.superlative ( var s ) ( string max ) ( call SW.ensureNumericProperty ( string num_turnovers ) ) ) ) ( call SW.domain ( string player ) ) ) ( string player ) ) )	overnight-basketball
players that have more than 3 turnovers over all seasons	( call SW.listValue ( call SW.getProperty ( ( lambda s ( call SW.filter ( var s ) ( call SW.ensureNumericProperty ( string num_turnovers ) ) ( string > ) ( call SW.ensureNumericEntity ( number 3 turnover ) ) ) ) ( call SW.domain ( string player ) ) ) ( string player ) ) )	overnight-basketball
how many fouls does kobe bryant average over a season	( call SW.listValue ( call SW.getProperty ( call SW.filter ( call SW.getProperty en.player.kobe_bryant ( call SW.reverse ( string player ) ) ) ( string num_fouls ) ( string = ) ( number 3 foul ) ) ( string season ) ) )	overnight-basketball
what players had more than three fouls per game over the season	( call SW.listValue ( call SW.getProperty ( ( lambda s ( call SW.filter ( var s ) ( call SW.ensureNumericProperty ( string num_fouls ) ) ( string > ) ( call SW.ensureNumericEntity ( number 3 foul ) ) ) ) ( call SW.domain ( string player ) ) ) ( string player ) ) )	overnight-basketball
what was the position of kobe bryant when he played 3 fouls	( call SW.listValue ( call SW.getProperty ( call SW.filter ( call SW.getProperty en.player.kobe_bryant ( call SW.reverse ( string player ) ) ) ( string num_fouls ) ( string = ) ( number 3 foul ) ) ( string position ) ) )	overnight-basketball
during his season playing point guard how many assists was bryant kobe responsible for	( call SW.listValue ( call SW.getProperty ( call SW.filter ( call SW.getProperty en.player.kobe_bryant ( call SW.reverse ( string player ) ) ) ( string position ) ( string = ) en.position.point_guard ) ( string num_assists ) ) )	overnight-basketball
how many blocks does kobe bryant usually make if hes already got 3	( call SW.listValue ( call SW.getProperty ( call SW.filter ( call SW.getProperty en.player.kobe_bryant ( call SW.reverse ( string player ) ) ) ( string num_blocks ) ( string = ) ( number 3 block ) ) ( string num_blocks ) ) )	overnight-basketball
number of played games over a season of player kobe bryant who is at point guard	( call SW.listValue ( call SW.getProperty ( call SW.filter ( call SW.getProperty en.player.kobe_bryant ( call SW.reverse ( string player ) ) ) ( string position ) ( string = ) en.position.point_guard ) ( string num_games_played ) ) )	overnight-basketball
name a player with the fewest turnovers during a season	( call SW.listValue ( call SW.getProperty ( ( lambda s ( call SW.superlative ( var s ) ( string min ) ( call SW.ensureNumericProperty ( string num_turnovers ) ) ) ) ( call SW.domain ( string player ) ) ) ( string player ) ) )	overnight-basketball
how many turnovers did kobe get after scoring 3 points	( call SW.listValue ( call SW.getProperty ( call SW.filter ( call SW.getProperty en.player.kobe_bryant ( call SW.reverse ( string player ) ) ) ( string num_points ) ( string = ) ( number 3 point ) ) ( string num_turnovers ) ) )	overnight-basketball
how many rebounds did kobe bryant who had three blocks have	( call SW.listValue ( call SW.getProperty ( call SW.filter ( call SW.getProperty en.player.kobe_bryant ( call SW.reverse ( string player ) ) ) ( string num_blocks ) ( string = ) ( number 3 block ) ) ( string num_rebounds ) ) )	overnight-basketball
how many blocks has kobe bryant made in seasons with exactly 3 assists	( call SW.listValue ( call SW.getProperty ( call SW.filter ( call SW.getProperty en.player.kobe_bryant ( call SW.reverse ( string player ) ) ) ( string num_assists ) ( string = ) ( number 3 assist ) ) ( string num_blocks ) ) )	overnight-basketball
number of fouls over a season of player kobe bryant who has 3 steals over a season	( call SW.listValue ( call SW.getProperty ( call SW.filter ( call SW.getProperty en.player.kobe_bryant ( call SW.reverse ( string player ) ) ) ( string num_steals ) ( string = ) ( number 3 steal ) ) ( string num_fouls ) ) )	overnight-basketball
players who had a greater number of assists in a season than kobe bryant	( call SW.listValue ( call SW.getProperty ( ( lambda s ( call SW.filter ( var s ) ( call SW.ensureNumericProperty ( string num_assists ) ) ( string > ) ( call SW.ensureNumericEntity ( call SW.getProperty ( call SW.getProperty en.player.kobe_bryant ( call SW.reverse ( string player ) ) ) ( string num_assists ) ) ) ) ) ( call SW.domain ( string player ) ) ) ( string player ) ) )	overnight-basketball
how many rebounds has kobe bryant made so far this season	( call SW.listValue ( call SW.getProperty ( call SW.getProperty en.player.kobe_bryant ( call SW.reverse ( string player ) ) ) ( string num_rebounds ) ) )	overnight-basketball
name kobe bryants position when he had three turnovers	( call SW.listValue ( call SW.getProperty ( call SW.filter ( call SW.getProperty en.player.kobe_bryant ( call SW.reverse ( string player ) ) ) ( string num_turnovers ) ( string = ) ( number 3 turnover ) ) ( string position ) ) )	overnight-basketball
what seasons did kobe bryant have only three blocks	( call SW.listValue ( call SW.getProperty ( call SW.filter ( call SW.getProperty en.player.kobe_bryant ( call SW.reverse ( string player ) ) ) ( string num_blocks ) ( string = ) ( number 3 block ) ) ( string season ) ) )	overnight-basketball
which player has less than 3 fouls total in a season	( call SW.listValue ( call SW.getProperty ( ( lambda s ( call SW.filter ( var s ) ( string num_fouls ) ( string ! = ) ( number 3 foul ) ) ) ( call SW.domain ( string player ) ) ) ( string player ) ) )	overnight-basketball
which player does not have 3 assists	( call SW.listValue ( call SW.getProperty ( ( lambda s ( call SW.filter ( var s ) ( string num_assists ) ( string ! = ) ( number 3 assist ) ) ) ( call SW.domain ( string player ) ) ) ( string player ) ) )	overnight-basketball
how many turnovers did kobe when playing with three fouls over the season	( call SW.listValue ( call SW.getProperty ( call SW.filter ( call SW.getProperty en.player.kobe_bryant ( call SW.reverse ( string player ) ) ) ( string num_fouls ) ( string = ) ( number 3 foul ) ) ( string num_turnovers ) ) )	overnight-basketball
how many fouls does kobe bryant have in seasons when he makes a total of 3 steals	( call SW.listValue ( call SW.getProperty ( call SW.filter ( call SW.getProperty en.player.kobe_bryant ( call SW.reverse ( string player ) ) ) ( string num_steals ) ( string = ) ( number 3 steal ) ) ( string num_fouls ) ) )	overnight-basketball
what player is the most versatile and plays the most number of positions	( call SW.listValue ( call SW.getProperty ( ( lambda s ( call SW.countSuperlative ( var s ) ( string max ) ( string position ) ) ) ( call SW.domain ( string player ) ) ) ( string player ) ) )	overnight-basketball
which player had at least three steals	( call SW.listValue ( call SW.getProperty ( ( lambda s ( call SW.filter ( var s ) ( call SW.ensureNumericProperty ( string num_steals ) ) ( string >= ) ( call SW.ensureNumericEntity ( number 3 steal ) ) ) ) ( call SW.domain ( string player ) ) ) ( string player ) ) )	overnight-basketball
how many steals did kobe bryant have as point guard	( call SW.listValue ( call SW.getProperty ( call SW.filter ( call SW.getProperty en.player.kobe_bryant ( call SW.reverse ( string player ) ) ) ( string position ) ( string = ) en.position.point_guard ) ( string num_steals ) ) )	overnight-basketball
how many rebounds did kobe bryant have after 3 games	( call SW.listValue ( call SW.getProperty ( call SW.filter ( call SW.getProperty en.player.kobe_bryant ( call SW.reverse ( string player ) ) ) ( string num_games_played ) ( string = ) ( number 3 game ) ) ( string num_rebounds ) ) )	overnight-basketball
how many steals per season does kobe bryant average when hes also got 3 rebounds	( call SW.listValue ( call SW.getProperty ( call SW.filter ( call SW.getProperty en.player.kobe_bryant ( call SW.reverse ( string player ) ) ) ( string num_rebounds ) ( string = ) ( number 3 rebound ) ) ( string num_steals ) ) )	overnight-basketball
what players have played less than two positions	( call SW.listValue ( call SW.getProperty ( ( lambda s ( call SW.countComparative ( var s ) ( string position ) ( string < ) ( number 2 ) ) ) ( call SW.domain ( string player ) ) ) ( string player ) ) )	overnight-basketball
which players play no more than two positions	( call SW.listValue ( call SW.getProperty ( ( lambda s ( call SW.countComparative ( var s ) ( string position ) ( string <= ) ( number 2 ) ) ) ( call SW.domain ( string player ) ) ) ( string player ) ) )	overnight-basketball
who gets 3 or more turnovers each season	( call SW.listValue ( call SW.getProperty ( ( lambda s ( call SW.filter ( var s ) ( call SW.ensureNumericProperty ( string num_turnovers ) ) ( string >= ) ( call SW.ensureNumericEntity ( number 3 turnover ) ) ) ) ( call SW.domain ( string player ) ) ) ( string player ) ) )	overnight-basketball
which player had fewer rebounds than kobe bryant	( call SW.listValue ( call SW.getProperty ( ( lambda s ( call SW.filter ( var s ) ( call SW.ensureNumericProperty ( string num_rebounds ) ) ( string < ) ( call SW.ensureNumericEntity ( call SW.getProperty ( call SW.getProperty en.player.kobe_bryant ( call SW.reverse ( string player ) ) ) ( string num_rebounds ) ) ) ) ) ( call SW.domain ( string player ) ) ) ( string player ) ) )	overnight-basketball
name a player who did not play in 2004	( call SW.listValue ( call SW.getProperty ( ( lambda s ( call SW.filter ( var s ) ( string season ) ( string ! = ) ( date 2004 -1 -1 ) ) ) ( call SW.domain ( string player ) ) ) ( string player ) ) )	overnight-basketball
who has more than 3 assists to their credit per season	( call SW.listValue ( call SW.getProperty ( ( lambda s ( call SW.filter ( var s ) ( call SW.ensureNumericProperty ( string num_assists ) ) ( string > ) ( call SW.ensureNumericEntity ( number 3 assist ) ) ) ) ( call SW.domain ( string player ) ) ) ( string player ) ) )	overnight-basketball
how many fouls in a season did kobe bryant have	( call SW.listValue ( call SW.getProperty ( call SW.filter ( call SW.getProperty en.player.kobe_bryant ( call SW.reverse ( string player ) ) ) ( string position ) ( string = ) en.position.point_guard ) ( string num_fouls ) ) )	overnight-basketball
how many fouls in a season did the los angeles lakers kobe bryant commit	( call SW.listValue ( call SW.getProperty ( call SW.filter ( call SW.getProperty en.player.kobe_bryant ( call SW.reverse ( string player ) ) ) ( string team ) ( string = ) en.team.lakers ) ( string num_fouls ) ) )	overnight-basketball
how many steals did kobe bryant have after 3 games	( call SW.listValue ( call SW.getProperty ( call SW.filter ( call SW.getProperty en.player.kobe_bryant ( call SW.reverse ( string player ) ) ) ( string num_games_played ) ( string = ) ( number 3 game ) ) ( string num_steals ) ) )	overnight-basketball
number of blocks over a season of player kobe bryant who is at point guard	( call SW.listValue ( call SW.getProperty ( call SW.filter ( call SW.getProperty en.player.kobe_bryant ( call SW.reverse ( string player ) ) ) ( string position ) ( string = ) en.position.point_guard ) ( string num_blocks ) ) )	overnight-basketball
what players made more than 2 points over a season	( call SW.listValue ( call SW.getProperty ( ( lambda s ( call SW.filter ( var s ) ( call SW.ensureNumericProperty ( string num_points ) ) ( string >= ) ( call SW.ensureNumericEntity ( number 3 point ) ) ) ) ( call SW.domain ( string player ) ) ) ( string player ) ) )	overnight-basketball
player whose number of points over a season is same as that of player kobe bryantcover a season	( call SW.listValue ( call SW.getProperty ( ( lambda s ( call SW.filter ( var s ) ( string num_points ) ( string = ) ( call SW.getProperty ( call SW.getProperty en.player.kobe_bryant ( call SW.reverse ( string player ) ) ) ( string num_points ) ) ) ) ( call SW.domain ( string player ) ) ) ( string player ) ) )	overnight-basketball
a player with at least 3 fouls	( call SW.listValue ( call SW.getProperty ( ( lambda s ( call SW.filter ( var s ) ( call SW.ensureNumericProperty ( string num_fouls ) ) ( string >= ) ( call SW.ensureNumericEntity ( number 3 foul ) ) ) ) ( call SW.domain ( string player ) ) ) ( string player ) ) )	overnight-basketball
what team does kobe bryant play for	( call SW.listValue ( call SW.getProperty ( call SW.filter ( call SW.getProperty en.player.kobe_bryant ( call SW.reverse ( string player ) ) ) ( string team ) ( string = ) en.team.lakers ) ( string team ) ) )	overnight-basketball
what position is kobe bryant	( call SW.listValue ( call SW.getProperty ( call SW.filter ( call SW.getProperty en.player.kobe_bryant ( call SW.reverse ( string player ) ) ) ( string num_fouls ) ( string = ) ( number 3 foul ) ) ( string position ) ) )	overnight-basketball
what was the complete number of steals in season where kobe bryant had only three points	( call SW.listValue ( call SW.getProperty ( call SW.filter ( call SW.getProperty en.player.kobe_bryant ( call SW.reverse ( string player ) ) ) ( string num_points ) ( string = ) ( number 3 point ) ) ( string num_steals ) ) )	overnight-basketball
in which season did kobe bryant score 3 points	( call SW.listValue ( call SW.getProperty ( call SW.filter ( call SW.getProperty en.player.kobe_bryant ( call SW.reverse ( string player ) ) ) ( string num_points ) ( string = ) ( number 3 point ) ) ( string season ) ) )	overnight-basketball
what player made more than 3 block over a season	( call SW.listValue ( call SW.getProperty ( ( lambda s ( call SW.filter ( var s ) ( call SW.ensureNumericProperty ( string num_blocks ) ) ( string > ) ( call SW.ensureNumericEntity ( number 3 block ) ) ) ) ( call SW.domain ( string player ) ) ) ( string player ) ) )	overnight-basketball
how many games did kobe bryant play where he made three assists	( call SW.listValue ( call SW.getProperty ( call SW.filter ( call SW.getProperty en.player.kobe_bryant ( call SW.reverse ( string player ) ) ) ( string num_assists ) ( string = ) ( number 3 assist ) ) ( string num_games_played ) ) )	overnight-basketball
how many points did kobe score while playing for the lakers	( call SW.listValue ( call SW.getProperty ( call SW.filter ( call SW.getProperty en.player.kobe_bryant ( call SW.reverse ( string player ) ) ) ( string team ) ( string = ) en.team.lakers ) ( string num_points ) ) )	overnight-basketball
what player had less than 3 turnovers	( call SW.listValue ( call SW.getProperty ( ( lambda s ( call SW.filter ( var s ) ( call SW.ensureNumericProperty ( string num_turnovers ) ) ( string < ) ( call SW.ensureNumericEntity ( number 3 turnover ) ) ) ) ( call SW.domain ( string player ) ) ) ( string player ) ) )	overnight-basketball
how many rebounds did kobe bryant get in the seasons he scored 3 points	( call SW.listValue ( call SW.getProperty ( call SW.filter ( call SW.getProperty en.player.kobe_bryant ( call SW.reverse ( string player ) ) ) ( string num_points ) ( string = ) ( number 3 point ) ) ( string num_rebounds ) ) )	overnight-basketball
who played the fewest games in a season	( call SW.listValue ( call SW.getProperty ( ( lambda s ( call SW.superlative ( var s ) ( string min ) ( call SW.ensureNumericProperty ( string num_games_played ) ) ) ) ( call SW.domain ( string player ) ) ) ( string player ) ) )	overnight-basketball
kobe bryant got 3 steals	( call SW.listValue ( call SW.getProperty ( call SW.filter ( call SW.getProperty en.player.kobe_bryant ( call SW.reverse ( string player ) ) ) ( string num_steals ) ( string = ) ( number 3 steal ) ) ( string num_steals ) ) )	overnight-basketball
how any blocks did kobe make after getting 3 rebounds	( call SW.listValue ( call SW.getProperty ( call SW.filter ( call SW.getProperty en.player.kobe_bryant ( call SW.reverse ( string player ) ) ) ( string num_rebounds ) ( string = ) ( number 3 rebound ) ) ( string num_blocks ) ) )	overnight-basketball
mention the number of turnovers of player kobe bryant in 3 games played over this season	( call SW.listValue ( call SW.getProperty ( call SW.filter ( call SW.getProperty en.player.kobe_bryant ( call SW.reverse ( string player ) ) ) ( string num_games_played ) ( string = ) ( number 3 game ) ) ( string num_turnovers ) ) )	overnight-basketball
who has had more than 3 turnovers	( call SW.listValue ( call SW.getProperty ( ( lambda s ( call SW.filter ( var s ) ( call SW.ensureNumericProperty ( string num_turnovers ) ) ( string > ) ( call SW.ensureNumericEntity ( number 3 turnover ) ) ) ) ( call SW.domain ( string player ) ) ) ( string player ) ) )	overnight-basketball
who has the same per season blocks as kobe bryant	( call SW.listValue ( call SW.getProperty ( ( lambda s ( call SW.filter ( var s ) ( string num_blocks ) ( string = ) ( call SW.getProperty ( call SW.getProperty en.player.kobe_bryant ( call SW.reverse ( string player ) ) ) ( string num_blocks ) ) ) ) ( call SW.domain ( string player ) ) ) ( string player ) ) )	overnight-basketball
how many rebounds did kobe bryant have over the season in which he played 3 games 	( call SW.listValue ( call SW.getProperty ( call SW.filter ( call SW.getProperty en.player.kobe_bryant ( call SW.reverse ( string player ) ) ) ( string num_games_played ) ( string = ) ( number 3 game ) ) ( string num_rebounds ) ) )	overnight-basketball
team of player kobe bryant who has 3 steals over a season	( call SW.listValue ( call SW.getProperty ( call SW.filter ( call SW.getProperty en.player.kobe_bryant ( call SW.reverse ( string player ) ) ) ( string num_steals ) ( string = ) ( number 3 steal ) ) ( string team ) ) )	overnight-basketball
which player has got a maximum of 3 turnovers	( call SW.listValue ( call SW.getProperty ( ( lambda s ( call SW.filter ( var s ) ( call SW.ensureNumericProperty ( string num_turnovers ) ) ( string <= ) ( call SW.ensureNumericEntity ( number 3 turnover ) ) ) ) ( call SW.domain ( string player ) ) ) ( string player ) ) )	overnight-basketball
player with the least played games in a season	( call SW.listValue ( call SW.getProperty ( ( lambda s ( call SW.superlative ( var s ) ( string min ) ( call SW.ensureNumericProperty ( string num_games_played ) ) ) ) ( call SW.domain ( string player ) ) ) ( string player ) ) )	overnight-basketball
what player has played more or less than 3 games	( call SW.listValue ( call SW.getProperty ( ( lambda s ( call SW.filter ( var s ) ( string num_games_played ) ( string ! = ) ( number 3 game ) ) ) ( call SW.domain ( string player ) ) ) ( string player ) ) )	overnight-basketball
who has at least as many assists as kobe bryant over a season	( call SW.listValue ( call SW.getProperty ( ( lambda s ( call SW.filter ( var s ) ( string num_assists ) ( string = ) ( call SW.getProperty ( call SW.getProperty en.player.kobe_bryant ( call SW.reverse ( string player ) ) ) ( string num_assists ) ) ) ) ( call SW.domain ( string player ) ) ) ( string player ) ) )	overnight-basketball
how many games kob bryant played over a season in which he made 3 points	( call SW.listValue ( call SW.getProperty ( call SW.filter ( call SW.getProperty en.player.kobe_bryant ( call SW.reverse ( string player ) ) ) ( string num_points ) ( string = ) ( number 3 point ) ) ( string num_games_played ) ) )	overnight-basketball
players with a total number of rebounds in a season no greater than three	( call SW.listValue ( call SW.getProperty ( ( lambda s ( call SW.filter ( var s ) ( call SW.ensureNumericProperty ( string num_rebounds ) ) ( string <= ) ( call SW.ensureNumericEntity ( number 3 rebound ) ) ) ) ( call SW.domain ( string player ) ) ) ( string player ) ) )	overnight-basketball
number of seasons where kobe bryant had three fouls	( call SW.listValue ( call SW.getProperty ( call SW.filter ( call SW.getProperty en.player.kobe_bryant ( call SW.reverse ( string player ) ) ) ( string num_fouls ) ( string = ) ( number 3 foul ) ) ( string num_fouls ) ) )	overnight-basketball
steals by kobe bryant in 2004	( call SW.listValue ( call SW.getProperty ( call SW.filter ( call SW.getProperty en.player.kobe_bryant ( call SW.reverse ( string player ) ) ) ( string season ) ( string = ) ( date 2004 -1 -1 ) ) ( string num_steals ) ) )	overnight-basketball
season of player kobe bryant whose has 3 points over a season	( call SW.listValue ( call SW.getProperty ( call SW.filter ( call SW.getProperty en.player.kobe_bryant ( call SW.reverse ( string player ) ) ) ( string num_points ) ( string = ) ( number 3 point ) ) ( string season ) ) )	overnight-basketball
in which season did kobe bryant have 3 turnovers	( call SW.listValue ( call SW.getProperty ( call SW.filter ( call SW.getProperty en.player.kobe_bryant ( call SW.reverse ( string player ) ) ) ( string num_turnovers ) ( string = ) ( number 3 turnover ) ) ( string season ) ) )	overnight-basketball
name the number of assists attributable to kobe bryant during a season	( call SW.listValue ( call SW.getProperty ( call SW.getProperty en.player.kobe_bryant ( call SW.reverse ( string player ) ) ) ( string num_assists ) ) )	overnight-basketball
how many steals did kobe get after getting 3 assists	( call SW.listValue ( call SW.getProperty ( call SW.filter ( call SW.getProperty en.player.kobe_bryant ( call SW.reverse ( string player ) ) ) ( string num_assists ) ( string = ) ( number 3 assist ) ) ( string num_steals ) ) )	overnight-basketball
how many rebounds did kboe bryant have when he had 3 points	( call SW.listValue ( call SW.getProperty ( call SW.filter ( call SW.getProperty en.player.kobe_bryant ( call SW.reverse ( string player ) ) ) ( string num_points ) ( string = ) ( number 3 point ) ) ( string num_rebounds ) ) )	overnight-basketball
how many blocks kob bryant made over a season	( call SW.listValue ( call SW.getProperty ( call SW.getProperty en.player.kobe_bryant ( call SW.reverse ( string player ) ) ) ( string num_blocks ) ) )	overnight-basketball
how many rebounds has kobe bryant had	( call SW.listValue ( call SW.getProperty ( call SW.filter ( call SW.getProperty en.player.kobe_bryant ( call SW.reverse ( string player ) ) ) ( string num_points ) ( string = ) ( number 3 point ) ) ( string num_rebounds ) ) )	overnight-basketball
name those players who have a total number of fouls in any one season equal to or more than that of kobe bryant	( call SW.listValue ( call SW.getProperty ( ( lambda s ( call SW.filter ( var s ) ( call SW.ensureNumericProperty ( string num_fouls ) ) ( string >= ) ( call SW.ensureNumericEntity ( call SW.getProperty ( call SW.getProperty en.player.kobe_bryant ( call SW.reverse ( string player ) ) ) ( string num_fouls ) ) ) ) ) ( call SW.domain ( string player ) ) ) ( string player ) ) )	overnight-basketball
number of played games over a season of player kobe bryant who has played 3 games over a season	( call SW.listValue ( call SW.getProperty ( call SW.filter ( call SW.getProperty en.player.kobe_bryant ( call SW.reverse ( string player ) ) ) ( string num_games_played ) ( string = ) ( number 3 game ) ) ( string num_games_played ) ) )	overnight-basketball
what player had less than 3 steals	( call SW.listValue ( call SW.getProperty ( ( lambda s ( call SW.filter ( var s ) ( call SW.ensureNumericProperty ( string num_steals ) ) ( string < ) ( call SW.ensureNumericEntity ( number 3 steal ) ) ) ) ( call SW.domain ( string player ) ) ) ( string player ) ) )	overnight-basketball
how many games did kobe bryant have three assists in over a season	( call SW.listValue ( call SW.getProperty ( call SW.filter ( call SW.getProperty en.player.kobe_bryant ( call SW.reverse ( string player ) ) ) ( string num_assists ) ( string = ) ( number 3 assist ) ) ( string num_games_played ) ) )	overnight-basketball
which player has got a minimum of 3 turnovers	( call SW.listValue ( call SW.getProperty ( ( lambda s ( call SW.filter ( var s ) ( call SW.ensureNumericProperty ( string num_turnovers ) ) ( string >= ) ( call SW.ensureNumericEntity ( number 3 turnover ) ) ) ) ( call SW.domain ( string player ) ) ) ( string player ) ) )	overnight-basketball
which player has a maximum of 3 blocks	( call SW.listValue ( call SW.getProperty ( ( lambda s ( call SW.filter ( var s ) ( call SW.ensureNumericProperty ( string num_blocks ) ) ( string <= ) ( call SW.ensureNumericEntity ( number 3 block ) ) ) ) ( call SW.domain ( string player ) ) ) ( string player ) ) )	overnight-basketball
which player had got less than 3 turnovers	( call SW.listValue ( call SW.getProperty ( ( lambda s ( call SW.filter ( var s ) ( call SW.ensureNumericProperty ( string num_turnovers ) ) ( string < ) ( call SW.ensureNumericEntity ( number 3 turnover ) ) ) ) ( call SW.domain ( string player ) ) ) ( string player ) ) )	overnight-basketball
what players had more points than kobe bryant in 2004	( call SW.listValue ( call SW.getProperty ( call SW.filter ( call SW.getProperty en.player.kobe_bryant ( call SW.reverse ( string player ) ) ) ( string season ) ( string = ) ( date 2004 -1 -1 ) ) ( string num_points ) ) )	overnight-basketball
number of steals over a season of player kobe bryant with 3 fouls over a season	( call SW.listValue ( call SW.getProperty ( call SW.filter ( call SW.getProperty en.player.kobe_bryant ( call SW.reverse ( string player ) ) ) ( string num_fouls ) ( string = ) ( number 3 foul ) ) ( string num_steals ) ) )	overnight-basketball
what player has had more turnovers than kobe bryant during a season	( call SW.listValue ( call SW.getProperty ( ( lambda s ( call SW.filter ( var s ) ( call SW.ensureNumericProperty ( string num_turnovers ) ) ( string > ) ( call SW.ensureNumericEntity ( call SW.getProperty ( call SW.getProperty en.player.kobe_bryant ( call SW.reverse ( string player ) ) ) ( string num_turnovers ) ) ) ) ) ( call SW.domain ( string player ) ) ) ( string player ) ) )	overnight-basketball
name the player who did not have three fouls in the season	( call SW.listValue ( call SW.getProperty ( ( lambda s ( call SW.filter ( var s ) ( string num_fouls ) ( string ! = ) ( number 3 foul ) ) ) ( call SW.domain ( string player ) ) ) ( string player ) ) )	overnight-basketball
which player did not play in 2004 or 2010	( call SW.listValue ( call SW.getProperty ( ( lambda s ( call SW.filter ( var s ) ( string season ) ( string = ) ( call SW.concat ( date 2004 -1 -1 ) ( date 2010 -1 -1 ) ) ) ) ( call SW.domain ( string player ) ) ) ( string player ) ) )	overnight-basketball
how many games has kobe bryant played in the last 3 seasons	( call SW.listValue ( call SW.getProperty ( call SW.filter ( call SW.getProperty en.player.kobe_bryant ( call SW.reverse ( string player ) ) ) ( string num_games_played ) ( string = ) ( number 3 game ) ) ( string num_games_played ) ) )	overnight-basketball
how many games has kobe bryant made more than 3 assists	( call SW.listValue ( call SW.getProperty ( call SW.filter ( call SW.getProperty en.player.kobe_bryant ( call SW.reverse ( string player ) ) ) ( string num_assists ) ( string = ) ( number 3 assist ) ) ( string num_games_played ) ) )	overnight-basketball
how many games has kobe bryant played	( call SW.listValue ( call SW.getProperty ( call SW.filter ( call SW.getProperty en.player.kobe_bryant ( call SW.reverse ( string player ) ) ) ( string season ) ( string = ) ( date 2004 -1 -1 ) ) ( string num_games_played ) ) )	overnight-basketball
how many rebounds did kobe bryant get as point guard	( call SW.listValue ( call SW.getProperty ( call SW.filter ( call SW.getProperty en.player.kobe_bryant ( call SW.reverse ( string player ) ) ) ( string position ) ( string = ) en.position.point_guard ) ( string num_rebounds ) ) )	overnight-basketball
how many points did kobe bryant have on the los angeles lakers	( call SW.listValue ( call SW.getProperty ( call SW.filter ( call SW.getProperty en.player.kobe_bryant ( call SW.reverse ( string player ) ) ) ( string team ) ( string = ) en.team.lakers ) ( string num_points ) ) )	overnight-basketball
how many points has kobe bryant gotten this season	( call SW.listValue ( call SW.getProperty ( call SW.filter ( call SW.getProperty en.player.kobe_bryant ( call SW.reverse ( string player ) ) ) ( string num_games_played ) ( string = ) ( number 3 game ) ) ( string num_points ) ) )	overnight-basketball
what player had the most fouls this season	( call SW.listValue ( call SW.getProperty ( ( lambda s ( call SW.superlative ( var s ) ( string max ) ( call SW.ensureNumericProperty ( string num_fouls ) ) ) ) ( call SW.domain ( string player ) ) ) ( string player ) ) )	overnight-basketball
how many blocks were made by kobe bryant in 3 games	( call SW.listValue ( call SW.getProperty ( call SW.filter ( call SW.getProperty en.player.kobe_bryant ( call SW.reverse ( string player ) ) ) ( string num_games_played ) ( string = ) ( number 3 game ) ) ( string num_blocks ) ) )	overnight-basketball
what players made more rebounds than kob bryant over a season	( call SW.listValue ( call SW.getProperty ( ( lambda s ( call SW.filter ( var s ) ( call SW.ensureNumericProperty ( string num_rebounds ) ) ( string > ) ( call SW.ensureNumericEntity ( call SW.getProperty ( call SW.getProperty en.player.kobe_bryant ( call SW.reverse ( string player ) ) ) ( string num_rebounds ) ) ) ) ) ( call SW.domain ( string player ) ) ) ( string player ) ) )	overnight-basketball
player with not more blocks over a season than player kobe bryant over a season	( call SW.listValue ( call SW.getProperty ( ( lambda s ( call SW.filter ( var s ) ( call SW.ensureNumericProperty ( string num_blocks ) ) ( string <= ) ( call SW.ensureNumericEntity ( call SW.getProperty ( call SW.getProperty en.player.kobe_bryant ( call SW.reverse ( string player ) ) ) ( string num_blocks ) ) ) ) ) ( call SW.domain ( string player ) ) ) ( string player ) ) )	overnight-basketball
position of player kobe bryant who has 3 points over a season	( call SW.listValue ( call SW.getProperty ( call SW.filter ( call SW.getProperty en.player.kobe_bryant ( call SW.reverse ( string player ) ) ) ( string num_points ) ( string = ) ( number 3 point ) ) ( string position ) ) )	overnight-basketball
which player has the most twos by position	( call SW.listValue ( call SW.getProperty ( ( lambda s ( call SW.countComparative ( var s ) ( string position ) ( string <= ) ( number 2 ) ) ) ( call SW.domain ( string player ) ) ) ( string player ) ) )	overnight-basketball
player whose number of blocks over a season is not less than that ofplayer kobe bryant over a season	( call SW.listValue ( call SW.getProperty ( ( lambda s ( call SW.filter ( var s ) ( call SW.ensureNumericProperty ( string num_blocks ) ) ( string >= ) ( call SW.ensureNumericEntity ( call SW.getProperty ( call SW.getProperty en.player.kobe_bryant ( call SW.reverse ( string player ) ) ) ( string num_blocks ) ) ) ) ) ( call SW.domain ( string player ) ) ) ( string player ) ) )	overnight-basketball
how many rebounds has kobe bryant had	( call SW.listValue ( call SW.getProperty ( call SW.getProperty en.player.kobe_bryant ( call SW.reverse ( string player ) ) ) ( string num_rebounds ) ) )	overnight-basketball
which player has the minimum number of steals of kobe bryant	( call SW.listValue ( call SW.getProperty ( ( lambda s ( call SW.filter ( var s ) ( call SW.ensureNumericProperty ( string num_steals ) ) ( string >= ) ( call SW.ensureNumericEntity ( call SW.getProperty ( call SW.getProperty en.player.kobe_bryant ( call SW.reverse ( string player ) ) ) ( string num_steals ) ) ) ) ) ( call SW.domain ( string player ) ) ) ( string player ) ) )	overnight-basketball
which player had three or more blocks	( call SW.listValue ( call SW.getProperty ( ( lambda s ( call SW.filter ( var s ) ( call SW.ensureNumericProperty ( string num_blocks ) ) ( string >= ) ( call SW.ensureNumericEntity ( number 3 block ) ) ) ) ( call SW.domain ( string player ) ) ) ( string player ) ) )	overnight-basketball
how many fouls has kobe bryant had	( call SW.listValue ( call SW.getProperty ( call SW.filter ( call SW.getProperty en.player.kobe_bryant ( call SW.reverse ( string player ) ) ) ( string num_blocks ) ( string = ) ( number 3 block ) ) ( string num_fouls ) ) )	overnight-basketball
how many players	( call SW.listValue ( call .size ( call SW.getProperty ( call SW.singleton en.player ) ( string ! type ) ) ) )	overnight-basketball
fouls by kobe bryant in 2004	( call SW.listValue ( call SW.getProperty ( call SW.filter ( call SW.getProperty en.player.kobe_bryant ( call SW.reverse ( string player ) ) ) ( string season ) ( string = ) ( date 2004 -1 -1 ) ) ( string num_fouls ) ) )	overnight-basketball
player who has one team	( call SW.listValue ( call SW.getProperty ( ( lambda s ( call SW.countComparative ( var s ) ( string team ) ( string < ) ( number 2 ) ) ) ( call SW.domain ( string player ) ) ) ( string player ) ) )	overnight-basketball
players that have more steals than kobe bryant over all seasons	( call SW.listValue ( call SW.getProperty ( ( lambda s ( call SW.filter ( var s ) ( call SW.ensureNumericProperty ( string num_steals ) ) ( string > ) ( call SW.ensureNumericEntity ( call SW.getProperty ( call SW.getProperty en.player.kobe_bryant ( call SW.reverse ( string player ) ) ) ( string num_steals ) ) ) ) ) ( call SW.domain ( string player ) ) ) ( string player ) ) )	overnight-basketball
what season did kobe bryant score 3 points	( call SW.listValue ( call SW.getProperty ( call SW.filter ( call SW.getProperty en.player.kobe_bryant ( call SW.reverse ( string player ) ) ) ( string num_points ) ( string = ) ( number 3 point ) ) ( string season ) ) )	overnight-basketball
whos got more than 3 assists each season	( call SW.listValue ( call SW.getProperty ( ( lambda s ( call SW.filter ( var s ) ( call SW.ensureNumericProperty ( string num_assists ) ) ( string >= ) ( call SW.ensureNumericEntity ( number 3 assist ) ) ) ) ( call SW.domain ( string player ) ) ) ( string player ) ) )	overnight-basketball
in what season did kobe bryant score a total of 3 assists	( call SW.listValue ( call SW.getProperty ( call SW.filter ( call SW.getProperty en.player.kobe_bryant ( call SW.reverse ( string player ) ) ) ( string num_assists ) ( string = ) ( number 3 assist ) ) ( string season ) ) )	overnight-basketball
what player had the fewest steals all season	( call SW.listValue ( call SW.getProperty ( ( lambda s ( call SW.superlative ( var s ) ( string min ) ( call SW.ensureNumericProperty ( string num_steals ) ) ) ) ( call SW.domain ( string player ) ) ) ( string player ) ) )	overnight-basketball
which player had no more than three assists during the season	( call SW.listValue ( call SW.getProperty ( ( lambda s ( call SW.filter ( var s ) ( call SW.ensureNumericProperty ( string num_assists ) ) ( string <= ) ( call SW.ensureNumericEntity ( number 3 assist ) ) ) ) ( call SW.domain ( string player ) ) ) ( string player ) ) )	overnight-basketball
in how many games did kobe bryant get 3 steals	( call SW.listValue ( call SW.getProperty ( call SW.filter ( call SW.getProperty en.player.kobe_bryant ( call SW.reverse ( string player ) ) ) ( string num_steals ) ( string = ) ( number 3 steal ) ) ( string num_games_played ) ) )	overnight-basketball
kobe bryant play point guard	( call SW.listValue ( call SW.getProperty ( call SW.filter ( call SW.getProperty en.player.kobe_bryant ( call SW.reverse ( string player ) ) ) ( string position ) ( string = ) en.position.point_guard ) ( string position ) ) )	overnight-basketball
what is the position of kobe bryant in los angeles lakers team	( call SW.listValue ( call SW.getProperty ( call SW.filter ( call SW.getProperty en.player.kobe_bryant ( call SW.reverse ( string player ) ) ) ( string team ) ( string = ) en.team.lakers ) ( string position ) ) )	overnight-basketball
what player plays the most positions	( call SW.listValue ( call SW.getProperty ( ( lambda s ( call SW.countSuperlative ( var s ) ( string max ) ( string position ) ) ) ( call SW.domain ( string player ) ) ) ( string player ) ) )	overnight-basketball
in which season was it that kobe bryant participated in 3 games total	( call SW.listValue ( call SW.getProperty ( call SW.filter ( call SW.getProperty en.player.kobe_bryant ( call SW.reverse ( string player ) ) ) ( string num_games_played ) ( string = ) ( number 3 game ) ) ( string season ) ) )	overnight-basketball
which player has more rebounds per season than kobe bryant	( call SW.listValue ( call SW.getProperty ( ( lambda s ( call SW.filter ( var s ) ( call SW.ensureNumericProperty ( string num_rebounds ) ) ( string > ) ( call SW.ensureNumericEntity ( call SW.getProperty ( call SW.getProperty en.player.kobe_bryant ( call SW.reverse ( string player ) ) ) ( string num_rebounds ) ) ) ) ) ( call SW.domain ( string player ) ) ) ( string player ) ) )	overnight-basketball
player with the same or fewer blocks per season as kobe bryant	( call SW.listValue ( call SW.getProperty ( ( lambda s ( call SW.filter ( var s ) ( call SW.ensureNumericProperty ( string num_blocks ) ) ( string <= ) ( call SW.ensureNumericEntity ( call SW.getProperty ( call SW.getProperty en.player.kobe_bryant ( call SW.reverse ( string player ) ) ) ( string num_blocks ) ) ) ) ) ( call SW.domain ( string player ) ) ) ( string player ) ) )	overnight-basketball
what players made less than three assists over a season	( call SW.listValue ( call SW.getProperty ( ( lambda s ( call SW.filter ( var s ) ( call SW.ensureNumericProperty ( string num_assists ) ) ( string < ) ( call SW.ensureNumericEntity ( number 3 assist ) ) ) ) ( call SW.domain ( string player ) ) ) ( string player ) ) )	overnight-basketball
what position is kobe bryant	( call SW.listValue ( call SW.getProperty ( call SW.filter ( call SW.getProperty en.player.kobe_bryant ( call SW.reverse ( string player ) ) ) ( string num_steals ) ( string = ) ( number 3 steal ) ) ( string position ) ) )	overnight-basketball
which player has played the fewest positions	( call SW.listValue ( call SW.getProperty ( ( lambda s ( call SW.countSuperlative ( var s ) ( string min ) ( string position ) ) ) ( call SW.domain ( string player ) ) ) ( string player ) ) )	overnight-basketball
how many players are there total	( call SW.listValue ( call .size ( call SW.getProperty ( call SW.singleton en.player ) ( string ! type ) ) ) )	overnight-basketball
how many points had kobe bryant scored after 3 rebounds	( call SW.listValue ( call SW.getProperty ( call SW.filter ( call SW.getProperty en.player.kobe_bryant ( call SW.reverse ( string player ) ) ) ( string num_rebounds ) ( string = ) ( number 3 rebound ) ) ( string num_points ) ) )	overnight-basketball
which player has not had three rebounds in a season	( call SW.listValue ( call SW.getProperty ( ( lambda s ( call SW.filter ( var s ) ( string num_rebounds ) ( string ! = ) ( number 3 rebound ) ) ) ( call SW.domain ( string player ) ) ) ( string player ) ) )	overnight-basketball
what player has more or less than 3 all season rebounds	( call SW.listValue ( call SW.getProperty ( ( lambda s ( call SW.filter ( var s ) ( string num_rebounds ) ( string ! = ) ( number 3 rebound ) ) ) ( call SW.domain ( string player ) ) ) ( string player ) ) )	overnight-basketball
who has the lowest average blocks per season	( call SW.listValue ( call SW.getProperty ( ( lambda s ( call SW.superlative ( var s ) ( string min ) ( call SW.ensureNumericProperty ( string num_blocks ) ) ) ) ( call SW.domain ( string player ) ) ) ( string player ) ) )	overnight-basketball
what position did kobe bryant play for the lakers	( call SW.listValue ( call SW.getProperty ( call SW.filter ( call SW.getProperty en.player.kobe_bryant ( call SW.reverse ( string player ) ) ) ( string team ) ( string = ) en.team.lakers ) ( string position ) ) )	overnight-basketball
which player doesnt average over 3 assists per game	( call SW.listValue ( call SW.getProperty ( ( lambda s ( call SW.filter ( var s ) ( string num_assists ) ( string ! = ) ( number 3 assist ) ) ) ( call SW.domain ( string player ) ) ) ( string player ) ) )	overnight-basketball
how many assists did kobe bryant have as point guard	( call SW.listValue ( call SW.getProperty ( call SW.filter ( call SW.getProperty en.player.kobe_bryant ( call SW.reverse ( string player ) ) ) ( string position ) ( string = ) en.position.point_guard ) ( string num_assists ) ) )	overnight-basketball
what position did kobe bryant play	( call SW.listValue ( call SW.getProperty ( call SW.filter ( call SW.getProperty en.player.kobe_bryant ( call SW.reverse ( string player ) ) ) ( string num_points ) ( string = ) ( number 3 point ) ) ( string position ) ) )	overnight-basketball
whos got the least turnovers so far this season	( call SW.listValue ( call SW.getProperty ( ( lambda s ( call SW.superlative ( var s ) ( string min ) ( call SW.ensureNumericProperty ( string num_turnovers ) ) ) ) ( call SW.domain ( string player ) ) ) ( string player ) ) )	overnight-basketball
how many fouls were played by kobe bryant after getting 3 steals	( call SW.listValue ( call SW.getProperty ( call SW.filter ( call SW.getProperty en.player.kobe_bryant ( call SW.reverse ( string player ) ) ) ( string num_steals ) ( string = ) ( number 3 steal ) ) ( string num_fouls ) ) )	overnight-basketball
how many all season rebounds did kobe bryant have	( call SW.listValue ( call SW.getProperty ( call SW.getProperty en.player.kobe_bryant ( call SW.reverse ( string player ) ) ) ( string num_rebounds ) ) )	overnight-basketball
what player did not play point guard	( call SW.listValue ( call SW.getProperty ( ( lambda s ( call SW.filter ( var s ) ( string position ) ( string ! = ) en.position.point_guard ) ) ( call SW.domain ( string player ) ) ) ( string player ) ) )	overnight-basketball
which player tied kobe bryants highest seasonal point score in a single season	( call SW.listValue ( call SW.getProperty ( ( lambda s ( call SW.filter ( var s ) ( call SW.ensureNumericProperty ( string num_points ) ) ( string <= ) ( call SW.ensureNumericEntity ( call SW.getProperty ( call SW.getProperty en.player.kobe_bryant ( call SW.reverse ( string player ) ) ) ( string num_points ) ) ) ) ) ( call SW.domain ( string player ) ) ) ( string player ) ) )	overnight-basketball
how many rebounds did kobe have in games where he scored three points	( call SW.listValue ( call SW.getProperty ( call SW.filter ( call SW.getProperty en.player.kobe_bryant ( call SW.reverse ( string player ) ) ) ( string num_points ) ( string = ) ( number 3 point ) ) ( string num_rebounds ) ) )	overnight-basketball
players that have the same number of rebounds as kobe bryant over all seasons	( call SW.listValue ( call SW.getProperty ( ( lambda s ( call SW.filter ( var s ) ( call SW.ensureNumericProperty ( string num_rebounds ) ) ( string >= ) ( call SW.ensureNumericEntity ( call SW.getProperty ( call SW.getProperty en.player.kobe_bryant ( call SW.reverse ( string player ) ) ) ( string num_rebounds ) ) ) ) ) ( call SW.domain ( string player ) ) ) ( string player ) ) )	overnight-basketball
what player had the same or less fouls as kobe bryant	( call SW.listValue ( call SW.getProperty ( ( lambda s ( call SW.filter ( var s ) ( call SW.ensureNumericProperty ( string num_fouls ) ) ( string <= ) ( call SW.ensureNumericEntity ( call SW.getProperty ( call SW.getProperty en.player.kobe_bryant ( call SW.reverse ( string player ) ) ) ( string num_fouls ) ) ) ) ) ( call SW.domain ( string player ) ) ) ( string player ) ) )	overnight-basketball
how many points does kobe bryant get per season	( call SW.listValue ( call SW.getProperty ( call SW.filter ( call SW.getProperty en.player.kobe_bryant ( call SW.reverse ( string player ) ) ) ( string num_points ) ( string = ) ( number 3 point ) ) ( string num_points ) ) )	overnight-basketball
what players allseason blocks are no more than kobe bryants allseason blocks	( call SW.listValue ( call SW.getProperty ( ( lambda s ( call SW.filter ( var s ) ( call SW.ensureNumericProperty ( string num_blocks ) ) ( string <= ) ( call SW.ensureNumericEntity ( call SW.getProperty ( call SW.getProperty en.player.kobe_bryant ( call SW.reverse ( string player ) ) ) ( string num_blocks ) ) ) ) ) ( call SW.domain ( string player ) ) ) ( string player ) ) )	overnight-basketball
player who committed more fouls than kob bryant	( call SW.listValue ( call SW.getProperty ( ( lambda s ( call SW.filter ( var s ) ( call SW.ensureNumericProperty ( string num_fouls ) ) ( string > ) ( call SW.ensureNumericEntity ( call SW.getProperty ( call SW.getProperty en.player.kobe_bryant ( call SW.reverse ( string player ) ) ) ( string num_fouls ) ) ) ) ) ( call SW.domain ( string player ) ) ) ( string player ) ) )	overnight-basketball
what player played less than 3 games	( call SW.listValue ( call SW.getProperty ( ( lambda s ( call SW.filter ( var s ) ( call SW.ensureNumericProperty ( string num_games_played ) ) ( string < ) ( call SW.ensureNumericEntity ( number 3 game ) ) ) ) ( call SW.domain ( string player ) ) ) ( string player ) ) )	overnight-basketball
how many steals has kobe bryant had	( call SW.listValue ( call SW.getProperty ( call SW.filter ( call SW.getProperty en.player.kobe_bryant ( call SW.reverse ( string player ) ) ) ( string num_points ) ( string = ) ( number 3 point ) ) ( string num_steals ) ) )	overnight-basketball
what players have had 3 or less rebounds	( call SW.listValue ( call SW.getProperty ( ( lambda s ( call SW.filter ( var s ) ( call SW.ensureNumericProperty ( string num_rebounds ) ) ( string <= ) ( call SW.ensureNumericEntity ( number 3 rebound ) ) ) ) ( call SW.domain ( string player ) ) ) ( string player ) ) )	overnight-basketball
which player plays the position of point guard or forward	( call SW.listValue ( call SW.getProperty ( ( lambda s ( call SW.filter ( var s ) ( string position ) ( string = ) ( call SW.concat en.position.point_guard en.position.forward ) ) ) ( call SW.domain ( string player ) ) ) ( string player ) ) )	overnight-basketball
which player had more assists than kobe bryant	( call SW.listValue ( call SW.getProperty ( ( lambda s ( call SW.filter ( var s ) ( call SW.ensureNumericProperty ( string num_assists ) ) ( string > ) ( call SW.ensureNumericEntity ( call SW.getProperty ( call SW.getProperty en.player.kobe_bryant ( call SW.reverse ( string player ) ) ) ( string num_assists ) ) ) ) ) ( call SW.domain ( string player ) ) ) ( string player ) ) )	overnight-basketball
who has had less than or the same number of turnovers as kobe bryant	( call SW.listValue ( call SW.getProperty ( ( lambda s ( call SW.filter ( var s ) ( call SW.ensureNumericProperty ( string num_turnovers ) ) ( string <= ) ( call SW.ensureNumericEntity ( call SW.getProperty ( call SW.getProperty en.player.kobe_bryant ( call SW.reverse ( string player ) ) ) ( string num_turnovers ) ) ) ) ) ( call SW.domain ( string player ) ) ) ( string player ) ) )	overnight-basketball
who has had less turnovers than kobe bryant	( call SW.listValue ( call SW.getProperty ( ( lambda s ( call SW.filter ( var s ) ( call SW.ensureNumericProperty ( string num_turnovers ) ) ( string < ) ( call SW.ensureNumericEntity ( call SW.getProperty ( call SW.getProperty en.player.kobe_bryant ( call SW.reverse ( string player ) ) ) ( string num_turnovers ) ) ) ) ) ( call SW.domain ( string player ) ) ) ( string player ) ) )	overnight-basketball
what team did kobe bryant play 3 games for	( call SW.listValue ( call SW.getProperty ( call SW.filter ( call SW.getProperty en.player.kobe_bryant ( call SW.reverse ( string player ) ) ) ( string num_games_played ) ( string = ) ( number 3 game ) ) ( string team ) ) )	overnight-basketball
what was the total number of assists over a season for kobe bryant playing point guard	( call SW.listValue ( call SW.getProperty ( call SW.filter ( call SW.getProperty en.player.kobe_bryant ( call SW.reverse ( string player ) ) ) ( string position ) ( string = ) en.position.point_guard ) ( string num_assists ) ) )	overnight-basketball
number of blocks over a season of player kobe bryant who has 3 points over a season	( call SW.listValue ( call SW.getProperty ( call SW.filter ( call SW.getProperty en.player.kobe_bryant ( call SW.reverse ( string player ) ) ) ( string num_points ) ( string = ) ( number 3 point ) ) ( string num_blocks ) ) )	overnight-basketball
name a player who assists over a single season is at least the same as kobe bryants	( call SW.listValue ( call SW.getProperty ( ( lambda s ( call SW.filter ( var s ) ( call SW.ensureNumericProperty ( string num_assists ) ) ( string <= ) ( call SW.ensureNumericEntity ( call SW.getProperty ( call SW.getProperty en.player.kobe_bryant ( call SW.reverse ( string player ) ) ) ( string num_assists ) ) ) ) ) ( call SW.domain ( string player ) ) ) ( string player ) ) )	overnight-basketball
how many games did kobe bryant play in the 2004 season	( call SW.listValue ( call SW.getProperty ( call SW.filter ( call SW.getProperty en.player.kobe_bryant ( call SW.reverse ( string player ) ) ) ( string season ) ( string = ) ( date 2004 -1 -1 ) ) ( string num_games_played ) ) )	overnight-basketball
what player had more than 3 blocks this season	( call SW.listValue ( call SW.getProperty ( ( lambda s ( call SW.filter ( var s ) ( call SW.ensureNumericProperty ( string num_blocks ) ) ( string > ) ( call SW.ensureNumericEntity ( number 3 block ) ) ) ) ( call SW.domain ( string player ) ) ) ( string player ) ) )	overnight-basketball
what is the position of kobe bryant in season 2004	( call SW.listValue ( call SW.getProperty ( call SW.filter ( call SW.getProperty en.player.kobe_bryant ( call SW.reverse ( string player ) ) ) ( string season ) ( string = ) ( date 2004 -1 -1 ) ) ( string position ) ) )	overnight-basketball
how many blocks does kobe bryant average in a season with 3 points	( call SW.listValue ( call SW.getProperty ( call SW.filter ( call SW.getProperty en.player.kobe_bryant ( call SW.reverse ( string player ) ) ) ( string num_points ) ( string = ) ( number 3 point ) ) ( string num_blocks ) ) )	overnight-basketball
which players have made the same number of fouls as kobe bryant in a season	( call SW.listValue ( call SW.getProperty ( ( lambda s ( call SW.filter ( var s ) ( string num_fouls ) ( string = ) ( call SW.getProperty ( call SW.getProperty en.player.kobe_bryant ( call SW.reverse ( string player ) ) ) ( string num_fouls ) ) ) ) ( call SW.domain ( string player ) ) ) ( string player ) ) )	overnight-basketball
find the player responsible for the biggest number of steals in any one season	( call SW.listValue ( call SW.getProperty ( ( lambda s ( call SW.superlative ( var s ) ( string max ) ( call SW.ensureNumericProperty ( string num_steals ) ) ) ) ( call SW.domain ( string player ) ) ) ( string player ) ) )	overnight-basketball
during the season in which kobe bryant had game time in 3 games how many assists was he responsible for	( call SW.listValue ( call SW.getProperty ( call SW.filter ( call SW.getProperty en.player.kobe_bryant ( call SW.reverse ( string player ) ) ) ( string num_games_played ) ( string = ) ( number 3 game ) ) ( string num_assists ) ) )	overnight-basketball
which player has made the least number of blocks	( call SW.listValue ( call SW.getProperty ( ( lambda s ( call SW.superlative ( var s ) ( string min ) ( call SW.ensureNumericProperty ( string num_blocks ) ) ) ) ( call SW.domain ( string player ) ) ) ( string player ) ) )	overnight-basketball
player with most points scored over all seasons	( call SW.listValue ( call SW.getProperty ( ( lambda s ( call SW.superlative ( var s ) ( string max ) ( call SW.ensureNumericProperty ( string num_points ) ) ) ) ( call SW.domain ( string player ) ) ) ( string player ) ) )	overnight-basketball
name a player with fewer blocks than kobe bryant	( call SW.listValue ( call SW.getProperty ( ( lambda s ( call SW.filter ( var s ) ( call SW.ensureNumericProperty ( string num_blocks ) ) ( string < ) ( call SW.ensureNumericEntity ( call SW.getProperty ( call SW.getProperty en.player.kobe_bryant ( call SW.reverse ( string player ) ) ) ( string num_blocks ) ) ) ) ) ( call SW.domain ( string player ) ) ) ( string player ) ) )	overnight-basketball
which players did not play in 2004	( call SW.listValue ( call SW.getProperty ( ( lambda s ( call SW.filter ( var s ) ( string season ) ( string ! = ) ( date 2004 -1 -1 ) ) ) ( call SW.domain ( string player ) ) ) ( string player ) ) )	overnight-basketball
which player has had the most fouls in a season	( call SW.listValue ( call SW.getProperty ( ( lambda s ( call SW.superlative ( var s ) ( string max ) ( call SW.ensureNumericProperty ( string num_fouls ) ) ) ) ( call SW.domain ( string player ) ) ) ( string player ) ) )	overnight-basketball
how many steals did kobe bryant make in seasons where he made 3 rebounds	( call SW.listValue ( call SW.getProperty ( call SW.filter ( call SW.getProperty en.player.kobe_bryant ( call SW.reverse ( string player ) ) ) ( string num_rebounds ) ( string = ) ( number 3 rebound ) ) ( string num_steals ) ) )	overnight-basketball
who has had more or equal to 3 fouls	( call SW.listValue ( call SW.getProperty ( ( lambda s ( call SW.filter ( var s ) ( call SW.ensureNumericProperty ( string num_fouls ) ) ( string >= ) ( call SW.ensureNumericEntity ( number 3 foul ) ) ) ) ( call SW.domain ( string player ) ) ) ( string player ) ) )	overnight-basketball
in how many games did kobe score 3 points	( call SW.listValue ( call SW.getProperty ( call SW.filter ( call SW.getProperty en.player.kobe_bryant ( call SW.reverse ( string player ) ) ) ( string num_points ) ( string = ) ( number 3 point ) ) ( string num_games_played ) ) )	overnight-basketball
what was the total number of turnovers in a season for kobe bryant at point guard	( call SW.listValue ( call SW.getProperty ( call SW.filter ( call SW.getProperty en.player.kobe_bryant ( call SW.reverse ( string player ) ) ) ( string position ) ( string = ) en.position.point_guard ) ( string num_turnovers ) ) )	overnight-basketball
how many points does kobe bryant have on average by game 3 in a season	( call SW.listValue ( call SW.getProperty ( call SW.filter ( call SW.getProperty en.player.kobe_bryant ( call SW.reverse ( string player ) ) ) ( string num_games_played ) ( string = ) ( number 3 game ) ) ( string num_points ) ) )	overnight-basketball
how many fouls did kobe bryant have when he made three turnovers	( call SW.listValue ( call SW.getProperty ( call SW.filter ( call SW.getProperty en.player.kobe_bryant ( call SW.reverse ( string player ) ) ) ( string num_turnovers ) ( string = ) ( number 3 turnover ) ) ( string num_fouls ) ) )	overnight-basketball
how many assists were got by kobe bryant who belonged to the los angeles team	( call SW.listValue ( call SW.getProperty ( call SW.filter ( call SW.getProperty en.player.kobe_bryant ( call SW.reverse ( string player ) ) ) ( string team ) ( string = ) en.team.lakers ) ( string num_assists ) ) )	overnight-basketball
in how many seasons has kobe bryant given up exactly 3 turnovers	( call SW.listValue ( call SW.getProperty ( call SW.filter ( call SW.getProperty en.player.kobe_bryant ( call SW.reverse ( string player ) ) ) ( string num_turnovers ) ( string = ) ( number 3 turnover ) ) ( string num_turnovers ) ) )	overnight-basketball
how many steals did kobe bryant make over the season	( call SW.listValue ( call SW.getProperty ( call SW.filter ( call SW.getProperty en.player.kobe_bryant ( call SW.reverse ( string player ) ) ) ( string num_games_played ) ( string = ) ( number 3 game ) ) ( string num_steals ) ) )	overnight-basketball
how many assists does kobe bryant usually make in a season after hes made at least 3	( call SW.listValue ( call SW.getProperty ( call SW.filter ( call SW.getProperty en.player.kobe_bryant ( call SW.reverse ( string player ) ) ) ( string num_assists ) ( string = ) ( number 3 assist ) ) ( string num_assists ) ) )	overnight-basketball
how many turnovers did kobe bryant make over the season where he made 3 steals	( call SW.listValue ( call SW.getProperty ( call SW.filter ( call SW.getProperty en.player.kobe_bryant ( call SW.reverse ( string player ) ) ) ( string num_steals ) ( string = ) ( number 3 steal ) ) ( string num_turnovers ) ) )	overnight-basketball
what is the number of rebounds by kobe bryant over the season	( call SW.listValue ( call SW.getProperty ( call SW.getProperty en.player.kobe_bryant ( call SW.reverse ( string player ) ) ) ( string num_rebounds ) ) )	overnight-basketball
which player has the fewest allseason blocks	( call SW.listValue ( call SW.getProperty ( ( lambda s ( call SW.superlative ( var s ) ( string min ) ( call SW.ensureNumericProperty ( string num_blocks ) ) ) ) ( call SW.domain ( string player ) ) ) ( string player ) ) )	overnight-basketball
what position did kobe bryant play in the 2004 season	( call SW.listValue ( call SW.getProperty ( call SW.filter ( call SW.getProperty en.player.kobe_bryant ( call SW.reverse ( string player ) ) ) ( string season ) ( string = ) ( date 2004 -1 -1 ) ) ( string position ) ) )	overnight-basketball
