who is the author of multivariate data analysis	( call SW.listValue ( call SW.filter ( call SW.getProperty ( call SW.singleton en.person ) ( string ! type ) ) ( call SW.reverse ( string author ) ) ( string = ) en.article.multivariate_data_analysis ) )	overnight-publications
name an article from the annals of statistics	( call SW.listValue ( call SW.filter ( call SW.getProperty ( call SW.singleton en.article ) ( string ! type ) ) ( call SW.reverse ( string cites ) ) ( string = ) ( call SW.filter ( call SW.getProperty ( call SW.singleton en.article ) ( string ! type ) ) ( string venue ) ( string = ) en.venue.annals_of_statistics ) ) )	overnight-publications
what award winning article has annals of statistics as a venue	( call SW.listValue ( call SW.filter ( call SW.filter ( call SW.getProperty ( call SW.singleton en.article ) ( string ! type ) ) ( string won_award ) ) ( string venue ) ( string = ) en.venue.annals_of_statistics ) )	overnight-publications
articles published in 2004 that cite multivariate data analysis	( call SW.listValue ( call SW.filter ( call SW.filter ( call SW.getProperty ( call SW.singleton en.article ) ( string ! type ) ) ( string cites ) ( string = ) en.article.multivariate_data_analysis ) ( string publication_date ) ( string = ) ( date 2004 -1 -1 ) ) )	overnight-publications
what article cites more than two other articles	( call SW.listValue ( call SW.countComparative ( call SW.getProperty ( call SW.singleton en.article ) ( string ! type ) ) ( call SW.reverse ( string cites ) ) ( string > ) ( number 2 ) ( call SW.getProperty ( call SW.singleton en.article ) ( string ! type ) ) ) )	overnight-publications
articles cited by efron	( call SW.listValue ( call SW.filter ( call SW.getProperty ( call SW.singleton en.article ) ( string ! type ) ) ( call SW.reverse ( string cites ) ) ( string = ) ( call SW.filter ( call SW.getProperty ( call SW.singleton en.article ) ( string ! type ) ) ( string author ) ( string = ) en.person.efron ) ) )	overnight-publications
venues that have published at most two articles	( call SW.listValue ( call SW.countComparative ( call SW.getProperty ( call SW.singleton en.venue ) ( string ! type ) ) ( call SW.reverse ( string venue ) ) ( string <= ) ( number 2 ) ( call SW.getProperty ( call SW.singleton en.article ) ( string ! type ) ) ) )	overnight-publications
authors of multiple articles	( call SW.listValue ( call SW.countSuperlative ( call SW.getProperty ( call SW.singleton en.person ) ( string ! type ) ) ( string min ) ( call SW.reverse ( string author ) ) ( call SW.getProperty ( call SW.singleton en.article ) ( string ! type ) ) ) )	overnight-publications
article cited by article which is published in 2004	( call SW.listValue ( call SW.filter ( call SW.getProperty ( call SW.singleton en.article ) ( string ! type ) ) ( call SW.reverse ( string cites ) ) ( string = ) ( call SW.filter ( call SW.getProperty ( call SW.singleton en.article ) ( string ! type ) ) ( string publication_date ) ( string = ) ( date 2004 -1 -1 ) ) ) )	overnight-publications
what is the venue of multivariate data analysis	( call SW.listValue ( call SW.filter ( call SW.filter ( call SW.getProperty ( call SW.singleton en.venue ) ( string ! type ) ) ( call SW.reverse ( string venue ) ) ( string = ) en.article.multivariate_data_analysis ) ( call SW.reverse ( string venue ) ) ( string = ) en.article.multivariate_data_analysis ) )	overnight-publications
what article was published on or after multivariate data analysis was	( call SW.listValue ( call SW.filter ( call SW.getProperty ( call SW.singleton en.article ) ( string ! type ) ) ( call SW.ensureNumericProperty ( string publication_date ) ) ( string >= ) ( call SW.ensureNumericEntity ( call SW.getProperty en.article.multivariate_data_analysis ( string publication_date ) ) ) ) )	overnight-publications
writer of articles cited by multivariate data analysis	( call SW.listValue ( call SW.filter ( call SW.getProperty ( call SW.singleton en.person ) ( string ! type ) ) ( call SW.reverse ( string author ) ) ( string = ) ( call SW.filter ( call SW.getProperty ( call SW.singleton en.article ) ( string ! type ) ) ( call SW.reverse ( string cites ) ) ( string = ) en.article.multivariate_data_analysis ) ) )	overnight-publications
who has written the fewest articles	( call SW.listValue ( call SW.countSuperlative ( call SW.getProperty ( call SW.singleton en.person ) ( string ! type ) ) ( string min ) ( call SW.reverse ( string author ) ) ( call SW.getProperty ( call SW.singleton en.article ) ( string ! type ) ) ) )	overnight-publications
venue that is venue of article that cites multivariate data analysis	( call SW.listValue ( call SW.filter ( call SW.getProperty ( call SW.singleton en.venue ) ( string ! type ) ) ( call SW.reverse ( string venue ) ) ( string = ) ( call SW.filter ( call SW.getProperty ( call SW.singleton en.article ) ( string ! type ) ) ( string cites ) ( string = ) en.article.multivariate_data_analysis ) ) )	overnight-publications
what are some articles unrelated to annals of statistics	( call SW.listValue ( call SW.filter ( call SW.getProperty ( call SW.singleton en.article ) ( string ! type ) ) ( string venue ) ( string ! = ) en.venue.annals_of_statistics ) )	overnight-publications
articles cited in articles by efron	( call SW.listValue ( call SW.filter ( call SW.getProperty ( call SW.singleton en.article ) ( string ! type ) ) ( call SW.reverse ( string cites ) ) ( string = ) ( call SW.filter ( call SW.getProperty ( call SW.singleton en.article ) ( string ! type ) ) ( string author ) ( string = ) en.person.efron ) ) )	overnight-publications
which authors have written two or more articles	( call SW.listValue ( call SW.countComparative ( call SW.getProperty ( call SW.singleton en.person ) ( string ! type ) ) ( call SW.reverse ( string author ) ) ( string >= ) ( number 2 ) ( call SW.getProperty ( call SW.singleton en.article ) ( string ! type ) ) ) )	overnight-publications
what article exchanged citations with multivariate data analysis	( call SW.listValue ( call SW.filter ( call SW.filter ( call SW.getProperty ( call SW.singleton en.article ) ( string ! type ) ) ( call SW.reverse ( string cites ) ) ( string = ) en.article.multivariate_data_analysis ) ( string cites ) ( string = ) en.article.multivariate_data_analysis ) )	overnight-publications
any article that mentions award winning article	( call SW.listValue ( call SW.filter ( call SW.getProperty ( call SW.singleton en.article ) ( string ! type ) ) ( string cites ) ( string = ) ( call SW.filter ( call SW.getProperty ( call SW.singleton en.article ) ( string ! type ) ) ( string won_award ) ) ) )	overnight-publications
article that cite articles published in 2004	( call SW.listValue ( call SW.filter ( call SW.getProperty ( call SW.singleton en.article ) ( string ! type ) ) ( string cites ) ( string = ) ( call SW.filter ( call SW.getProperty ( call SW.singleton en.article ) ( string ! type ) ) ( string publication_date ) ( string = ) ( date 2004 -1 -1 ) ) ) )	overnight-publications
articles in annals of statistics cited in multivariate data analysis	( call SW.listValue ( call SW.filter ( call SW.filter ( call SW.getProperty ( call SW.singleton en.article ) ( string ! type ) ) ( call SW.reverse ( string cites ) ) ( string = ) en.article.multivariate_data_analysis ) ( string venue ) ( string = ) en.venue.annals_of_statistics ) )	overnight-publications
find an article with no more than two authors	( call SW.listValue ( call SW.countComparative ( call SW.getProperty ( call SW.singleton en.article ) ( string ! type ) ) ( string author ) ( string <= ) ( number 2 ) ) )	overnight-publications
articles published before 2010	( call SW.listValue ( call SW.filter ( call SW.getProperty ( call SW.singleton en.article ) ( string ! type ) ) ( call SW.ensureNumericProperty ( string publication_date ) ) ( string <= ) ( call SW.ensureNumericEntity ( call SW.concat ( date 2004 -1 -1 ) ( date 2010 -1 -1 ) ) ) ) )	overnight-publications
articles that won awards cited by multivariate data analysis	( call SW.listValue ( call SW.filter ( call SW.filter ( call SW.getProperty ( call SW.singleton en.article ) ( string ! type ) ) ( string won_award ) ) ( call SW.reverse ( string cites ) ) ( string = ) en.article.multivariate_data_analysis ) )	overnight-publications
what article has a publication date of at least 2004	( call SW.listValue ( call SW.filter ( call SW.getProperty ( call SW.singleton en.article ) ( string ! type ) ) ( call SW.ensureNumericProperty ( string publication_date ) ) ( string >= ) ( call SW.ensureNumericEntity ( date 2004 -1 -1 ) ) ) )	overnight-publications
what article is not cited in multivariate data analysis	( call SW.listValue ( call SW.filter ( call SW.getProperty ( call SW.singleton en.article ) ( string ! type ) ) ( call SW.reverse ( string cites ) ) ( string ! = ) en.article.multivariate_data_analysis ) )	overnight-publications
find an article published after 2004	( call SW.listValue ( call SW.filter ( call SW.getProperty ( call SW.singleton en.article ) ( string ! type ) ) ( call SW.ensureNumericProperty ( string publication_date ) ) ( string > ) ( call SW.ensureNumericEntity ( call SW.concat ( date 2004 -1 -1 ) ( date 2010 -1 -1 ) ) ) ) )	overnight-publications
article that cites three or more articles	( call SW.listValue ( call SW.countComparative ( call SW.getProperty ( call SW.singleton en.article ) ( string ! type ) ) ( call SW.reverse ( string cites ) ) ( string > ) ( number 2 ) ( call SW.getProperty ( call SW.singleton en.article ) ( string ! type ) ) ) )	overnight-publications
author with at most two article	( call SW.listValue ( call SW.countComparative ( call SW.getProperty ( call SW.singleton en.person ) ( string ! type ) ) ( call SW.reverse ( string author ) ) ( string <= ) ( number 2 ) ( call SW.getProperty ( call SW.singleton en.article ) ( string ! type ) ) ) )	overnight-publications
name an article with fewer than two authors	( call SW.listValue ( call SW.countComparative ( call SW.getProperty ( call SW.singleton en.article ) ( string ! type ) ) ( string author ) ( string < ) ( number 2 ) ) )	overnight-publications
articles not published in the annals of statistics	( call SW.listValue ( call SW.filter ( call SW.getProperty ( call SW.singleton en.article ) ( string ! type ) ) ( string venue ) ( string ! = ) en.venue.annals_of_statistics ) )	overnight-publications
what award winning article was written by efron	( call SW.listValue ( call SW.filter ( call SW.filter ( call SW.getProperty ( call SW.singleton en.article ) ( string ! type ) ) ( string won_award ) ) ( string author ) ( string = ) en.person.efron ) )	overnight-publications
who wrote the most articles	( call SW.listValue ( call SW.countSuperlative ( call SW.getProperty ( call SW.singleton en.person ) ( string ! type ) ) ( string max ) ( call SW.reverse ( string author ) ) ( call SW.getProperty ( call SW.singleton en.article ) ( string ! type ) ) ) )	overnight-publications
article whose publication date is at least 2004	( call SW.listValue ( call SW.filter ( call SW.getProperty ( call SW.singleton en.article ) ( string ! type ) ) ( call SW.ensureNumericProperty ( string publication_date ) ) ( string >= ) ( call SW.ensureNumericEntity ( date 2004 -1 -1 ) ) ) )	overnight-publications
an article that cites multivariate data analysis published in 2004	( call SW.listValue ( call SW.filter ( call SW.filter ( call SW.getProperty ( call SW.singleton en.article ) ( string ! type ) ) ( call SW.reverse ( string cites ) ) ( string = ) en.article.multivariate_data_analysis ) ( string publication_date ) ( string = ) ( date 2004 -1 -1 ) ) )	overnight-publications
articles published between 2004 and 2010	( call SW.listValue ( call SW.filter ( call SW.getProperty ( call SW.singleton en.article ) ( string ! type ) ) ( call SW.ensureNumericProperty ( string publication_date ) ) ( string <= ) ( call SW.ensureNumericEntity ( call SW.concat ( date 2004 -1 -1 ) ( date 2010 -1 -1 ) ) ) ) )	overnight-publications
which article was published in 2004 at annals of statistics	( call SW.listValue ( call SW.filter ( call SW.filter ( call SW.getProperty ( call SW.singleton en.article ) ( string ! type ) ) ( string publication_date ) ( string = ) ( date 2004 -1 -1 ) ) ( string venue ) ( string = ) en.venue.annals_of_statistics ) )	overnight-publications
what article from 2004 cites multivariate data analysis	( call SW.listValue ( call SW.filter ( call SW.filter ( call SW.getProperty ( call SW.singleton en.article ) ( string ! type ) ) ( string publication_date ) ( string = ) ( date 2004 -1 -1 ) ) ( string cites ) ( string = ) en.article.multivariate_data_analysis ) )	overnight-publications
name someone who has written an article about multivariate data analysis	( call SW.listValue ( call SW.filter ( call SW.filter ( call SW.getProperty ( call SW.singleton en.person ) ( string ! type ) ) ( call SW.reverse ( string author ) ) ( string = ) en.article.multivariate_data_analysis ) ( call SW.reverse ( string author ) ) ( string = ) en.article.multivariate_data_analysis ) )	overnight-publications
articles written by efron and cited by multivariate data analysis	( call SW.listValue ( call SW.filter ( call SW.filter ( call SW.getProperty ( call SW.singleton en.article ) ( string ! type ) ) ( string author ) ( string = ) en.person.efron ) ( call SW.reverse ( string cites ) ) ( string = ) en.article.multivariate_data_analysis ) )	overnight-publications
what article cites other articles about annals of statistics	( call SW.listValue ( call SW.filter ( call SW.getProperty ( call SW.singleton en.article ) ( string ! type ) ) ( string cites ) ( string = ) ( call SW.filter ( call SW.getProperty ( call SW.singleton en.article ) ( string ! type ) ) ( string venue ) ( string = ) en.venue.annals_of_statistics ) ) )	overnight-publications
what journal is multivariate data analysis published in	( call SW.listValue ( call SW.getProperty en.article.multivariate_data_analysis ( string venue ) ) )	overnight-publications
who wrote multivariate data analysis more than once	( call SW.listValue ( call SW.filter ( call SW.filter ( call SW.getProperty ( call SW.singleton en.person ) ( string ! type ) ) ( call SW.reverse ( string author ) ) ( string = ) en.article.multivariate_data_analysis ) ( call SW.reverse ( string author ) ) ( string = ) en.article.multivariate_data_analysis ) )	overnight-publications
what article doesnt cite multivariate data analysis	( call SW.listValue ( call SW.filter ( call SW.getProperty ( call SW.singleton en.article ) ( string ! type ) ) ( string cites ) ( string ! = ) en.article.multivariate_data_analysis ) )	overnight-publications
articles published in 2004 or before	( call SW.listValue ( call SW.filter ( call SW.getProperty ( call SW.singleton en.article ) ( string ! type ) ) ( call SW.ensureNumericProperty ( string publication_date ) ) ( string <= ) ( call SW.ensureNumericEntity ( date 2004 -1 -1 ) ) ) )	overnight-publications
what article wasnt published in 2004	( call SW.listValue ( call SW.filter ( call SW.getProperty ( call SW.singleton en.article ) ( string ! type ) ) ( string publication_date ) ( string ! = ) ( date 2004 -1 -1 ) ) )	overnight-publications
article whose venue is venue that is venue of multivariate data analysis	( call SW.listValue ( call SW.filter ( call SW.getProperty ( call SW.singleton en.article ) ( string ! type ) ) ( string venue ) ( string = ) ( call SW.filter ( call SW.getProperty ( call SW.singleton en.venue ) ( string ! type ) ) ( call SW.reverse ( string venue ) ) ( string = ) en.article.multivariate_data_analysis ) ) )	overnight-publications
articles published before 2004 or before 2010	( call SW.listValue ( call SW.filter ( call SW.getProperty ( call SW.singleton en.article ) ( string ! type ) ) ( call SW.ensureNumericProperty ( string publication_date ) ) ( string <= ) ( call SW.ensureNumericEntity ( call SW.concat ( date 2004 -1 -1 ) ( date 2010 -1 -1 ) ) ) ) )	overnight-publications
articles published in annals of statistics that cite multivariate data analysis	( call SW.listValue ( call SW.filter ( call SW.filter ( call SW.getProperty ( call SW.singleton en.article ) ( string ! type ) ) ( string cites ) ( string = ) en.article.multivariate_data_analysis ) ( string venue ) ( string = ) en.venue.annals_of_statistics ) )	overnight-publications
venue that is venue of article whose author is efron	( call SW.listValue ( call SW.filter ( call SW.getProperty ( call SW.singleton en.venue ) ( string ! type ) ) ( call SW.reverse ( string venue ) ) ( string = ) ( call SW.filter ( call SW.getProperty ( call SW.singleton en.article ) ( string ! type ) ) ( string author ) ( string = ) en.person.efron ) ) )	overnight-publications
awardwinning articles cited in multivariate data analysis	( call SW.listValue ( call SW.filter ( call SW.filter ( call SW.getProperty ( call SW.singleton en.article ) ( string ! type ) ) ( call SW.reverse ( string cites ) ) ( string = ) en.article.multivariate_data_analysis ) ( string won_award ) ) )	overnight-publications
which efron article cites multivariate data analysis	( call SW.listValue ( call SW.filter ( call SW.filter ( call SW.getProperty ( call SW.singleton en.article ) ( string ! type ) ) ( call SW.reverse ( string cites ) ) ( string = ) en.article.multivariate_data_analysis ) ( string author ) ( string = ) en.person.efron ) )	overnight-publications
articles written by efron or lakoff	( call SW.listValue ( call SW.filter ( call SW.getProperty ( call SW.singleton en.article ) ( string ! type ) ) ( string author ) ( string = ) ( call SW.concat en.person.efron en.person.lakoff ) ) )	overnight-publications
an article whose also authored multivariate data analysis	( call SW.listValue ( call SW.filter ( call SW.getProperty ( call SW.singleton en.article ) ( string ! type ) ) ( string author ) ( string = ) ( call SW.getProperty en.article.multivariate_data_analysis ( string author ) ) ) )	overnight-publications
what articles are published in multivariate data analysis	( call SW.listValue ( call SW.filter ( call SW.getProperty ( call SW.singleton en.article ) ( string ! type ) ) ( call SW.reverse ( string cites ) ) ( string = ) en.article.multivariate_data_analysis ) )	overnight-publications
which article is mentioned in least number of other articles	( call SW.listValue ( call SW.countSuperlative ( call SW.getProperty ( call SW.singleton en.article ) ( string ! type ) ) ( string min ) ( call SW.reverse ( string cites ) ) ( call SW.getProperty ( call SW.singleton en.article ) ( string ! type ) ) ) )	overnight-publications
articles cited in annals of statistics	( call SW.listValue ( call SW.filter ( call SW.getProperty ( call SW.singleton en.article ) ( string ! type ) ) ( call SW.reverse ( string cites ) ) ( string = ) ( call SW.filter ( call SW.getProperty ( call SW.singleton en.article ) ( string ! type ) ) ( string venue ) ( string = ) en.venue.annals_of_statistics ) ) )	overnight-publications
articles that have a publication date close to the date of multivariate data analysis	( call SW.listValue ( call SW.filter ( call SW.getProperty ( call SW.singleton en.article ) ( string ! type ) ) ( call SW.ensureNumericProperty ( string publication_date ) ) ( string <= ) ( call SW.ensureNumericEntity ( call SW.getProperty en.article.multivariate_data_analysis ( string publication_date ) ) ) ) )	overnight-publications
which article cites an awardwinning article	( call SW.listValue ( call SW.filter ( call SW.getProperty ( call SW.singleton en.article ) ( string ! type ) ) ( call SW.reverse ( string cites ) ) ( string = ) ( call SW.filter ( call SW.getProperty ( call SW.singleton en.article ) ( string ! type ) ) ( string won_award ) ) ) )	overnight-publications
writers who published in 2004	( call SW.listValue ( call SW.filter ( call SW.getProperty ( call SW.singleton en.person ) ( string ! type ) ) ( call SW.reverse ( string author ) ) ( string = ) ( call SW.filter ( call SW.getProperty ( call SW.singleton en.article ) ( string ! type ) ) ( string publication_date ) ( string = ) ( date 2004 -1 -1 ) ) ) )	overnight-publications
find an article making a citation of a 2004 published article	( call SW.listValue ( call SW.filter ( call SW.getProperty ( call SW.singleton en.article ) ( string ! type ) ) ( string cites ) ( string = ) ( call SW.filter ( call SW.getProperty ( call SW.singleton en.article ) ( string ! type ) ) ( string publication_date ) ( string = ) ( date 2004 -1 -1 ) ) ) )	overnight-publications
article with the fewest authors	( call SW.listValue ( call SW.countSuperlative ( call SW.getProperty ( call SW.singleton en.article ) ( string ! type ) ) ( string min ) ( string author ) ) )	overnight-publications
what award winning article is cited by multivariate data analysis	( call SW.listValue ( call SW.filter ( call SW.filter ( call SW.getProperty ( call SW.singleton en.article ) ( string ! type ) ) ( string won_award ) ) ( call SW.reverse ( string cites ) ) ( string = ) en.article.multivariate_data_analysis ) )	overnight-publications
who authored two or fewer articles	( call SW.listValue ( call SW.countComparative ( call SW.getProperty ( call SW.singleton en.person ) ( string ! type ) ) ( call SW.reverse ( string author ) ) ( string <= ) ( number 2 ) ( call SW.getProperty ( call SW.singleton en.article ) ( string ! type ) ) ) )	overnight-publications
