what recipe can make fewer than two types of cuisine	( call SW.listValue ( call SW.countComparative ( call SW.getProperty ( call SW.singleton en.recipe ) ( string ! type ) ) ( string cuisine ) ( string < ) ( number 2 ) ) )	overnight-recipes
what is a recipe with a prep time less than the cooking time of rice pudding	( call SW.listValue ( call SW.filter ( call SW.getProperty ( call SW.singleton en.recipe ) ( string ! type ) ) ( call SW.ensureNumericProperty ( string preparation_time ) ) ( string < ) ( call SW.ensureNumericEntity ( call SW.getProperty en.recipe.rice_pudding ( string cooking_time ) ) ) ) )	overnight-recipes
what recipe requires milk	( call SW.listValue ( call SW.filter ( call SW.getProperty ( call SW.singleton en.ingredient ) ( string ! type ) ) ( call SW.reverse ( string requires ) ) ( string = ) ( call SW.filter ( call SW.getProperty ( call SW.singleton en.recipe ) ( string ! type ) ) ( string requires ) ( string = ) en.ingredient.milk ) ) )	overnight-recipes
recipe of number of ingredients	( call SW.listValue ( call SW.countSuperlative ( call SW.getProperty ( call SW.singleton en.recipe ) ( string ! type ) ) ( string max ) ( string requires ) ( call SW.getProperty ( call SW.singleton en.ingredient ) ( string ! type ) ) ) )	overnight-recipes
show me meals with two or fewer recipes	( call SW.listValue ( call SW.countComparative ( call SW.getProperty ( call SW.singleton en.meal ) ( string ! type ) ) ( call SW.reverse ( string meal ) ) ( string <= ) ( number 2 ) ( call SW.getProperty ( call SW.singleton en.recipe ) ( string ! type ) ) ) )	overnight-recipes
find some lunch recipes	( call SW.listValue ( call SW.filter ( call SW.getProperty ( call SW.singleton en.recipe ) ( string ! type ) ) ( string meal ) ( string = ) en.meal.lunch ) )	overnight-recipes
what recipe has the smallest preparation time	( call SW.listValue ( call SW.superlative ( call SW.getProperty ( call SW.singleton en.recipe ) ( string ! type ) ) ( string min ) ( call SW.ensureNumericProperty ( string preparation_time ) ) ) )	overnight-recipes
what meal doesnt call for rice pudding	( call SW.listValue ( call SW.filter ( call SW.getProperty ( call SW.singleton en.meal ) ( string ! type ) ) ( call SW.reverse ( string meal ) ) ( string ! = ) en.recipe.rice_pudding ) )	overnight-recipes
recipes that require less or same time than the time taken to prepare rice pudding	( call SW.listValue ( call SW.filter ( call SW.getProperty ( call SW.singleton en.recipe ) ( string ! type ) ) ( call SW.ensureNumericProperty ( string preparation_time ) ) ( string <= ) ( call SW.ensureNumericEntity ( call SW.getProperty en.recipe.rice_pudding ( string preparation_time ) ) ) ) )	overnight-recipes
what is a meal that incorporates rice pudding	( call SW.listValue ( call SW.filter ( call SW.filter ( call SW.getProperty ( call SW.singleton en.meal ) ( string ! type ) ) ( call SW.reverse ( string meal ) ) ( string = ) en.recipe.rice_pudding ) ( call SW.reverse ( string meal ) ) ( string = ) en.recipe.rice_pudding ) )	overnight-recipes
show me recipes that have a shorter preparation time than rice pudding	( call SW.listValue ( call SW.filter ( call SW.getProperty ( call SW.singleton en.recipe ) ( string ! type ) ) ( call SW.ensureNumericProperty ( string preparation_time ) ) ( string < ) ( call SW.ensureNumericEntity ( call SW.getProperty en.recipe.rice_pudding ( string preparation_time ) ) ) ) )	overnight-recipes
what meal has less than two recipes for it	( call SW.listValue ( call SW.countComparative ( call SW.getProperty ( call SW.singleton en.meal ) ( string ! type ) ) ( call SW.reverse ( string meal ) ) ( string < ) ( number 2 ) ( call SW.getProperty ( call SW.singleton en.recipe ) ( string ! type ) ) ) )	overnight-recipes
how many recipes are there	( call SW.listValue ( call .size ( call SW.getProperty ( call SW.singleton en.recipe ) ( string ! type ) ) ) )	overnight-recipes
what recipe is the oldest	( call SW.listValue ( call SW.superlative ( call SW.getProperty ( call SW.singleton en.recipe ) ( string ! type ) ) ( string min ) ( call SW.ensureNumericProperty ( string posting_date ) ) ) )	overnight-recipes
what recipe requires more prep time than rice pudding	( call SW.listValue ( call SW.filter ( call SW.getProperty ( call SW.singleton en.recipe ) ( string ! type ) ) ( call SW.ensureNumericProperty ( string preparation_time ) ) ( string > ) ( call SW.ensureNumericEntity ( call SW.getProperty en.recipe.rice_pudding ( string preparation_time ) ) ) ) )	overnight-recipes
show me recipes that take the same amount of time or more to cook as rice pudding	( call SW.listValue ( call SW.filter ( call SW.getProperty ( call SW.singleton en.recipe ) ( string ! type ) ) ( call SW.ensureNumericProperty ( string cooking_time ) ) ( string >= ) ( call SW.ensureNumericEntity ( call SW.getProperty en.recipe.rice_pudding ( string cooking_time ) ) ) ) )	overnight-recipes
show me recipes that require longer time to cook than rice pudding	( call SW.listValue ( call SW.filter ( call SW.getProperty ( call SW.singleton en.recipe ) ( string ! type ) ) ( call SW.ensureNumericProperty ( string preparation_time ) ) ( string > ) ( call SW.ensureNumericEntity ( call SW.getProperty en.recipe.rice_pudding ( string cooking_time ) ) ) ) )	overnight-recipes
show recipes for the meal as the same for rice pudding	( call SW.listValue ( call SW.filter ( call SW.getProperty ( call SW.singleton en.recipe ) ( string ! type ) ) ( string meal ) ( string = ) ( call SW.filter ( call SW.getProperty ( call SW.singleton en.meal ) ( string ! type ) ) ( call SW.reverse ( string meal ) ) ( string = ) en.recipe.rice_pudding ) ) )	overnight-recipes
what recipe can make the most meals	( call SW.listValue ( call SW.countSuperlative ( call SW.getProperty ( call SW.singleton en.recipe ) ( string ! type ) ) ( string max ) ( string meal ) ( call SW.getProperty ( call SW.singleton en.meal ) ( string ! type ) ) ) )	overnight-recipes
show me recipes from the same cuisine as rice pudding	( call SW.listValue ( call SW.filter ( call SW.getProperty ( call SW.singleton en.recipe ) ( string ! type ) ) ( string cuisine ) ( string = ) ( call SW.getProperty en.recipe.rice_pudding ( string cuisine ) ) ) )	overnight-recipes
what recipe is not for a lunch meal	( call SW.listValue ( call SW.filter ( call SW.getProperty ( call SW.singleton en.recipe ) ( string ! type ) ) ( string meal ) ( string = ) en.meal.lunch ) )	overnight-recipes
show me recipes with the most preparation time	( call SW.listValue ( call SW.superlative ( call SW.getProperty ( call SW.singleton en.recipe ) ( string ! type ) ) ( string max ) ( call SW.ensureNumericProperty ( string preparation_time ) ) ) )	overnight-recipes
what recipe was posted in either 2004 or 2010	( call SW.listValue ( call SW.filter ( call SW.getProperty ( call SW.singleton en.recipe ) ( string ! type ) ) ( string posting_date ) ( string = ) ( call SW.concat ( date 2004 -1 -1 ) ( date 2010 -1 -1 ) ) ) )	overnight-recipes
show me recipes posted in 2004 that use milk	( call SW.listValue ( call SW.filter ( call SW.filter ( call SW.getProperty ( call SW.singleton en.recipe ) ( string ! type ) ) ( string posting_date ) ( string = ) ( date 2004 -1 -1 ) ) ( string requires ) ( string = ) en.ingredient.milk ) )	overnight-recipes
show me the most required ingredient in recipes	( call SW.listValue ( call SW.countSuperlative ( call SW.getProperty ( call SW.singleton en.ingredient ) ( string ! type ) ) ( string max ) ( call SW.reverse ( string requires ) ) ( call SW.getProperty ( call SW.singleton en.recipe ) ( string ! type ) ) ) )	overnight-recipes
which recipe was posted during 2004	( call SW.listValue ( call SW.filter ( call SW.getProperty ( call SW.singleton en.recipe ) ( string ! type ) ) ( call SW.ensureNumericProperty ( string posting_date ) ) ( string <= ) ( call SW.ensureNumericEntity ( date 2004 -1 -1 ) ) ) )	overnight-recipes
what recipes have a cooking time that is at least as long as rice puddings preparation time	( call SW.listValue ( call SW.filter ( call SW.getProperty ( call SW.singleton en.recipe ) ( string ! type ) ) ( call SW.ensureNumericProperty ( string cooking_time ) ) ( string >= ) ( call SW.ensureNumericEntity ( call SW.getProperty en.recipe.rice_pudding ( string preparation_time ) ) ) ) )	overnight-recipes
what two ingredients does that recipe require	( call SW.listValue ( call SW.countComparative ( call SW.getProperty ( call SW.singleton en.ingredient ) ( string ! type ) ) ( call SW.reverse ( string requires ) ) ( string = ) ( number 2 ) ( call SW.getProperty ( call SW.singleton en.recipe ) ( string ! type ) ) ) )	overnight-recipes
show me meals with more than two recipes	( call SW.listValue ( call SW.countComparative ( call SW.getProperty ( call SW.singleton en.meal ) ( string ! type ) ) ( call SW.reverse ( string meal ) ) ( string > ) ( number 2 ) ( call SW.getProperty ( call SW.singleton en.recipe ) ( string ! type ) ) ) )	overnight-recipes
show me recipes requiring the ingredient milk	( call SW.listValue ( call SW.filter ( call SW.getProperty ( call SW.singleton en.ingredient ) ( string ! type ) ) ( call SW.reverse ( string requires ) ) ( string = ) ( call SW.filter ( call SW.getProperty ( call SW.singleton en.recipe ) ( string ! type ) ) ( string requires ) ( string = ) en.ingredient.milk ) ) )	overnight-recipes
what is a recipe used for fewer than two meals	( call SW.listValue ( call SW.countComparative ( call SW.getProperty ( call SW.singleton en.recipe ) ( string ! type ) ) ( string meal ) ( string < ) ( number 2 ) ( call SW.getProperty ( call SW.singleton en.meal ) ( string ! type ) ) ) )	overnight-recipes
show me ingredients required by recipes posted in 2004	( call SW.listValue ( call SW.filter ( call SW.getProperty ( call SW.singleton en.ingredient ) ( string ! type ) ) ( call SW.reverse ( string requires ) ) ( string = ) ( call SW.filter ( call SW.getProperty ( call SW.singleton en.recipe ) ( string ! type ) ) ( string posting_date ) ( string = ) ( date 2004 -1 -1 ) ) ) )	overnight-recipes
recipes posted after 2004	( call SW.listValue ( call SW.filter ( call SW.getProperty ( call SW.singleton en.recipe ) ( string ! type ) ) ( call SW.ensureNumericProperty ( string posting_date ) ) ( string > ) ( call SW.ensureNumericEntity ( date 2004 -1 -1 ) ) ) )	overnight-recipes
show me a meal that has more than two recipes	( call SW.listValue ( call SW.countComparative ( call SW.getProperty ( call SW.singleton en.meal ) ( string ! type ) ) ( call SW.reverse ( string meal ) ) ( string > ) ( number 2 ) ( call SW.getProperty ( call SW.singleton en.recipe ) ( string ! type ) ) ) )	overnight-recipes
what recipes preparation time is at least that of rice pudding	( call SW.listValue ( call SW.filter ( call SW.getProperty ( call SW.singleton en.recipe ) ( string ! type ) ) ( call SW.ensureNumericProperty ( string preparation_time ) ) ( string >= ) ( call SW.ensureNumericEntity ( call SW.getProperty en.recipe.rice_pudding ( string preparation_time ) ) ) ) )	overnight-recipes
show me recipes posted in 2004 and 2010	( call SW.listValue ( call SW.filter ( call SW.getProperty ( call SW.singleton en.recipe ) ( string ! type ) ) ( string posting_date ) ( string = ) ( call SW.concat ( date 2004 -1 -1 ) ( date 2010 -1 -1 ) ) ) )	overnight-recipes
for what meal is rice pudding used	( call SW.listValue ( call SW.filter ( call SW.filter ( call SW.getProperty ( call SW.singleton en.meal ) ( string ! type ) ) ( call SW.reverse ( string meal ) ) ( string = ) en.recipe.rice_pudding ) ( call SW.reverse ( string meal ) ) ( string = ) en.recipe.rice_pudding ) )	overnight-recipes
what recipe makes the fewest types of cuisine	( call SW.listValue ( call SW.countSuperlative ( call SW.getProperty ( call SW.singleton en.recipe ) ( string ! type ) ) ( string min ) ( string cuisine ) ) )	overnight-recipes
what recipes posting date is not in 2004	( call SW.listValue ( call SW.filter ( call SW.getProperty ( call SW.singleton en.recipe ) ( string ! type ) ) ( string posting_date ) ( string ! = ) ( date 2004 -1 -1 ) ) )	overnight-recipes
what is a recipe that is for more than two different meals	( call SW.listValue ( call SW.countComparative ( call SW.getProperty ( call SW.singleton en.recipe ) ( string ! type ) ) ( string meal ) ( string > ) ( number 2 ) ( call SW.getProperty ( call SW.singleton en.meal ) ( string ! type ) ) ) )	overnight-recipes
what ingredients do recipes posted in 2004 call for	( call SW.listValue ( call SW.filter ( call SW.getProperty ( call SW.singleton en.ingredient ) ( string ! type ) ) ( call SW.reverse ( string requires ) ) ( string = ) ( call SW.filter ( call SW.getProperty ( call SW.singleton en.recipe ) ( string ! type ) ) ( string posting_date ) ( string = ) ( date 2004 -1 -1 ) ) ) )	overnight-recipes
show me recipes posted in 2004	( call SW.listValue ( call SW.filter ( call SW.getProperty ( call SW.singleton en.recipe ) ( string ! type ) ) ( string posting_date ) ( string = ) ( date 2004 -1 -1 ) ) )	overnight-recipes
which recipes have less than two cuisines	( call SW.listValue ( call SW.countComparative ( call SW.getProperty ( call SW.singleton en.recipe ) ( string ! type ) ) ( string cuisine ) ( string < ) ( number 2 ) ) )	overnight-recipes
which recipe has less cooking time like rice pudding	( call SW.listValue ( call SW.filter ( call SW.getProperty ( call SW.singleton en.recipe ) ( string ! type ) ) ( call SW.ensureNumericProperty ( string cooking_time ) ) ( string >= ) ( call SW.ensureNumericEntity ( call SW.getProperty en.recipe.rice_pudding ( string cooking_time ) ) ) ) )	overnight-recipes
name a recipe which was posted on or later than the posting date of the rice pudding recipe	( call SW.listValue ( call SW.filter ( call SW.getProperty ( call SW.singleton en.recipe ) ( string ! type ) ) ( call SW.ensureNumericProperty ( string posting_date ) ) ( string >= ) ( call SW.ensureNumericEntity ( call SW.getProperty en.recipe.rice_pudding ( string posting_date ) ) ) ) )	overnight-recipes
what recipe has the fewest number of cuisine	( call SW.listValue ( call SW.countSuperlative ( call SW.getProperty ( call SW.singleton en.recipe ) ( string ! type ) ) ( string min ) ( string cuisine ) ) )	overnight-recipes
recipe with posting date 2004	( call SW.listValue ( call SW.filter ( call SW.getProperty ( call SW.singleton en.recipe ) ( string ! type ) ) ( string posting_date ) ( string = ) ( date 2004 -1 -1 ) ) )	overnight-recipes
what recipe posted in 2004 requires milk as an ingredient	( call SW.listValue ( call SW.filter ( call SW.filter ( call SW.getProperty ( call SW.singleton en.recipe ) ( string ! type ) ) ( string posting_date ) ( string = ) ( date 2004 -1 -1 ) ) ( string requires ) ( string = ) en.ingredient.milk ) )	overnight-recipes
name ingredients that is not required for rice pudding	( call SW.listValue ( call SW.filter ( call SW.getProperty ( call SW.singleton en.ingredient ) ( string ! type ) ) ( call SW.reverse ( string requires ) ) ( string ! = ) en.recipe.rice_pudding ) )	overnight-recipes
for which meal is rice pudding or quiche had	( call SW.listValue ( call SW.filter ( call SW.getProperty ( call SW.singleton en.meal ) ( string ! type ) ) ( call SW.reverse ( string meal ) ) ( string = ) ( call SW.concat en.recipe.rice_pudding en.recipe.quiche ) ) )	overnight-recipes
which ingredient is needed in the least number of recipes	( call SW.listValue ( call SW.countSuperlative ( call SW.getProperty ( call SW.singleton en.ingredient ) ( string ! type ) ) ( string min ) ( call SW.reverse ( string requires ) ) ( call SW.getProperty ( call SW.singleton en.recipe ) ( string ! type ) ) ) )	overnight-recipes
what recipe has the shortest cooking time	( call SW.listValue ( call SW.superlative ( call SW.getProperty ( call SW.singleton en.recipe ) ( string ! type ) ) ( string min ) ( call SW.ensureNumericProperty ( string cooking_time ) ) ) )	overnight-recipes
what recipe takes longer to cook than rice pudding	( call SW.listValue ( call SW.filter ( call SW.getProperty ( call SW.singleton en.recipe ) ( string ! type ) ) ( call SW.ensureNumericProperty ( string cooking_time ) ) ( string > ) ( call SW.ensureNumericEntity ( call SW.getProperty en.recipe.rice_pudding ( string cooking_time ) ) ) ) )	overnight-recipes
what recipe was posted before or on the same day as rice pudding	( call SW.listValue ( call SW.filter ( call SW.getProperty ( call SW.singleton en.recipe ) ( string ! type ) ) ( call SW.ensureNumericProperty ( string posting_date ) ) ( string <= ) ( call SW.ensureNumericEntity ( call SW.getProperty en.recipe.rice_pudding ( string posting_date ) ) ) ) )	overnight-recipes
ingredient required by least number of recipes	( call SW.listValue ( call SW.countSuperlative ( call SW.getProperty ( call SW.singleton en.ingredient ) ( string ! type ) ) ( string min ) ( call SW.reverse ( string requires ) ) ( call SW.getProperty ( call SW.singleton en.recipe ) ( string ! type ) ) ) )	overnight-recipes
what recipes ingredient does this lunch require	( call SW.listValue ( call SW.filter ( call SW.getProperty ( call SW.singleton en.ingredient ) ( string ! type ) ) ( call SW.reverse ( string requires ) ) ( string = ) ( call SW.filter ( call SW.getProperty ( call SW.singleton en.recipe ) ( string ! type ) ) ( string meal ) ( string = ) en.meal.lunch ) ) )	overnight-recipes
what recipe calling for milk was posted in 2004	( call SW.listValue ( call SW.filter ( call SW.filter ( call SW.getProperty ( call SW.singleton en.recipe ) ( string ! type ) ) ( string posting_date ) ( string = ) ( date 2004 -1 -1 ) ) ( string requires ) ( string = ) en.ingredient.milk ) )	overnight-recipes
show me recipes with cooking time equal to or greater than cooking time for rice pudding	( call SW.listValue ( call SW.filter ( call SW.getProperty ( call SW.singleton en.recipe ) ( string ! type ) ) ( call SW.ensureNumericProperty ( string cooking_time ) ) ( string >= ) ( call SW.ensureNumericEntity ( call SW.getProperty en.recipe.rice_pudding ( string cooking_time ) ) ) ) )	overnight-recipes
what recipe cooks in more or the same time as rice pudding takes to prep	( call SW.listValue ( call SW.filter ( call SW.getProperty ( call SW.singleton en.recipe ) ( string ! type ) ) ( call SW.ensureNumericProperty ( string cooking_time ) ) ( string >= ) ( call SW.ensureNumericEntity ( call SW.getProperty en.recipe.rice_pudding ( string preparation_time ) ) ) ) )	overnight-recipes
find recipes that were posted before 2004 or 2010	( call SW.listValue ( call SW.filter ( call SW.getProperty ( call SW.singleton en.recipe ) ( string ! type ) ) ( call SW.ensureNumericProperty ( string posting_date ) ) ( string < ) ( call SW.ensureNumericEntity ( call SW.concat ( date 2004 -1 -1 ) ( date 2010 -1 -1 ) ) ) ) )	overnight-recipes
show me recipes that require cooking time thats more than rice pudding	( call SW.listValue ( call SW.filter ( call SW.getProperty ( call SW.singleton en.recipe ) ( string ! type ) ) ( call SW.ensureNumericProperty ( string cooking_time ) ) ( string > ) ( call SW.ensureNumericEntity ( call SW.getProperty en.recipe.rice_pudding ( string cooking_time ) ) ) ) )	overnight-recipes
show me meal recipes including rice pudding	( call SW.listValue ( call SW.filter ( call SW.getProperty ( call SW.singleton en.recipe ) ( string ! type ) ) ( string meal ) ( string = ) ( call SW.filter ( call SW.getProperty ( call SW.singleton en.meal ) ( string ! type ) ) ( call SW.reverse ( string meal ) ) ( string = ) en.recipe.rice_pudding ) ) )	overnight-recipes
what is the average time needed for the preparation of the dish	( call SW.listValue ( call SW.aggregate ( string avg ) ( call SW.getProperty ( call SW.getProperty ( call SW.singleton en.recipe ) ( string ! type ) ) ( string cooking_time ) ) ) )	overnight-recipes
what recipe was posted before rice puddings recipe	( call SW.listValue ( call SW.filter ( call SW.getProperty ( call SW.singleton en.recipe ) ( string ! type ) ) ( call SW.ensureNumericProperty ( string posting_date ) ) ( string < ) ( call SW.ensureNumericEntity ( call SW.getProperty en.recipe.rice_pudding ( string posting_date ) ) ) ) )	overnight-recipes
recipes posted in 2004 and later	( call SW.listValue ( call SW.filter ( call SW.getProperty ( call SW.singleton en.recipe ) ( string ! type ) ) ( call SW.ensureNumericProperty ( string posting_date ) ) ( string >= ) ( call SW.ensureNumericEntity ( date 2004 -1 -1 ) ) ) )	overnight-recipes
what ingredients are used least in recipes	( call SW.listValue ( call SW.countSuperlative ( call SW.getProperty ( call SW.singleton en.ingredient ) ( string ! type ) ) ( string min ) ( call SW.reverse ( string requires ) ) ( call SW.getProperty ( call SW.singleton en.recipe ) ( string ! type ) ) ) )	overnight-recipes
show me recipe that require longer time to cook than rice pudding	( call SW.listValue ( call SW.filter ( call SW.getProperty ( call SW.singleton en.recipe ) ( string ! type ) ) ( call SW.ensureNumericProperty ( string cooking_time ) ) ( string > ) ( call SW.ensureNumericEntity ( call SW.getProperty en.recipe.rice_pudding ( string cooking_time ) ) ) ) )	overnight-recipes
what recipe has the most types of cuisine	( call SW.listValue ( call SW.countSuperlative ( call SW.getProperty ( call SW.singleton en.recipe ) ( string ! type ) ) ( string max ) ( string cuisine ) ) )	overnight-recipes
which meal has least number of recipes	( call SW.listValue ( call SW.countSuperlative ( call SW.getProperty ( call SW.singleton en.meal ) ( string ! type ) ) ( string min ) ( call SW.reverse ( string meal ) ) ( call SW.getProperty ( call SW.singleton en.recipe ) ( string ! type ) ) ) )	overnight-recipes
what recipes need three or more ingredients	( call SW.listValue ( call SW.countComparative ( call SW.getProperty ( call SW.singleton en.recipe ) ( string ! type ) ) ( string requires ) ( string > ) ( number 2 ) ( call SW.getProperty ( call SW.singleton en.ingredient ) ( string ! type ) ) ) )	overnight-recipes
what is a meal with a recipe posted in 2004	( call SW.listValue ( call SW.filter ( call SW.getProperty ( call SW.singleton en.meal ) ( string ! type ) ) ( call SW.reverse ( string meal ) ) ( string = ) ( call SW.filter ( call SW.getProperty ( call SW.singleton en.recipe ) ( string ! type ) ) ( string posting_date ) ( string = ) ( date 2004 -1 -1 ) ) ) )	overnight-recipes
show me recipes with cooking times equal to cooking time of rice pudding	( call SW.listValue ( call SW.filter ( call SW.getProperty ( call SW.singleton en.recipe ) ( string ! type ) ) ( string cooking_time ) ( string = ) ( call SW.getProperty en.recipe.rice_pudding ( string cooking_time ) ) ) )	overnight-recipes
show me recipes posted the same day as rice pudding or before	( call SW.listValue ( call SW.filter ( call SW.getProperty ( call SW.singleton en.recipe ) ( string ! type ) ) ( call SW.ensureNumericProperty ( string posting_date ) ) ( string <= ) ( call SW.ensureNumericEntity ( call SW.getProperty en.recipe.rice_pudding ( string posting_date ) ) ) ) )	overnight-recipes
a recipe with milk posted in 2004	( call SW.listValue ( call SW.filter ( call SW.filter ( call SW.getProperty ( call SW.singleton en.recipe ) ( string ! type ) ) ( string posting_date ) ( string = ) ( date 2004 -1 -1 ) ) ( string requires ) ( string = ) en.ingredient.milk ) )	overnight-recipes
for what meal is rice pudding	( call SW.listValue ( call SW.filter ( call SW.filter ( call SW.getProperty ( call SW.singleton en.meal ) ( string ! type ) ) ( call SW.reverse ( string meal ) ) ( string = ) en.recipe.rice_pudding ) ( call SW.reverse ( string meal ) ) ( string = ) en.recipe.rice_pudding ) )	overnight-recipes
show me recipes that required two or more ingredients	( call SW.listValue ( call SW.countComparative ( call SW.getProperty ( call SW.singleton en.recipe ) ( string ! type ) ) ( string requires ) ( string >= ) ( number 2 ) ( call SW.getProperty ( call SW.singleton en.ingredient ) ( string ! type ) ) ) )	overnight-recipes
how much time is needed to cook this dish	( call SW.listValue ( call SW.aggregate ( string sum ) ( call SW.getProperty ( call SW.getProperty ( call SW.singleton en.recipe ) ( string ! type ) ) ( string cooking_time ) ) ) )	overnight-recipes
which recipes have the most number of meals	( call SW.listValue ( call SW.countSuperlative ( call SW.getProperty ( call SW.singleton en.recipe ) ( string ! type ) ) ( string max ) ( string meal ) ( call SW.getProperty ( call SW.singleton en.meal ) ( string ! type ) ) ) )	overnight-recipes
what meal is rice pudding or quiche in	( call SW.listValue ( call SW.filter ( call SW.getProperty ( call SW.singleton en.meal ) ( string ! type ) ) ( call SW.reverse ( string meal ) ) ( string = ) ( call SW.concat en.recipe.rice_pudding en.recipe.quiche ) ) )	overnight-recipes
what ingredient is used for the least amount of recipes	( call SW.listValue ( call SW.countSuperlative ( call SW.getProperty ( call SW.singleton en.ingredient ) ( string ! type ) ) ( string min ) ( call SW.reverse ( string requires ) ) ( call SW.getProperty ( call SW.singleton en.recipe ) ( string ! type ) ) ) )	overnight-recipes
show me recipe requiring milk posted in 2004	( call SW.listValue ( call SW.filter ( call SW.filter ( call SW.getProperty ( call SW.singleton en.recipe ) ( string ! type ) ) ( string requires ) ( string = ) en.ingredient.milk ) ( string posting_date ) ( string = ) ( date 2004 -1 -1 ) ) )	overnight-recipes
what recipe takes longer to cook than rice pudding takes to prep	( call SW.listValue ( call SW.filter ( call SW.getProperty ( call SW.singleton en.recipe ) ( string ! type ) ) ( call SW.ensureNumericProperty ( string cooking_time ) ) ( string > ) ( call SW.ensureNumericEntity ( call SW.getProperty en.recipe.rice_pudding ( string preparation_time ) ) ) ) )	overnight-recipes
meal than has rice pudding or quiche	( call SW.listValue ( call SW.filter ( call SW.getProperty ( call SW.singleton en.meal ) ( string ! type ) ) ( call SW.reverse ( string meal ) ) ( string = ) ( call SW.concat en.recipe.rice_pudding en.recipe.quiche ) ) )	overnight-recipes
either lunch or dinner	( call SW.listValue ( call SW.concat en.meal.lunch en.meal.dinner ) )	overnight-recipes
what recipe takes the longest to prepare	( call SW.listValue ( call SW.superlative ( call SW.getProperty ( call SW.singleton en.recipe ) ( string ! type ) ) ( string max ) ( call SW.ensureNumericProperty ( string preparation_time ) ) ) )	overnight-recipes
show me recipes that take the same amount of time to prepare as rice pudding does to cook	( call SW.listValue ( call SW.filter ( call SW.getProperty ( call SW.singleton en.recipe ) ( string ! type ) ) ( string preparation_time ) ( string = ) ( call SW.getProperty en.recipe.rice_pudding ( string cooking_time ) ) ) )	overnight-recipes
how many total meals are there	( call SW.listValue ( call .size ( call SW.getProperty ( call SW.singleton en.meal ) ( string ! type ) ) ) )	overnight-recipes
what recipe takes the longest to cook	( call SW.listValue ( call SW.superlative ( call SW.getProperty ( call SW.singleton en.recipe ) ( string ! type ) ) ( string max ) ( call SW.ensureNumericProperty ( string cooking_time ) ) ) )	overnight-recipes
what meal is rice pudding or quiche made for	( call SW.listValue ( call SW.filter ( call SW.getProperty ( call SW.singleton en.meal ) ( string ! type ) ) ( call SW.reverse ( string meal ) ) ( string = ) ( call SW.concat en.recipe.rice_pudding en.recipe.quiche ) ) )	overnight-recipes
recipes posted till rice pudding is posted	( call SW.listValue ( call SW.filter ( call SW.getProperty ( call SW.singleton en.recipe ) ( string ! type ) ) ( call SW.ensureNumericProperty ( string posting_date ) ) ( string <= ) ( call SW.ensureNumericEntity ( call SW.getProperty en.recipe.rice_pudding ( string posting_date ) ) ) ) )	overnight-recipes
which meal has less than two recipes	( call SW.listValue ( call SW.countComparative ( call SW.getProperty ( call SW.singleton en.meal ) ( string ! type ) ) ( call SW.reverse ( string meal ) ) ( string < ) ( number 2 ) ( call SW.getProperty ( call SW.singleton en.recipe ) ( string ! type ) ) ) )	overnight-recipes
what recipe was posted the earliest	( call SW.listValue ( call SW.superlative ( call SW.getProperty ( call SW.singleton en.recipe ) ( string ! type ) ) ( string min ) ( call SW.ensureNumericProperty ( string posting_date ) ) ) )	overnight-recipes
show me recipes that need milk and were posted in 2004	( call SW.listValue ( call SW.filter ( call SW.filter ( call SW.getProperty ( call SW.singleton en.recipe ) ( string ! type ) ) ( string requires ) ( string = ) en.ingredient.milk ) ( string posting_date ) ( string = ) ( date 2004 -1 -1 ) ) )	overnight-recipes
what is the cook time for rice pudding	( call SW.listValue ( call SW.getProperty en.recipe.rice_pudding ( string cooking_time ) ) )	overnight-recipes
what recipes takes more time to prepare than rice pudding	( call SW.listValue ( call SW.filter ( call SW.getProperty ( call SW.singleton en.recipe ) ( string ! type ) ) ( call SW.ensureNumericProperty ( string cooking_time ) ) ( string > ) ( call SW.ensureNumericEntity ( call SW.getProperty en.recipe.rice_pudding ( string cooking_time ) ) ) ) )	overnight-recipes
which recipe has a prep time no greater than the prep time for rice pudding	( call SW.listValue ( call SW.filter ( call SW.getProperty ( call SW.singleton en.recipe ) ( string ! type ) ) ( call SW.ensureNumericProperty ( string preparation_time ) ) ( string <= ) ( call SW.ensureNumericEntity ( call SW.getProperty en.recipe.rice_pudding ( string preparation_time ) ) ) ) )	overnight-recipes
how long does it take to prepare rice pudding	( call SW.listValue ( call SW.getProperty en.recipe.rice_pudding ( string preparation_time ) ) )	overnight-recipes
which recipe requires the least cooking time	( call SW.listValue ( call SW.superlative ( call SW.getProperty ( call SW.singleton en.recipe ) ( string ! type ) ) ( string min ) ( call SW.ensureNumericProperty ( string cooking_time ) ) ) )	overnight-recipes
which meal has two or more recipes	( call SW.listValue ( call SW.countComparative ( call SW.getProperty ( call SW.singleton en.meal ) ( string ! type ) ) ( call SW.reverse ( string meal ) ) ( string >= ) ( number 2 ) ( call SW.getProperty ( call SW.singleton en.recipe ) ( string ! type ) ) ) )	overnight-recipes
show recipes that requires lesser preparation than rice pudding	( call SW.listValue ( call SW.filter ( call SW.getProperty ( call SW.singleton en.recipe ) ( string ! type ) ) ( call SW.ensureNumericProperty ( string preparation_time ) ) ( string < ) ( call SW.ensureNumericEntity ( call SW.getProperty en.recipe.rice_pudding ( string preparation_time ) ) ) ) )	overnight-recipes
show recipes whose posted date is on or before 2004	( call SW.listValue ( call SW.filter ( call SW.getProperty ( call SW.singleton en.recipe ) ( string ! type ) ) ( call SW.ensureNumericProperty ( string posting_date ) ) ( string <= ) ( call SW.ensureNumericEntity ( date 2004 -1 -1 ) ) ) )	overnight-recipes
find a recipe which has a longer cooking time than rice pudding	( call SW.listValue ( call SW.filter ( call SW.getProperty ( call SW.singleton en.recipe ) ( string ! type ) ) ( call SW.ensureNumericProperty ( string cooking_time ) ) ( string > ) ( call SW.ensureNumericEntity ( call SW.getProperty en.recipe.rice_pudding ( string preparation_time ) ) ) ) )	overnight-recipes
which recipes were posted before 2004 or 2010	( call SW.listValue ( call SW.filter ( call SW.getProperty ( call SW.singleton en.recipe ) ( string ! type ) ) ( call SW.ensureNumericProperty ( string posting_date ) ) ( string < ) ( call SW.ensureNumericEntity ( call SW.concat ( date 2004 -1 -1 ) ( date 2010 -1 -1 ) ) ) ) )	overnight-recipes
which recipes were posted up to 2004 or 2010	( call SW.listValue ( call SW.filter ( call SW.getProperty ( call SW.singleton en.recipe ) ( string ! type ) ) ( call SW.ensureNumericProperty ( string posting_date ) ) ( string <= ) ( call SW.ensureNumericEntity ( call SW.concat ( date 2004 -1 -1 ) ( date 2010 -1 -1 ) ) ) ) )	overnight-recipes
recipe whose cooking time is not more than rice pudding	( call SW.listValue ( call SW.filter ( call SW.getProperty ( call SW.singleton en.recipe ) ( string ! type ) ) ( call SW.ensureNumericProperty ( string cooking_time ) ) ( string <= ) ( call SW.ensureNumericEntity ( call SW.getProperty en.recipe.rice_pudding ( string cooking_time ) ) ) ) )	overnight-recipes
show the recipe that takes the longest time to cook	( call SW.listValue ( call SW.superlative ( call SW.getProperty ( call SW.singleton en.recipe ) ( string ! type ) ) ( string max ) ( call SW.ensureNumericProperty ( string cooking_time ) ) ) )	overnight-recipes
two cuisine recipe	( call SW.listValue ( call SW.countComparative ( call SW.getProperty ( call SW.singleton en.recipe ) ( string ! type ) ) ( string cuisine ) ( string = ) ( number 2 ) ) )	overnight-recipes
show me recipes that have a preparation time less than the cooking time of rice pudding	( call SW.listValue ( call SW.filter ( call SW.getProperty ( call SW.singleton en.recipe ) ( string ! type ) ) ( call SW.ensureNumericProperty ( string preparation_time ) ) ( string < ) ( call SW.ensureNumericEntity ( call SW.getProperty en.recipe.rice_pudding ( string cooking_time ) ) ) ) )	overnight-recipes
find  lunch recipes posted in 2004	( call SW.listValue ( call SW.filter ( call SW.filter ( call SW.getProperty ( call SW.singleton en.recipe ) ( string ! type ) ) ( string posting_date ) ( string = ) ( date 2004 -1 -1 ) ) ( string meal ) ( string = ) en.meal.lunch ) )	overnight-recipes
show me recipes with fewer than two ingredients	( call SW.listValue ( call SW.countComparative ( call SW.getProperty ( call SW.singleton en.recipe ) ( string ! type ) ) ( string requires ) ( string < ) ( number 2 ) ( call SW.getProperty ( call SW.singleton en.ingredient ) ( string ! type ) ) ) )	overnight-recipes
show me meals with the least recipes	( call SW.listValue ( call SW.countSuperlative ( call SW.getProperty ( call SW.singleton en.meal ) ( string ! type ) ) ( string min ) ( call SW.reverse ( string meal ) ) ( call SW.getProperty ( call SW.singleton en.recipe ) ( string ! type ) ) ) )	overnight-recipes
how many ingredients are there	( call SW.listValue ( call .size ( call SW.getProperty ( call SW.singleton en.ingredient ) ( string ! type ) ) ) )	overnight-recipes
recipes total preparation time	( call SW.listValue ( call SW.aggregate ( string sum ) ( call SW.getProperty ( call SW.getProperty ( call SW.singleton en.recipe ) ( string ! type ) ) ( string preparation_time ) ) ) )	overnight-recipes
how long does this recipe take to cook	( call SW.listValue ( call SW.aggregate ( string sum ) ( call SW.getProperty ( call SW.getProperty ( call SW.singleton en.recipe ) ( string ! type ) ) ( string cooking_time ) ) ) )	overnight-recipes
show me recipes that requires the most time to prepare the dish	( call SW.listValue ( call SW.superlative ( call SW.getProperty ( call SW.singleton en.recipe ) ( string ! type ) ) ( string max ) ( call SW.ensureNumericProperty ( string preparation_time ) ) ) )	overnight-recipes
which recipe can be used for two or more meals	( call SW.listValue ( call SW.countComparative ( call SW.getProperty ( call SW.singleton en.recipe ) ( string ! type ) ) ( string meal ) ( string >= ) ( number 2 ) ( call SW.getProperty ( call SW.singleton en.meal ) ( string ! type ) ) ) )	overnight-recipes
what recipe is most recent	( call SW.listValue ( call SW.superlative ( call SW.getProperty ( call SW.singleton en.recipe ) ( string ! type ) ) ( string max ) ( call SW.ensureNumericProperty ( string posting_date ) ) ) )	overnight-recipes
what recipe has a cuisine including rice pudding	( call SW.listValue ( call SW.filter ( call SW.getProperty ( call SW.singleton en.recipe ) ( string ! type ) ) ( string cuisine ) ( string = ) ( call SW.getProperty en.recipe.rice_pudding ( string cuisine ) ) ) )	overnight-recipes
recipe with posting date not after posting date of rice pudding	( call SW.listValue ( call SW.filter ( call SW.getProperty ( call SW.singleton en.recipe ) ( string ! type ) ) ( call SW.ensureNumericProperty ( string posting_date ) ) ( string <= ) ( call SW.ensureNumericEntity ( call SW.getProperty en.recipe.rice_pudding ( string posting_date ) ) ) ) )	overnight-recipes
what ingredients are required in two recipes	( call SW.listValue ( call SW.countComparative ( call SW.getProperty ( call SW.singleton en.ingredient ) ( string ! type ) ) ( call SW.reverse ( string requires ) ) ( string = ) ( number 2 ) ( call SW.getProperty ( call SW.singleton en.recipe ) ( string ! type ) ) ) )	overnight-recipes
show ingredients for lunch recipes	( call SW.listValue ( call SW.filter ( call SW.getProperty ( call SW.singleton en.ingredient ) ( string ! type ) ) ( call SW.reverse ( string requires ) ) ( string = ) ( call SW.filter ( call SW.getProperty ( call SW.singleton en.recipe ) ( string ! type ) ) ( string meal ) ( string = ) en.meal.lunch ) ) )	overnight-recipes
show me recipes with a preparation time greater than rice pudding	( call SW.listValue ( call SW.filter ( call SW.getProperty ( call SW.singleton en.recipe ) ( string ! type ) ) ( call SW.ensureNumericProperty ( string preparation_time ) ) ( string > ) ( call SW.ensureNumericEntity ( call SW.getProperty en.recipe.rice_pudding ( string preparation_time ) ) ) ) )	overnight-recipes
what meal can you find at least two recipes for	( call SW.listValue ( call SW.countComparative ( call SW.getProperty ( call SW.singleton en.meal ) ( string ! type ) ) ( call SW.reverse ( string meal ) ) ( string >= ) ( number 2 ) ( call SW.getProperty ( call SW.singleton en.recipe ) ( string ! type ) ) ) )	overnight-recipes
show me a recipe that requires only two ingredients	( call SW.listValue ( call SW.countComparative ( call SW.getProperty ( call SW.singleton en.recipe ) ( string ! type ) ) ( string requires ) ( string = ) ( number 2 ) ( call SW.getProperty ( call SW.singleton en.ingredient ) ( string ! type ) ) ) )	overnight-recipes
what ingredient is in two or less recipes	( call SW.listValue ( call SW.countComparative ( call SW.getProperty ( call SW.singleton en.ingredient ) ( string ! type ) ) ( call SW.reverse ( string requires ) ) ( string <= ) ( number 2 ) ( call SW.getProperty ( call SW.singleton en.recipe ) ( string ! type ) ) ) )	overnight-recipes
show me ingredients required for fewer than two recipes	( call SW.listValue ( call SW.countComparative ( call SW.getProperty ( call SW.singleton en.ingredient ) ( string ! type ) ) ( call SW.reverse ( string requires ) ) ( string < ) ( number 2 ) ( call SW.getProperty ( call SW.singleton en.recipe ) ( string ! type ) ) ) )	overnight-recipes
which recipe was not posted in 2004	( call SW.listValue ( call SW.filter ( call SW.getProperty ( call SW.singleton en.recipe ) ( string ! type ) ) ( string posting_date ) ( string ! = ) ( date 2004 -1 -1 ) ) )	overnight-recipes
show me two recipes for a meal	( call SW.listValue ( call SW.countComparative ( call SW.getProperty ( call SW.singleton en.meal ) ( string ! type ) ) ( call SW.reverse ( string meal ) ) ( string = ) ( number 2 ) ( call SW.getProperty ( call SW.singleton en.recipe ) ( string ! type ) ) ) )	overnight-recipes
show recipes with milk as an ingredient and is posted in 2004	( call SW.listValue ( call SW.filter ( call SW.filter ( call SW.getProperty ( call SW.singleton en.recipe ) ( string ! type ) ) ( string posting_date ) ( string = ) ( date 2004 -1 -1 ) ) ( string requires ) ( string = ) en.ingredient.milk ) )	overnight-recipes
which recipes require at least two ingredients	( call SW.listValue ( call SW.countComparative ( call SW.getProperty ( call SW.singleton en.recipe ) ( string ! type ) ) ( string requires ) ( string >= ) ( number 2 ) ( call SW.getProperty ( call SW.singleton en.ingredient ) ( string ! type ) ) ) )	overnight-recipes
show recipes posted on the same date as rice pudding	( call SW.listValue ( call SW.filter ( call SW.getProperty ( call SW.singleton en.recipe ) ( string ! type ) ) ( string posting_date ) ( string = ) ( call SW.getProperty en.recipe.rice_pudding ( string posting_date ) ) ) )	overnight-recipes
recipe of at least two cuisine	( call SW.listValue ( call SW.countComparative ( call SW.getProperty ( call SW.singleton en.recipe ) ( string ! type ) ) ( string cuisine ) ( string >= ) ( number 2 ) ) )	overnight-recipes
show me recipes that cannot be taken for lunch	( call SW.listValue ( call SW.filter ( call SW.getProperty ( call SW.singleton en.recipe ) ( string ! type ) ) ( string meal ) ( string ! = ) en.meal.lunch ) )	overnight-recipes
what is a recipe which was posted no later than 2004	( call SW.listValue ( call SW.filter ( call SW.getProperty ( call SW.singleton en.recipe ) ( string ! type ) ) ( call SW.ensureNumericProperty ( string posting_date ) ) ( string <= ) ( call SW.ensureNumericEntity ( date 2004 -1 -1 ) ) ) )	overnight-recipes
what is the posting date for rice pudding	( call SW.listValue ( call SW.getProperty en.recipe.rice_pudding ( string posting_date ) ) )	overnight-recipes
which recipe was posted the earliest	( call SW.listValue ( call SW.superlative ( call SW.getProperty ( call SW.singleton en.recipe ) ( string ! type ) ) ( string min ) ( call SW.ensureNumericProperty ( string posting_date ) ) ) )	overnight-recipes
recipe requires less than three ingredients	( call SW.listValue ( call SW.countComparative ( call SW.getProperty ( call SW.singleton en.recipe ) ( string ! type ) ) ( string requires ) ( string <= ) ( number 2 ) ( call SW.getProperty ( call SW.singleton en.ingredient ) ( string ! type ) ) ) )	overnight-recipes
for what meals share two or more recipes	( call SW.listValue ( call SW.countComparative ( call SW.getProperty ( call SW.singleton en.meal ) ( string ! type ) ) ( call SW.reverse ( string meal ) ) ( string > ) ( number 2 ) ( call SW.getProperty ( call SW.singleton en.recipe ) ( string ! type ) ) ) )	overnight-recipes
what ingredient is found in rice pudding	( call SW.listValue ( call SW.filter ( call SW.getProperty ( call SW.singleton en.recipe ) ( string ! type ) ) ( string requires ) ( string = ) ( call SW.filter ( call SW.getProperty ( call SW.singleton en.ingredient ) ( string ! type ) ) ( call SW.reverse ( string requires ) ) ( string = ) en.recipe.rice_pudding ) ) )	overnight-recipes
what recipes require one or two ingredients	( call SW.listValue ( call SW.countComparative ( call SW.getProperty ( call SW.singleton en.recipe ) ( string ! type ) ) ( string requires ) ( string <= ) ( number 2 ) ( call SW.getProperty ( call SW.singleton en.ingredient ) ( string ! type ) ) ) )	overnight-recipes
what recipes posting date is in 2004 and what ingredients does it require	( call SW.listValue ( call SW.filter ( call SW.getProperty ( call SW.singleton en.ingredient ) ( string ! type ) ) ( call SW.reverse ( string requires ) ) ( string = ) ( call SW.filter ( call SW.getProperty ( call SW.singleton en.recipe ) ( string ! type ) ) ( string posting_date ) ( string = ) ( date 2004 -1 -1 ) ) ) )	overnight-recipes
show me recipes posted in 2004	( call SW.listValue ( call SW.filter ( call SW.getProperty ( call SW.singleton en.recipe ) ( string ! type ) ) ( string posting_date ) ( string = ) ( date 2004 -1 -1 ) ) )	overnight-recipes
how many meals do we have everyday	( call SW.listValue ( call .size ( call SW.getProperty ( call SW.singleton en.meal ) ( string ! type ) ) ) )	overnight-recipes
find a recipe that takes the same time to cook as rice pudding	( call SW.listValue ( call SW.filter ( call SW.getProperty ( call SW.singleton en.recipe ) ( string ! type ) ) ( string preparation_time ) ( string = ) ( call SW.getProperty en.recipe.rice_pudding ( string preparation_time ) ) ) )	overnight-recipes
show me recipes posted before rice pudding	( call SW.listValue ( call SW.filter ( call SW.getProperty ( call SW.singleton en.recipe ) ( string ! type ) ) ( call SW.ensureNumericProperty ( string posting_date ) ) ( string < ) ( call SW.ensureNumericEntity ( call SW.getProperty en.recipe.rice_pudding ( string posting_date ) ) ) ) )	overnight-recipes
show me meals with two recipes	( call SW.listValue ( call SW.countComparative ( call SW.getProperty ( call SW.singleton en.meal ) ( string ! type ) ) ( call SW.reverse ( string meal ) ) ( string = ) ( number 2 ) ( call SW.getProperty ( call SW.singleton en.recipe ) ( string ! type ) ) ) )	overnight-recipes
find a lunch recipe that was posted in 2004	( call SW.listValue ( call SW.filter ( call SW.filter ( call SW.getProperty ( call SW.singleton en.recipe ) ( string ! type ) ) ( string meal ) ( string = ) en.meal.lunch ) ( string posting_date ) ( string = ) ( date 2004 -1 -1 ) ) )	overnight-recipes
show me recipes for lunch or supper	( call SW.listValue ( call SW.filter ( call SW.getProperty ( call SW.singleton en.recipe ) ( string ! type ) ) ( string meal ) ( string = ) ( call SW.concat en.meal.lunch en.meal.dinner ) ) )	overnight-recipes
what recipe takes longer to prep than rice pudding	( call SW.listValue ( call SW.filter ( call SW.getProperty ( call SW.singleton en.recipe ) ( string ! type ) ) ( call SW.ensureNumericProperty ( string preparation_time ) ) ( string > ) ( call SW.ensureNumericEntity ( call SW.getProperty en.recipe.rice_pudding ( string preparation_time ) ) ) ) )	overnight-recipes
what recipes share ingredients	( call SW.listValue ( call SW.countComparative ( call SW.getProperty ( call SW.singleton en.ingredient ) ( string ! type ) ) ( call SW.reverse ( string requires ) ) ( string = ) ( number 2 ) ( call SW.getProperty ( call SW.singleton en.recipe ) ( string ! type ) ) ) )	overnight-recipes
which recipe is intended for the least number of meals	( call SW.listValue ( call SW.countSuperlative ( call SW.getProperty ( call SW.singleton en.recipe ) ( string ! type ) ) ( string min ) ( string meal ) ( call SW.getProperty ( call SW.singleton en.meal ) ( string ! type ) ) ) )	overnight-recipes
show me recipes that call for more than two ingredients	( call SW.listValue ( call SW.countComparative ( call SW.getProperty ( call SW.singleton en.recipe ) ( string ! type ) ) ( string requires ) ( string > ) ( number 2 ) ( call SW.getProperty ( call SW.singleton en.ingredient ) ( string ! type ) ) ) )	overnight-recipes
what is an ingredient found in fewer than two recipes	( call SW.listValue ( call SW.countComparative ( call SW.getProperty ( call SW.singleton en.ingredient ) ( string ! type ) ) ( call SW.reverse ( string requires ) ) ( string < ) ( number 2 ) ( call SW.getProperty ( call SW.singleton en.recipe ) ( string ! type ) ) ) )	overnight-recipes
what is a recipe from fewer than two cuisines	( call SW.listValue ( call SW.countComparative ( call SW.getProperty ( call SW.singleton en.recipe ) ( string ! type ) ) ( string cuisine ) ( string < ) ( number 2 ) ) )	overnight-recipes
what recipes posting date is in 2004 or 2010	( call SW.listValue ( call SW.filter ( call SW.getProperty ( call SW.singleton en.recipe ) ( string ! type ) ) ( string posting_date ) ( string = ) ( call SW.concat ( date 2004 -1 -1 ) ( date 2010 -1 -1 ) ) ) )	overnight-recipes
which ingredient is needed by many recipes	( call SW.listValue ( call SW.countSuperlative ( call SW.getProperty ( call SW.singleton en.ingredient ) ( string ! type ) ) ( string max ) ( call SW.reverse ( string requires ) ) ( call SW.getProperty ( call SW.singleton en.recipe ) ( string ! type ) ) ) )	overnight-recipes
what lunch recipe requires milk	( call SW.listValue ( call SW.filter ( call SW.filter ( call SW.getProperty ( call SW.singleton en.recipe ) ( string ! type ) ) ( string requires ) ( string = ) en.ingredient.milk ) ( string meal ) ( string = ) en.meal.lunch ) )	overnight-recipes
which recipes have at least 2 cuisines	( call SW.listValue ( call SW.countComparative ( call SW.getProperty ( call SW.singleton en.recipe ) ( string ! type ) ) ( string cuisine ) ( string >= ) ( number 2 ) ) )	overnight-recipes
what is a meal for which there are fewer than two recipes	( call SW.listValue ( call SW.countComparative ( call SW.getProperty ( call SW.singleton en.meal ) ( string ! type ) ) ( call SW.reverse ( string meal ) ) ( string < ) ( number 2 ) ( call SW.getProperty ( call SW.singleton en.recipe ) ( string ! type ) ) ) )	overnight-recipes
what recipes require the same time or than rice pudding	( call SW.listValue ( call SW.filter ( call SW.getProperty ( call SW.singleton en.recipe ) ( string ! type ) ) ( call SW.ensureNumericProperty ( string cooking_time ) ) ( string >= ) ( call SW.ensureNumericEntity ( call SW.getProperty en.recipe.rice_pudding ( string cooking_time ) ) ) ) )	overnight-recipes
what meal has two or fewer recipes designated for it	( call SW.listValue ( call SW.countComparative ( call SW.getProperty ( call SW.singleton en.meal ) ( string ! type ) ) ( call SW.reverse ( string meal ) ) ( string <= ) ( number 2 ) ( call SW.getProperty ( call SW.singleton en.recipe ) ( string ! type ) ) ) )	overnight-recipes
a recipe that posted after 2004 or 2010	( call SW.listValue ( call SW.filter ( call SW.getProperty ( call SW.singleton en.recipe ) ( string ! type ) ) ( call SW.ensureNumericProperty ( string posting_date ) ) ( string > ) ( call SW.ensureNumericEntity ( call SW.concat ( date 2004 -1 -1 ) ( date 2010 -1 -1 ) ) ) ) )	overnight-recipes
recipe prepared in more time than cooking time of rice pudding	( call SW.listValue ( call SW.filter ( call SW.getProperty ( call SW.singleton en.recipe ) ( string ! type ) ) ( call SW.ensureNumericProperty ( string preparation_time ) ) ( string > ) ( call SW.ensureNumericEntity ( call SW.getProperty en.recipe.rice_pudding ( string cooking_time ) ) ) ) )	overnight-recipes
which recipe can be prepared at the earliest	( call SW.listValue ( call SW.superlative ( call SW.getProperty ( call SW.singleton en.recipe ) ( string ! type ) ) ( string min ) ( call SW.ensureNumericProperty ( string preparation_time ) ) ) )	overnight-recipes
what recipe falls under two cuisines	( call SW.listValue ( call SW.countComparative ( call SW.getProperty ( call SW.singleton en.recipe ) ( string ! type ) ) ( string cuisine ) ( string = ) ( number 2 ) ) )	overnight-recipes
show me recipes that has milk as one of its ingredients	( call SW.listValue ( call SW.filter ( call SW.getProperty ( call SW.singleton en.recipe ) ( string ! type ) ) ( string requires ) ( string = ) en.ingredient.milk ) )	overnight-recipes
recipe cooked in less time than rice pudding preparation	( call SW.listValue ( call SW.filter ( call SW.getProperty ( call SW.singleton en.recipe ) ( string ! type ) ) ( call SW.ensureNumericProperty ( string cooking_time ) ) ( string < ) ( call SW.ensureNumericEntity ( call SW.getProperty en.recipe.rice_pudding ( string preparation_time ) ) ) ) )	overnight-recipes
what recipes require the same ingredients as rice pudding	( call SW.listValue ( call SW.filter ( call SW.getProperty ( call SW.singleton en.recipe ) ( string ! type ) ) ( string requires ) ( string = ) ( call SW.filter ( call SW.getProperty ( call SW.singleton en.ingredient ) ( string ! type ) ) ( call SW.reverse ( string requires ) ) ( string = ) en.recipe.rice_pudding ) ) )	overnight-recipes
what recipes share the cuisine of rice pudding	( call SW.listValue ( call SW.filter ( call SW.getProperty ( call SW.singleton en.recipe ) ( string ! type ) ) ( string cuisine ) ( string = ) ( call SW.getProperty en.recipe.rice_pudding ( string cuisine ) ) ) )	overnight-recipes
what is the meal that rice pudding goes with	( call SW.listValue ( call SW.filter ( call SW.filter ( call SW.getProperty ( call SW.singleton en.meal ) ( string ! type ) ) ( call SW.reverse ( string meal ) ) ( string = ) en.recipe.rice_pudding ) ( call SW.reverse ( string meal ) ) ( string = ) en.recipe.rice_pudding ) )	overnight-recipes
what recipe can you prep in the same or longer amount of time as rice pudding	( call SW.listValue ( call SW.filter ( call SW.getProperty ( call SW.singleton en.recipe ) ( string ! type ) ) ( call SW.ensureNumericProperty ( string preparation_time ) ) ( string >= ) ( call SW.ensureNumericEntity ( call SW.getProperty en.recipe.rice_pudding ( string preparation_time ) ) ) ) )	overnight-recipes
show me recipes posted after 2004 or after 2010	( call SW.listValue ( call SW.filter ( call SW.getProperty ( call SW.singleton en.recipe ) ( string ! type ) ) ( call SW.ensureNumericProperty ( string posting_date ) ) ( string > ) ( call SW.ensureNumericEntity ( call SW.concat ( date 2004 -1 -1 ) ( date 2010 -1 -1 ) ) ) ) )	overnight-recipes
what recipes dont call for milk	( call SW.listValue ( call SW.filter ( call SW.getProperty ( call SW.singleton en.recipe ) ( string ! type ) ) ( string requires ) ( string ! = ) en.ingredient.milk ) )	overnight-recipes
recipes that have cooking time less than cooking time of rice pudding	( call SW.listValue ( call SW.filter ( call SW.getProperty ( call SW.singleton en.recipe ) ( string ! type ) ) ( call SW.ensureNumericProperty ( string cooking_time ) ) ( string <= ) ( call SW.ensureNumericEntity ( call SW.getProperty en.recipe.rice_pudding ( string cooking_time ) ) ) ) )	overnight-recipes
recipe having more than two cuisine	( call SW.listValue ( call SW.countComparative ( call SW.getProperty ( call SW.singleton en.recipe ) ( string ! type ) ) ( string cuisine ) ( string > ) ( number 2 ) ) )	overnight-recipes
find the lunch recipes posted in 2004	( call SW.listValue ( call SW.filter ( call SW.filter ( call SW.getProperty ( call SW.singleton en.recipe ) ( string ! type ) ) ( string posting_date ) ( string = ) ( date 2004 -1 -1 ) ) ( string meal ) ( string = ) en.meal.lunch ) )	overnight-recipes
a recipe for rice pudding	( call SW.listValue ( call SW.getProperty en.recipe.rice_pudding ( string cuisine ) ) )	overnight-recipes
what recipe was posted the same day as rice pudding	( call SW.listValue ( call SW.filter ( call SW.getProperty ( call SW.singleton en.recipe ) ( string ! type ) ) ( string posting_date ) ( string = ) ( call SW.getProperty en.recipe.rice_pudding ( string posting_date ) ) ) )	overnight-recipes
which recipes were posted after 2004	( call SW.listValue ( call SW.filter ( call SW.getProperty ( call SW.singleton en.recipe ) ( string ! type ) ) ( call SW.ensureNumericProperty ( string posting_date ) ) ( string > ) ( call SW.ensureNumericEntity ( date 2004 -1 -1 ) ) ) )	overnight-recipes
what recipe takes same or less time to prepare rice pudding	( call SW.listValue ( call SW.filter ( call SW.getProperty ( call SW.singleton en.recipe ) ( string ! type ) ) ( call SW.ensureNumericProperty ( string preparation_time ) ) ( string <= ) ( call SW.ensureNumericEntity ( call SW.getProperty en.recipe.rice_pudding ( string preparation_time ) ) ) ) )	overnight-recipes
show me recipe that has at least have two cuisine	( call SW.listValue ( call SW.countComparative ( call SW.getProperty ( call SW.singleton en.recipe ) ( string ! type ) ) ( string cuisine ) ( string >= ) ( number 2 ) ) )	overnight-recipes
show me recipes that require milk	( call SW.listValue ( call SW.filter ( call SW.getProperty ( call SW.singleton en.recipe ) ( string ! type ) ) ( string requires ) ( string = ) en.ingredient.milk ) )	overnight-recipes
which recipe is prepared using the same amount of time as that of rice pudding	( call SW.listValue ( call SW.filter ( call SW.getProperty ( call SW.singleton en.recipe ) ( string ! type ) ) ( call SW.ensureNumericProperty ( string preparation_time ) ) ( string >= ) ( call SW.ensureNumericEntity ( call SW.getProperty en.recipe.rice_pudding ( string preparation_time ) ) ) ) )	overnight-recipes
is the recipe for lunch or dinner	( call SW.listValue ( call SW.concat en.meal.lunch en.meal.dinner ) )	overnight-recipes
show me recipes that involve two cuisines	( call SW.listValue ( call SW.countComparative ( call SW.getProperty ( call SW.singleton en.recipe ) ( string ! type ) ) ( string cuisine ) ( string = ) ( number 2 ) ) )	overnight-recipes
show recipes that has milk as its ingredient	( call SW.listValue ( call SW.filter ( call SW.filter ( call SW.getProperty ( call SW.singleton en.recipe ) ( string ! type ) ) ( string requires ) ( string = ) en.ingredient.milk ) ( string requires ) ( string = ) en.ingredient.milk ) )	overnight-recipes
which recipe belongs to the cuisine of rice pudding	( call SW.listValue ( call SW.filter ( call SW.getProperty ( call SW.singleton en.recipe ) ( string ! type ) ) ( string cuisine ) ( string = ) ( call SW.getProperty en.recipe.rice_pudding ( string cuisine ) ) ) )	overnight-recipes
show me recipes that need milk	( call SW.listValue ( call SW.filter ( call SW.filter ( call SW.getProperty ( call SW.singleton en.recipe ) ( string ! type ) ) ( string requires ) ( string = ) en.ingredient.milk ) ( string requires ) ( string = ) en.ingredient.milk ) )	overnight-recipes
find a recipe that was posted  by 2004	( call SW.listValue ( call SW.filter ( call SW.getProperty ( call SW.singleton en.recipe ) ( string ! type ) ) ( call SW.ensureNumericProperty ( string posting_date ) ) ( string >= ) ( call SW.ensureNumericEntity ( date 2004 -1 -1 ) ) ) )	overnight-recipes
what recipe does not need milk	( call SW.listValue ( call SW.filter ( call SW.getProperty ( call SW.singleton en.recipe ) ( string ! type ) ) ( string requires ) ( string ! = ) en.ingredient.milk ) )	overnight-recipes
which recipe uses milk as an ingredient	( call SW.listValue ( call SW.filter ( call SW.getProperty ( call SW.singleton en.recipe ) ( string ! type ) ) ( string requires ) ( string = ) en.ingredient.milk ) )	overnight-recipes
what meals are recipes for lunch for	( call SW.listValue ( call SW.filter ( call SW.getProperty ( call SW.singleton en.meal ) ( string ! type ) ) ( call SW.reverse ( string meal ) ) ( string = ) ( call SW.filter ( call SW.getProperty ( call SW.singleton en.recipe ) ( string ! type ) ) ( string meal ) ( string = ) en.meal.lunch ) ) )	overnight-recipes
either 2004 or 2010	( call SW.listValue ( call SW.concat ( date 2004 -1 -1 ) ( date 2010 -1 -1 ) ) )	overnight-recipes
which recipes take as long as prepare rice pudding	( call SW.listValue ( call SW.filter ( call SW.getProperty ( call SW.singleton en.recipe ) ( string ! type ) ) ( call SW.ensureNumericProperty ( string cooking_time ) ) ( string <= ) ( call SW.ensureNumericEntity ( call SW.getProperty en.recipe.rice_pudding ( string preparation_time ) ) ) ) )	overnight-recipes
what recipe requires the least ingredients	( call SW.listValue ( call SW.countSuperlative ( call SW.getProperty ( call SW.singleton en.ingredient ) ( string ! type ) ) ( string min ) ( call SW.reverse ( string requires ) ) ( call SW.getProperty ( call SW.singleton en.recipe ) ( string ! type ) ) ) )	overnight-recipes
what are the ingredients needed for recipes posted in 2004	( call SW.listValue ( call SW.filter ( call SW.getProperty ( call SW.singleton en.ingredient ) ( string ! type ) ) ( call SW.reverse ( string requires ) ) ( string = ) ( call SW.filter ( call SW.getProperty ( call SW.singleton en.recipe ) ( string ! type ) ) ( string posting_date ) ( string = ) ( date 2004 -1 -1 ) ) ) )	overnight-recipes
which recipes are intended for lunch or dinner	( call SW.listValue ( call SW.filter ( call SW.getProperty ( call SW.singleton en.recipe ) ( string ! type ) ) ( string meal ) ( string = ) ( call SW.concat en.meal.lunch en.meal.dinner ) ) )	overnight-recipes
what recipe needs milk and is for lunch	( call SW.listValue ( call SW.filter ( call SW.filter ( call SW.getProperty ( call SW.singleton en.recipe ) ( string ! type ) ) ( string requires ) ( string = ) en.ingredient.milk ) ( string meal ) ( string = ) en.meal.lunch ) )	overnight-recipes
to which cuisine does rice pudding belong	( call SW.listValue ( call SW.getProperty en.recipe.rice_pudding ( string cuisine ) ) )	overnight-recipes
show me recipes that use less than two ingredients	( call SW.listValue ( call SW.countComparative ( call SW.getProperty ( call SW.singleton en.recipe ) ( string ! type ) ) ( string requires ) ( string < ) ( number 2 ) ( call SW.getProperty ( call SW.singleton en.ingredient ) ( string ! type ) ) ) )	overnight-recipes
show me recipes with cooking time less than the preparation time for rice pudding	( call SW.listValue ( call SW.filter ( call SW.getProperty ( call SW.singleton en.recipe ) ( string ! type ) ) ( call SW.ensureNumericProperty ( string cooking_time ) ) ( string < ) ( call SW.ensureNumericEntity ( call SW.getProperty en.recipe.rice_pudding ( string preparation_time ) ) ) ) )	overnight-recipes
which recipe falls under the most kinds of cuisine	( call SW.listValue ( call SW.countSuperlative ( call SW.getProperty ( call SW.singleton en.recipe ) ( string ! type ) ) ( string max ) ( string cuisine ) ) )	overnight-recipes
what recipe can you prep in the same or more time as it takes to cook rice pudding	( call SW.listValue ( call SW.filter ( call SW.getProperty ( call SW.singleton en.recipe ) ( string ! type ) ) ( call SW.ensureNumericProperty ( string preparation_time ) ) ( string >= ) ( call SW.ensureNumericEntity ( call SW.getProperty en.recipe.rice_pudding ( string cooking_time ) ) ) ) )	overnight-recipes
show me lunch recipes that posted in 2004	( call SW.listValue ( call SW.filter ( call SW.filter ( call SW.getProperty ( call SW.singleton en.recipe ) ( string ! type ) ) ( string posting_date ) ( string = ) ( date 2004 -1 -1 ) ) ( string meal ) ( string = ) en.meal.lunch ) )	overnight-recipes
show me recipes with the longest cooking time	( call SW.listValue ( call SW.superlative ( call SW.getProperty ( call SW.singleton en.recipe ) ( string ! type ) ) ( string max ) ( call SW.ensureNumericProperty ( string cooking_time ) ) ) )	overnight-recipes
name ingredients used only in one or two recipes	( call SW.listValue ( call SW.countComparative ( call SW.getProperty ( call SW.singleton en.ingredient ) ( string ! type ) ) ( call SW.reverse ( string requires ) ) ( string <= ) ( number 2 ) ( call SW.getProperty ( call SW.singleton en.recipe ) ( string ! type ) ) ) )	overnight-recipes
show me milkfree recipes	( call SW.listValue ( call SW.filter ( call SW.getProperty ( call SW.singleton en.recipe ) ( string ! type ) ) ( string requires ) ( string ! = ) en.ingredient.milk ) )	overnight-recipes
what is a recipe from the fewest cuisines	( call SW.listValue ( call SW.countSuperlative ( call SW.getProperty ( call SW.singleton en.recipe ) ( string ! type ) ) ( string min ) ( string cuisine ) ) )	overnight-recipes
show me recipes requiring milk	( call SW.listValue ( call SW.filter ( call SW.filter ( call SW.getProperty ( call SW.singleton en.recipe ) ( string ! type ) ) ( string requires ) ( string = ) en.ingredient.milk ) ( string requires ) ( string = ) en.ingredient.milk ) )	overnight-recipes
show me recipes posted at the same date as rice pudding	( call SW.listValue ( call SW.filter ( call SW.getProperty ( call SW.singleton en.recipe ) ( string ! type ) ) ( call SW.ensureNumericProperty ( string posting_date ) ) ( string <= ) ( call SW.ensureNumericEntity ( call SW.getProperty en.recipe.rice_pudding ( string posting_date ) ) ) ) )	overnight-recipes
what are the ingredients of rice pudding or quiche	( call SW.listValue ( call SW.filter ( call SW.getProperty ( call SW.singleton en.ingredient ) ( string ! type ) ) ( call SW.reverse ( string requires ) ) ( string = ) ( call SW.concat en.recipe.rice_pudding en.recipe.quiche ) ) )	overnight-recipes
which recipe has the least preparation time	( call SW.listValue ( call SW.superlative ( call SW.getProperty ( call SW.singleton en.recipe ) ( string ! type ) ) ( string min ) ( call SW.ensureNumericProperty ( string preparation_time ) ) ) )	overnight-recipes
a recipe requiring fewer than two ingredients	( call SW.listValue ( call SW.countComparative ( call SW.getProperty ( call SW.singleton en.recipe ) ( string ! type ) ) ( string requires ) ( string < ) ( number 2 ) ( call SW.getProperty ( call SW.singleton en.ingredient ) ( string ! type ) ) ) )	overnight-recipes
which recipes were posted when rice pudding was posted	( call SW.listValue ( call SW.filter ( call SW.getProperty ( call SW.singleton en.recipe ) ( string ! type ) ) ( call SW.ensureNumericProperty ( string posting_date ) ) ( string >= ) ( call SW.ensureNumericEntity ( call SW.getProperty en.recipe.rice_pudding ( string posting_date ) ) ) ) )	overnight-recipes
what meal most recipes made for	( call SW.listValue ( call SW.countSuperlative ( call SW.getProperty ( call SW.singleton en.meal ) ( string ! type ) ) ( string max ) ( call SW.reverse ( string meal ) ) ( call SW.getProperty ( call SW.singleton en.recipe ) ( string ! type ) ) ) )	overnight-recipes
what recipe calls for either milk or spinach	( call SW.listValue ( call SW.filter ( call SW.getProperty ( call SW.singleton en.recipe ) ( string ! type ) ) ( string requires ) ( string = ) ( call SW.concat en.ingredient.milk en.ingredient.spinach ) ) )	overnight-recipes
which recipe has the cooking time of rice pudding	( call SW.listValue ( call SW.filter ( call SW.getProperty ( call SW.singleton en.recipe ) ( string ! type ) ) ( call SW.ensureNumericProperty ( string cooking_time ) ) ( string <= ) ( call SW.ensureNumericEntity ( call SW.getProperty en.recipe.rice_pudding ( string cooking_time ) ) ) ) )	overnight-recipes
show me recipes not posted in 2004	( call SW.listValue ( call SW.filter ( call SW.getProperty ( call SW.singleton en.recipe ) ( string ! type ) ) ( string posting_date ) ( string ! = ) ( date 2004 -1 -1 ) ) )	overnight-recipes
what recipe takes no longer to prepare than rice pudding	( call SW.listValue ( call SW.filter ( call SW.getProperty ( call SW.singleton en.recipe ) ( string ! type ) ) ( call SW.ensureNumericProperty ( string preparation_time ) ) ( string <= ) ( call SW.ensureNumericEntity ( call SW.getProperty en.recipe.rice_pudding ( string preparation_time ) ) ) ) )	overnight-recipes
what recipe cooks for less time than rice pudding takes to prep	( call SW.listValue ( call SW.filter ( call SW.getProperty ( call SW.singleton en.recipe ) ( string ! type ) ) ( call SW.ensureNumericProperty ( string cooking_time ) ) ( string < ) ( call SW.ensureNumericEntity ( call SW.getProperty en.recipe.rice_pudding ( string preparation_time ) ) ) ) )	overnight-recipes
what recipes have the most ingredients	( call SW.listValue ( call SW.countSuperlative ( call SW.getProperty ( call SW.singleton en.recipe ) ( string ! type ) ) ( string max ) ( string requires ) ( call SW.getProperty ( call SW.singleton en.ingredient ) ( string ! type ) ) ) )	overnight-recipes
what meal is a recipe that requires milk for	( call SW.listValue ( call SW.filter ( call SW.getProperty ( call SW.singleton en.meal ) ( string ! type ) ) ( call SW.reverse ( string meal ) ) ( string = ) ( call SW.filter ( call SW.getProperty ( call SW.singleton en.recipe ) ( string ! type ) ) ( string requires ) ( string = ) en.ingredient.milk ) ) )	overnight-recipes
what is the cuisine of rice pudding	( call SW.listValue ( call SW.getProperty en.recipe.rice_pudding ( string cuisine ) ) )	overnight-recipes
what is the most commonly used ingredient	( call SW.listValue ( call SW.countSuperlative ( call SW.getProperty ( call SW.singleton en.ingredient ) ( string ! type ) ) ( string max ) ( call SW.reverse ( string requires ) ) ( call SW.getProperty ( call SW.singleton en.recipe ) ( string ! type ) ) ) )	overnight-recipes
what recipe is for no more than two meals	( call SW.listValue ( call SW.countComparative ( call SW.getProperty ( call SW.singleton en.recipe ) ( string ! type ) ) ( string meal ) ( string <= ) ( number 2 ) ( call SW.getProperty ( call SW.singleton en.meal ) ( string ! type ) ) ) )	overnight-recipes
which  recipe takes as much time to prepare as rice pudding	( call SW.listValue ( call SW.filter ( call SW.getProperty ( call SW.singleton en.recipe ) ( string ! type ) ) ( string preparation_time ) ( string = ) ( call SW.getProperty en.recipe.rice_pudding ( string preparation_time ) ) ) )	overnight-recipes
show me recipes with a cooking time greater or equal to the preparation time for rice pudding	( call SW.listValue ( call SW.filter ( call SW.getProperty ( call SW.singleton en.recipe ) ( string ! type ) ) ( call SW.ensureNumericProperty ( string cooking_time ) ) ( string >= ) ( call SW.ensureNumericEntity ( call SW.getProperty en.recipe.rice_pudding ( string preparation_time ) ) ) ) )	overnight-recipes
what is the cooking time of rice pudding	( call SW.listValue ( call SW.getProperty en.recipe.rice_pudding ( string cooking_time ) ) )	overnight-recipes
which recipe needs more than two ingredients	( call SW.listValue ( call SW.countComparative ( call SW.getProperty ( call SW.singleton en.recipe ) ( string ! type ) ) ( string requires ) ( string > ) ( number 2 ) ( call SW.getProperty ( call SW.singleton en.ingredient ) ( string ! type ) ) ) )	overnight-recipes
ingredient of two recipes	( call SW.listValue ( call SW.countComparative ( call SW.getProperty ( call SW.singleton en.ingredient ) ( string ! type ) ) ( call SW.reverse ( string requires ) ) ( string = ) ( number 2 ) ( call SW.getProperty ( call SW.singleton en.recipe ) ( string ! type ) ) ) )	overnight-recipes
show me the average cooking time for all recipes	( call SW.listValue ( call SW.aggregate ( string avg ) ( call SW.getProperty ( call SW.getProperty ( call SW.singleton en.recipe ) ( string ! type ) ) ( string cooking_time ) ) ) )	overnight-recipes
show me recipes posted on the same day as rice pudding	( call SW.listValue ( call SW.filter ( call SW.getProperty ( call SW.singleton en.recipe ) ( string ! type ) ) ( string posting_date ) ( string = ) ( call SW.getProperty en.recipe.rice_pudding ( string posting_date ) ) ) )	overnight-recipes
show me recipes for the most cuisines	( call SW.listValue ( call SW.countSuperlative ( call SW.getProperty ( call SW.singleton en.recipe ) ( string ! type ) ) ( string max ) ( string cuisine ) ) )	overnight-recipes
name lunch recipes	( call SW.listValue ( call SW.filter ( call SW.filter ( call SW.getProperty ( call SW.singleton en.recipe ) ( string ! type ) ) ( string meal ) ( string = ) en.meal.lunch ) ( string meal ) ( string = ) en.meal.lunch ) )	overnight-recipes
what is the average prep time for the recipe	( call SW.listValue ( call SW.aggregate ( string avg ) ( call SW.getProperty ( call SW.getProperty ( call SW.singleton en.recipe ) ( string ! type ) ) ( string preparation_time ) ) ) )	overnight-recipes
how many ingredients does that require	( call SW.listValue ( call .size ( call SW.getProperty ( call SW.singleton en.ingredient ) ( string ! type ) ) ) )	overnight-recipes
what recipe requires less prep time than rice pudding	( call SW.listValue ( call SW.filter ( call SW.getProperty ( call SW.singleton en.recipe ) ( string ! type ) ) ( call SW.ensureNumericProperty ( string preparation_time ) ) ( string < ) ( call SW.ensureNumericEntity ( call SW.getProperty en.recipe.rice_pudding ( string preparation_time ) ) ) ) )	overnight-recipes
what is the recipe that needs the minimum number of ingredients	( call SW.listValue ( call SW.countSuperlative ( call SW.getProperty ( call SW.singleton en.recipe ) ( string ! type ) ) ( string min ) ( string requires ) ( call SW.getProperty ( call SW.singleton en.ingredient ) ( string ! type ) ) ) )	overnight-recipes
what is the number of ingredients for that recipe	( call SW.listValue ( call .size ( call SW.getProperty ( call SW.singleton en.ingredient ) ( string ! type ) ) ) )	overnight-recipes
what meal has two or more recipes	( call SW.listValue ( call SW.countComparative ( call SW.getProperty ( call SW.singleton en.meal ) ( string ! type ) ) ( call SW.reverse ( string meal ) ) ( string >= ) ( number 2 ) ( call SW.getProperty ( call SW.singleton en.recipe ) ( string ! type ) ) ) )	overnight-recipes
name ingredients used in more than one recipe	( call SW.listValue ( call SW.countComparative ( call SW.getProperty ( call SW.singleton en.ingredient ) ( string ! type ) ) ( call SW.reverse ( string requires ) ) ( string = ) ( number 2 ) ( call SW.getProperty ( call SW.singleton en.recipe ) ( string ! type ) ) ) )	overnight-recipes
what recipes posting date is at most 2004 or 2010	( call SW.listValue ( call SW.filter ( call SW.getProperty ( call SW.singleton en.recipe ) ( string ! type ) ) ( call SW.ensureNumericProperty ( string posting_date ) ) ( string <= ) ( call SW.ensureNumericEntity ( call SW.concat ( date 2004 -1 -1 ) ( date 2010 -1 -1 ) ) ) ) )	overnight-recipes
recipe for only one meal	( call SW.listValue ( call SW.countComparative ( call SW.getProperty ( call SW.singleton en.recipe ) ( string ! type ) ) ( string meal ) ( string < ) ( number 2 ) ( call SW.getProperty ( call SW.singleton en.meal ) ( string ! type ) ) ) )	overnight-recipes
show recipes that take at least the preparation time of rice pudding to be done	( call SW.listValue ( call SW.filter ( call SW.getProperty ( call SW.singleton en.recipe ) ( string ! type ) ) ( call SW.ensureNumericProperty ( string preparation_time ) ) ( string >= ) ( call SW.ensureNumericEntity ( call SW.getProperty en.recipe.rice_pudding ( string preparation_time ) ) ) ) )	overnight-recipes
what recipe is found in two different meals	( call SW.listValue ( call SW.countComparative ( call SW.getProperty ( call SW.singleton en.recipe ) ( string ! type ) ) ( string meal ) ( string = ) ( number 2 ) ( call SW.getProperty ( call SW.singleton en.meal ) ( string ! type ) ) ) )	overnight-recipes
show me recipes that were posted later than 2004	( call SW.listValue ( call SW.filter ( call SW.getProperty ( call SW.singleton en.meal ) ( string ! type ) ) ( call SW.reverse ( string meal ) ) ( string = ) ( call SW.filter ( call SW.getProperty ( call SW.singleton en.recipe ) ( string ! type ) ) ( string posting_date ) ( string = ) ( date 2004 -1 -1 ) ) ) )	overnight-recipes
which recipes were posted at the same time as rice pudding	( call SW.listValue ( call SW.filter ( call SW.getProperty ( call SW.singleton en.recipe ) ( string ! type ) ) ( string posting_date ) ( string = ) ( call SW.getProperty en.recipe.rice_pudding ( string posting_date ) ) ) )	overnight-recipes
recipe of less than two meal	( call SW.listValue ( call SW.countComparative ( call SW.getProperty ( call SW.singleton en.recipe ) ( string ! type ) ) ( string meal ) ( string < ) ( number 2 ) ( call SW.getProperty ( call SW.singleton en.meal ) ( string ! type ) ) ) )	overnight-recipes
what recipes cooking time is the preparation time of rice pudding	( call SW.listValue ( call SW.filter ( call SW.getProperty ( call SW.singleton en.recipe ) ( string ! type ) ) ( string cooking_time ) ( string = ) ( call SW.getProperty en.recipe.rice_pudding ( string preparation_time ) ) ) )	overnight-recipes
what is the cooking time of recipe	( call SW.listValue ( call SW.aggregate ( string sum ) ( call SW.getProperty ( call SW.getProperty ( call SW.singleton en.recipe ) ( string ! type ) ) ( string cooking_time ) ) ) )	overnight-recipes
a recipe for a meal other than lunch	( call SW.listValue ( call SW.filter ( call SW.getProperty ( call SW.singleton en.recipe ) ( string ! type ) ) ( string meal ) ( string ! = ) en.meal.lunch ) )	overnight-recipes
what is the cooking time of rice pudding	( call SW.listValue ( call SW.getProperty en.recipe.rice_pudding ( string cooking_time ) ) )	overnight-recipes
which is the food item that is needed in two recipes	( call SW.listValue ( call SW.countComparative ( call SW.getProperty ( call SW.singleton en.ingredient ) ( string ! type ) ) ( call SW.reverse ( string requires ) ) ( string = ) ( number 2 ) ( call SW.getProperty ( call SW.singleton en.recipe ) ( string ! type ) ) ) )	overnight-recipes
show me ingredients required by recipes that require milk	( call SW.listValue ( call SW.filter ( call SW.getProperty ( call SW.singleton en.ingredient ) ( string ! type ) ) ( call SW.reverse ( string requires ) ) ( string = ) ( call SW.filter ( call SW.getProperty ( call SW.singleton en.recipe ) ( string ! type ) ) ( string requires ) ( string = ) en.ingredient.milk ) ) )	overnight-recipes
what is an ingredient found in no more than two recipes	( call SW.listValue ( call SW.countComparative ( call SW.getProperty ( call SW.singleton en.ingredient ) ( string ! type ) ) ( call SW.reverse ( string requires ) ) ( string <= ) ( number 2 ) ( call SW.getProperty ( call SW.singleton en.recipe ) ( string ! type ) ) ) )	overnight-recipes
find recipe for two meals	( call SW.listValue ( call SW.countComparative ( call SW.getProperty ( call SW.singleton en.recipe ) ( string ! type ) ) ( string meal ) ( string <= ) ( number 2 ) ( call SW.getProperty ( call SW.singleton en.meal ) ( string ! type ) ) ) )	overnight-recipes
what meal has maximum recipes	( call SW.listValue ( call SW.countComparative ( call SW.getProperty ( call SW.singleton en.meal ) ( string ! type ) ) ( call SW.reverse ( string meal ) ) ( string <= ) ( number 2 ) ( call SW.getProperty ( call SW.singleton en.recipe ) ( string ! type ) ) ) )	overnight-recipes
show me the recipe that has the shortest cooking time	( call SW.listValue ( call SW.superlative ( call SW.getProperty ( call SW.singleton en.recipe ) ( string ! type ) ) ( string min ) ( call SW.ensureNumericProperty ( string cooking_time ) ) ) )	overnight-recipes
show me recipes posted during 2004 and 2010	( call SW.listValue ( call SW.filter ( call SW.getProperty ( call SW.singleton en.recipe ) ( string ! type ) ) ( string posting_date ) ( string = ) ( call SW.concat ( date 2004 -1 -1 ) ( date 2010 -1 -1 ) ) ) )	overnight-recipes
what is an ingredient used in more than two recipes	( call SW.listValue ( call SW.countComparative ( call SW.getProperty ( call SW.singleton en.ingredient ) ( string ! type ) ) ( call SW.reverse ( string requires ) ) ( string > ) ( number 2 ) ( call SW.getProperty ( call SW.singleton en.recipe ) ( string ! type ) ) ) )	overnight-recipes
what is a recipe from the same cuisine as rice pudding	( call SW.listValue ( call SW.filter ( call SW.getProperty ( call SW.singleton en.recipe ) ( string ! type ) ) ( string cuisine ) ( string = ) ( call SW.getProperty en.recipe.rice_pudding ( string cuisine ) ) ) )	overnight-recipes
what recipes need milk or spinach	( call SW.listValue ( call SW.concat en.ingredient.milk en.ingredient.spinach ) )	overnight-recipes
what is the average cooking time of recipe	( call SW.listValue ( call SW.aggregate ( string avg ) ( call SW.getProperty ( call SW.getProperty ( call SW.singleton en.recipe ) ( string ! type ) ) ( string cooking_time ) ) ) )	overnight-recipes
what ingredient is used only in a single recipe	( call SW.listValue ( call SW.countComparative ( call SW.getProperty ( call SW.singleton en.ingredient ) ( string ! type ) ) ( call SW.reverse ( string requires ) ) ( string < ) ( number 2 ) ( call SW.getProperty ( call SW.singleton en.recipe ) ( string ! type ) ) ) )	overnight-recipes
what recipe was posted during 2004	( call SW.listValue ( call SW.filter ( call SW.getProperty ( call SW.singleton en.recipe ) ( string ! type ) ) ( string posting_date ) ( string = ) ( date 2004 -1 -1 ) ) )	overnight-recipes
what recipe requires three or more ingredients	( call SW.listValue ( call SW.countComparative ( call SW.getProperty ( call SW.singleton en.recipe ) ( string ! type ) ) ( string requires ) ( string > ) ( number 2 ) ( call SW.getProperty ( call SW.singleton en.ingredient ) ( string ! type ) ) ) )	overnight-recipes
find a recipe for lunch	( call SW.listValue ( call SW.filter ( call SW.filter ( call SW.getProperty ( call SW.singleton en.recipe ) ( string ! type ) ) ( string meal ) ( string = ) en.meal.lunch ) ( string meal ) ( string = ) en.meal.lunch ) )	overnight-recipes
which recipe was posted on the same date as that of rice pudding	( call SW.listValue ( call SW.filter ( call SW.getProperty ( call SW.singleton en.recipe ) ( string ! type ) ) ( string posting_date ) ( string = ) ( call SW.getProperty en.recipe.rice_pudding ( string posting_date ) ) ) )	overnight-recipes
what recipe takes less time to cook than rice pudding does to prepare	( call SW.listValue ( call SW.filter ( call SW.getProperty ( call SW.singleton en.recipe ) ( string ! type ) ) ( call SW.ensureNumericProperty ( string cooking_time ) ) ( string < ) ( call SW.ensureNumericEntity ( call SW.getProperty en.recipe.rice_pudding ( string preparation_time ) ) ) ) )	overnight-recipes
show me recipes that take less time to cook than it takes to prepare rice pudding	( call SW.listValue ( call SW.filter ( call SW.getProperty ( call SW.singleton en.recipe ) ( string ! type ) ) ( call SW.ensureNumericProperty ( string cooking_time ) ) ( string < ) ( call SW.ensureNumericEntity ( call SW.getProperty en.recipe.rice_pudding ( string preparation_time ) ) ) ) )	overnight-recipes
which recipe has the least amount of prep time	( call SW.listValue ( call SW.superlative ( call SW.getProperty ( call SW.singleton en.recipe ) ( string ! type ) ) ( string min ) ( call SW.ensureNumericProperty ( string preparation_time ) ) ) )	overnight-recipes
which recipe  s cooking time is equal to that of rice pudding	( call SW.listValue ( call SW.filter ( call SW.getProperty ( call SW.singleton en.recipe ) ( string ! type ) ) ( call SW.ensureNumericProperty ( string preparation_time ) ) ( string <= ) ( call SW.ensureNumericEntity ( call SW.getProperty en.recipe.rice_pudding ( string cooking_time ) ) ) ) )	overnight-recipes
which recipes have three or more cuisine	( call SW.listValue ( call SW.countComparative ( call SW.getProperty ( call SW.singleton en.recipe ) ( string ! type ) ) ( string cuisine ) ( string > ) ( number 2 ) ) )	overnight-recipes
which recipe was posted in 2004 or 2010	( call SW.listValue ( call SW.filter ( call SW.getProperty ( call SW.singleton en.recipe ) ( string ! type ) ) ( call SW.ensureNumericProperty ( string posting_date ) ) ( string <= ) ( call SW.ensureNumericEntity ( call SW.concat ( date 2004 -1 -1 ) ( date 2010 -1 -1 ) ) ) ) )	overnight-recipes
how long does it take to  make rice pudding	( call SW.listValue ( call SW.getProperty en.recipe.rice_pudding ( string cooking_time ) ) )	overnight-recipes
recipe cooked in preparation time of rice pudding or more	( call SW.listValue ( call SW.filter ( call SW.getProperty ( call SW.singleton en.recipe ) ( string ! type ) ) ( call SW.ensureNumericProperty ( string cooking_time ) ) ( string >= ) ( call SW.ensureNumericEntity ( call SW.getProperty en.recipe.rice_pudding ( string preparation_time ) ) ) ) )	overnight-recipes
a recipe which takes longer to cook than the preparation time for rice pudding	( call SW.listValue ( call SW.filter ( call SW.getProperty ( call SW.singleton en.recipe ) ( string ! type ) ) ( call SW.ensureNumericProperty ( string cooking_time ) ) ( string > ) ( call SW.ensureNumericEntity ( call SW.getProperty en.recipe.rice_pudding ( string preparation_time ) ) ) ) )	overnight-recipes
how long does the recipe take to prep	( call SW.listValue ( call SW.aggregate ( string sum ) ( call SW.getProperty ( call SW.getProperty ( call SW.singleton en.recipe ) ( string ! type ) ) ( string preparation_time ) ) ) )	overnight-recipes
what recipes posting date is greater than 2004 or 2010	( call SW.listValue ( call SW.filter ( call SW.getProperty ( call SW.singleton en.recipe ) ( string ! type ) ) ( call SW.ensureNumericProperty ( string posting_date ) ) ( string > ) ( call SW.ensureNumericEntity ( call SW.concat ( date 2004 -1 -1 ) ( date 2010 -1 -1 ) ) ) ) )	overnight-recipes
show me recipes posted before 2004 or before 2010	( call SW.listValue ( call SW.filter ( call SW.getProperty ( call SW.singleton en.recipe ) ( string ! type ) ) ( call SW.ensureNumericProperty ( string posting_date ) ) ( string < ) ( call SW.ensureNumericEntity ( call SW.concat ( date 2004 -1 -1 ) ( date 2010 -1 -1 ) ) ) ) )	overnight-recipes
show me meals with at least two recipes	( call SW.listValue ( call SW.countComparative ( call SW.getProperty ( call SW.singleton en.meal ) ( string ! type ) ) ( call SW.reverse ( string meal ) ) ( string >= ) ( number 2 ) ( call SW.getProperty ( call SW.singleton en.recipe ) ( string ! type ) ) ) )	overnight-recipes
what meal can be made by the recipe posted in 2004	( call SW.listValue ( call SW.filter ( call SW.getProperty ( call SW.singleton en.meal ) ( string ! type ) ) ( call SW.reverse ( string meal ) ) ( string = ) ( call SW.filter ( call SW.getProperty ( call SW.singleton en.recipe ) ( string ! type ) ) ( string posting_date ) ( string = ) ( date 2004 -1 -1 ) ) ) )	overnight-recipes
show me meals with the most recipes	( call SW.listValue ( call SW.countSuperlative ( call SW.getProperty ( call SW.singleton en.meal ) ( string ! type ) ) ( string max ) ( call SW.reverse ( string meal ) ) ( call SW.getProperty ( call SW.singleton en.recipe ) ( string ! type ) ) ) )	overnight-recipes
what ingredient is in over two recipes	( call SW.listValue ( call SW.countComparative ( call SW.getProperty ( call SW.singleton en.ingredient ) ( string ! type ) ) ( call SW.reverse ( string requires ) ) ( string > ) ( number 2 ) ( call SW.getProperty ( call SW.singleton en.recipe ) ( string ! type ) ) ) )	overnight-recipes
name the ingredient required by at least two recipes	( call SW.listValue ( call SW.countComparative ( call SW.getProperty ( call SW.singleton en.ingredient ) ( string ! type ) ) ( call SW.reverse ( string requires ) ) ( string >= ) ( number 2 ) ( call SW.getProperty ( call SW.singleton en.recipe ) ( string ! type ) ) ) )	overnight-recipes
show recipes that could be used in any meal	( call SW.listValue ( call SW.countComparative ( call SW.getProperty ( call SW.singleton en.recipe ) ( string ! type ) ) ( string meal ) ( string > ) ( number 2 ) ( call SW.getProperty ( call SW.singleton en.meal ) ( string ! type ) ) ) )	overnight-recipes
which recipes were posted before rice pudding	( call SW.listValue ( call SW.filter ( call SW.getProperty ( call SW.singleton en.recipe ) ( string ! type ) ) ( call SW.ensureNumericProperty ( string posting_date ) ) ( string < ) ( call SW.ensureNumericEntity ( call SW.getProperty en.recipe.rice_pudding ( string posting_date ) ) ) ) )	overnight-recipes
find recipes posted later than 2004 or 2010	( call SW.listValue ( call SW.filter ( call SW.getProperty ( call SW.singleton en.recipe ) ( string ! type ) ) ( call SW.ensureNumericProperty ( string posting_date ) ) ( string > ) ( call SW.ensureNumericEntity ( call SW.concat ( date 2004 -1 -1 ) ( date 2010 -1 -1 ) ) ) ) )	overnight-recipes
show me the ingredients for rice pudding	( call SW.listValue ( call SW.filter ( call SW.getProperty ( call SW.singleton en.ingredient ) ( string ! type ) ) ( call SW.reverse ( string requires ) ) ( string = ) en.recipe.rice_pudding ) )	overnight-recipes
which recipe has a posting date smaller than 2004 or 2010	( call SW.listValue ( call SW.filter ( call SW.getProperty ( call SW.singleton en.recipe ) ( string ! type ) ) ( call SW.ensureNumericProperty ( string posting_date ) ) ( string < ) ( call SW.ensureNumericEntity ( call SW.concat ( date 2004 -1 -1 ) ( date 2010 -1 -1 ) ) ) ) )	overnight-recipes
what lunch recipes posting date is 2004	( call SW.listValue ( call SW.filter ( call SW.filter ( call SW.getProperty ( call SW.singleton en.recipe ) ( string ! type ) ) ( string meal ) ( string = ) en.meal.lunch ) ( string posting_date ) ( string = ) ( date 2004 -1 -1 ) ) )	overnight-recipes
recipe in least cuisines	( call SW.listValue ( call SW.countSuperlative ( call SW.getProperty ( call SW.singleton en.recipe ) ( string ! type ) ) ( string min ) ( string cuisine ) ) )	overnight-recipes
an ingredient required by at least two recipes	( call SW.listValue ( call SW.countComparative ( call SW.getProperty ( call SW.singleton en.ingredient ) ( string ! type ) ) ( call SW.reverse ( string requires ) ) ( string >= ) ( number 2 ) ( call SW.getProperty ( call SW.singleton en.recipe ) ( string ! type ) ) ) )	overnight-recipes
how long does rice pudding take to cook	( call SW.listValue ( call SW.getProperty en.recipe.rice_pudding ( string cooking_time ) ) )	overnight-recipes
what ingredient is required in either rice pudding or quiche	( call SW.listValue ( call SW.filter ( call SW.getProperty ( call SW.singleton en.ingredient ) ( string ! type ) ) ( call SW.reverse ( string requires ) ) ( string = ) ( call SW.concat en.recipe.rice_pudding en.recipe.quiche ) ) )	overnight-recipes
what is the average cooking time for that dish	( call SW.listValue ( call SW.aggregate ( string avg ) ( call SW.getProperty ( call SW.getProperty ( call SW.singleton en.recipe ) ( string ! type ) ) ( string cooking_time ) ) ) )	overnight-recipes
what recipes need milk and is posted in 2004	( call SW.listValue ( call SW.filter ( call SW.filter ( call SW.getProperty ( call SW.singleton en.recipe ) ( string ! type ) ) ( string requires ) ( string = ) en.ingredient.milk ) ( string posting_date ) ( string = ) ( date 2004 -1 -1 ) ) )	overnight-recipes
what ingredients does quiche or rice pudding require	( call SW.listValue ( call SW.filter ( call SW.getProperty ( call SW.singleton en.ingredient ) ( string ! type ) ) ( call SW.reverse ( string requires ) ) ( string = ) ( call SW.concat en.recipe.rice_pudding en.recipe.quiche ) ) )	overnight-recipes
what ingredients do lunch recipes need	( call SW.listValue ( call SW.filter ( call SW.getProperty ( call SW.singleton en.ingredient ) ( string ! type ) ) ( call SW.reverse ( string requires ) ) ( string = ) ( call SW.filter ( call SW.getProperty ( call SW.singleton en.recipe ) ( string ! type ) ) ( string meal ) ( string = ) en.meal.lunch ) ) )	overnight-recipes
what recipes  are prepared in less time tan rice pudding	( call SW.listValue ( call SW.filter ( call SW.getProperty ( call SW.singleton en.recipe ) ( string ! type ) ) ( call SW.ensureNumericProperty ( string preparation_time ) ) ( string < ) ( call SW.ensureNumericEntity ( call SW.getProperty en.recipe.rice_pudding ( string preparation_time ) ) ) ) )	overnight-recipes
what is the mean cooking time for the recipe	( call SW.listValue ( call SW.aggregate ( string avg ) ( call SW.getProperty ( call SW.getProperty ( call SW.singleton en.recipe ) ( string ! type ) ) ( string cooking_time ) ) ) )	overnight-recipes
show me recipes for rice pudding meals	( call SW.listValue ( call SW.filter ( call SW.getProperty ( call SW.singleton en.recipe ) ( string ! type ) ) ( string meal ) ( string = ) ( call SW.filter ( call SW.getProperty ( call SW.singleton en.meal ) ( string ! type ) ) ( call SW.reverse ( string meal ) ) ( string = ) en.recipe.rice_pudding ) ) )	overnight-recipes
what recipe was posted before 2004	( call SW.listValue ( call SW.filter ( call SW.getProperty ( call SW.singleton en.recipe ) ( string ! type ) ) ( call SW.ensureNumericProperty ( string posting_date ) ) ( string < ) ( call SW.ensureNumericEntity ( date 2004 -1 -1 ) ) ) )	overnight-recipes
what recipe takes the longest time to prep	( call SW.listValue ( call SW.superlative ( call SW.getProperty ( call SW.singleton en.recipe ) ( string ! type ) ) ( string max ) ( call SW.ensureNumericProperty ( string preparation_time ) ) ) )	overnight-recipes
what recipes were posted before 2004	( call SW.listValue ( call SW.filter ( call SW.getProperty ( call SW.singleton en.recipe ) ( string ! type ) ) ( call SW.ensureNumericProperty ( string posting_date ) ) ( string < ) ( call SW.ensureNumericEntity ( date 2004 -1 -1 ) ) ) )	overnight-recipes
what recipe has no fewer than two cuisines	( call SW.listValue ( call SW.countComparative ( call SW.getProperty ( call SW.singleton en.recipe ) ( string ! type ) ) ( string cuisine ) ( string >= ) ( number 2 ) ) )	overnight-recipes
what recipe is for less than two people	( call SW.listValue ( call SW.countComparative ( call SW.getProperty ( call SW.singleton en.recipe ) ( string ! type ) ) ( string meal ) ( string < ) ( number 2 ) ( call SW.getProperty ( call SW.singleton en.meal ) ( string ! type ) ) ) )	overnight-recipes
which recipes take less time to prepare than to cook rice pudding	( call SW.listValue ( call SW.filter ( call SW.getProperty ( call SW.singleton en.recipe ) ( string ! type ) ) ( call SW.ensureNumericProperty ( string preparation_time ) ) ( string < ) ( call SW.ensureNumericEntity ( call SW.getProperty en.recipe.rice_pudding ( string cooking_time ) ) ) ) )	overnight-recipes
show me meals including rice pudding	( call SW.listValue ( call SW.filter ( call SW.getProperty ( call SW.singleton en.meal ) ( string ! type ) ) ( call SW.reverse ( string meal ) ) ( string = ) en.recipe.rice_pudding ) )	overnight-recipes
what recipes cooking time is greater than that of rice pudding	( call SW.listValue ( call SW.filter ( call SW.getProperty ( call SW.singleton en.recipe ) ( string ! type ) ) ( call SW.ensureNumericProperty ( string cooking_time ) ) ( string > ) ( call SW.ensureNumericEntity ( call SW.getProperty en.recipe.rice_pudding ( string cooking_time ) ) ) ) )	overnight-recipes
which recipes have a preparation time as long as the cooking time of rice pudding	( call SW.listValue ( call SW.filter ( call SW.getProperty ( call SW.singleton en.recipe ) ( string ! type ) ) ( string preparation_time ) ( string = ) ( call SW.getProperty en.recipe.rice_pudding ( string cooking_time ) ) ) )	overnight-recipes
recipes posted with or after posting rice pudding	( call SW.listValue ( call SW.filter ( call SW.getProperty ( call SW.singleton en.recipe ) ( string ! type ) ) ( call SW.ensureNumericProperty ( string posting_date ) ) ( string >= ) ( call SW.ensureNumericEntity ( call SW.getProperty en.recipe.rice_pudding ( string posting_date ) ) ) ) )	overnight-recipes
which recipe is posted after the posting date of rice pudding	( call SW.listValue ( call SW.filter ( call SW.getProperty ( call SW.singleton en.recipe ) ( string ! type ) ) ( call SW.ensureNumericProperty ( string posting_date ) ) ( string > ) ( call SW.ensureNumericEntity ( call SW.getProperty en.recipe.rice_pudding ( string posting_date ) ) ) ) )	overnight-recipes
show me lunch recipes that need milk	( call SW.listValue ( call SW.filter ( call SW.filter ( call SW.getProperty ( call SW.singleton en.recipe ) ( string ! type ) ) ( string requires ) ( string = ) en.ingredient.milk ) ( string meal ) ( string = ) en.meal.lunch ) )	overnight-recipes
show me lunch recipes that require milk	( call SW.listValue ( call SW.filter ( call SW.filter ( call SW.getProperty ( call SW.singleton en.recipe ) ( string ! type ) ) ( string meal ) ( string = ) en.meal.lunch ) ( string requires ) ( string = ) en.ingredient.milk ) )	overnight-recipes
which ingredient is needed by rice pudding or quiche	( call SW.listValue ( call SW.filter ( call SW.getProperty ( call SW.singleton en.ingredient ) ( string ! type ) ) ( call SW.reverse ( string requires ) ) ( string = ) ( call SW.concat en.recipe.rice_pudding en.recipe.quiche ) ) )	overnight-recipes
which recipe needs the longest preparation tome	( call SW.listValue ( call SW.superlative ( call SW.getProperty ( call SW.singleton en.recipe ) ( string ! type ) ) ( string max ) ( call SW.ensureNumericProperty ( string preparation_time ) ) ) )	overnight-recipes
are there any recipes which were posted twice in 2004	( call SW.listValue ( call SW.filter ( call SW.filter ( call SW.getProperty ( call SW.singleton en.recipe ) ( string ! type ) ) ( string posting_date ) ( string = ) ( date 2004 -1 -1 ) ) ( string posting_date ) ( string = ) ( date 2004 -1 -1 ) ) )	overnight-recipes
for which meal is that recipe that has milk as one of its ingredients	( call SW.listValue ( call SW.filter ( call SW.getProperty ( call SW.singleton en.meal ) ( string ! type ) ) ( call SW.reverse ( string meal ) ) ( string = ) ( call SW.filter ( call SW.getProperty ( call SW.singleton en.recipe ) ( string ! type ) ) ( string requires ) ( string = ) en.ingredient.milk ) ) )	overnight-recipes
recipe for three or more meals	( call SW.listValue ( call SW.countComparative ( call SW.getProperty ( call SW.singleton en.recipe ) ( string ! type ) ) ( string meal ) ( string >= ) ( number 2 ) ( call SW.getProperty ( call SW.singleton en.meal ) ( string ! type ) ) ) )	overnight-recipes
show me recipes with preparation time equal to or longer than rice pudding	( call SW.listValue ( call SW.filter ( call SW.getProperty ( call SW.singleton en.recipe ) ( string ! type ) ) ( call SW.ensureNumericProperty ( string preparation_time ) ) ( string >= ) ( call SW.ensureNumericEntity ( call SW.getProperty en.recipe.rice_pudding ( string cooking_time ) ) ) ) )	overnight-recipes
which recipes require the same ingredients as rice pudding	( call SW.listValue ( call SW.filter ( call SW.getProperty ( call SW.singleton en.recipe ) ( string ! type ) ) ( string requires ) ( string = ) ( call SW.filter ( call SW.getProperty ( call SW.singleton en.ingredient ) ( string ! type ) ) ( call SW.reverse ( string requires ) ) ( string = ) en.recipe.rice_pudding ) ) )	overnight-recipes
show me recipes requiring milk or spinach	( call SW.listValue ( call SW.filter ( call SW.getProperty ( call SW.singleton en.recipe ) ( string ! type ) ) ( string requires ) ( string = ) ( call SW.concat en.ingredient.milk en.ingredient.spinach ) ) )	overnight-recipes
what recipe requires at the least two ingredients	( call SW.listValue ( call SW.countComparative ( call SW.getProperty ( call SW.singleton en.recipe ) ( string ! type ) ) ( string requires ) ( string >= ) ( number 2 ) ( call SW.getProperty ( call SW.singleton en.ingredient ) ( string ! type ) ) ) )	overnight-recipes
what recipes posting date is greater than that of rice pudding	( call SW.listValue ( call SW.filter ( call SW.getProperty ( call SW.singleton en.recipe ) ( string ! type ) ) ( call SW.ensureNumericProperty ( string posting_date ) ) ( string > ) ( call SW.ensureNumericEntity ( call SW.getProperty en.recipe.rice_pudding ( string posting_date ) ) ) ) )	overnight-recipes
a recipe with milk as an ingredient	( call SW.listValue ( call SW.filter ( call SW.getProperty ( call SW.singleton en.ingredient ) ( string ! type ) ) ( call SW.reverse ( string requires ) ) ( string = ) ( call SW.filter ( call SW.getProperty ( call SW.singleton en.recipe ) ( string ! type ) ) ( string requires ) ( string = ) en.ingredient.milk ) ) )	overnight-recipes
what recipes cooking time is longer than that of rice pudding	( call SW.listValue ( call SW.filter ( call SW.getProperty ( call SW.singleton en.recipe ) ( string ! type ) ) ( call SW.ensureNumericProperty ( string cooking_time ) ) ( string > ) ( call SW.ensureNumericEntity ( call SW.getProperty en.recipe.rice_pudding ( string preparation_time ) ) ) ) )	overnight-recipes
whats the average preparation time of a recipe	( call SW.listValue ( call SW.aggregate ( string avg ) ( call SW.getProperty ( call SW.getProperty ( call SW.singleton en.recipe ) ( string ! type ) ) ( string preparation_time ) ) ) )	overnight-recipes
what recipe has the least prep time	( call SW.listValue ( call SW.superlative ( call SW.getProperty ( call SW.singleton en.recipe ) ( string ! type ) ) ( string min ) ( call SW.ensureNumericProperty ( string preparation_time ) ) ) )	overnight-recipes
which recipe needs more time than rice pudding preparation	( call SW.listValue ( call SW.filter ( call SW.getProperty ( call SW.singleton en.recipe ) ( string ! type ) ) ( call SW.ensureNumericProperty ( string preparation_time ) ) ( string > ) ( call SW.ensureNumericEntity ( call SW.getProperty en.recipe.rice_pudding ( string preparation_time ) ) ) ) )	overnight-recipes
list  the ingredients of rice pudding	( call SW.listValue ( call SW.filter ( call SW.getProperty ( call SW.singleton en.ingredient ) ( string ! type ) ) ( call SW.reverse ( string requires ) ) ( string = ) en.recipe.rice_pudding ) )	overnight-recipes
what recipes posting date is at the greatest in 2004	( call SW.listValue ( call SW.filter ( call SW.getProperty ( call SW.singleton en.recipe ) ( string ! type ) ) ( call SW.ensureNumericProperty ( string posting_date ) ) ( string <= ) ( call SW.ensureNumericEntity ( date 2004 -1 -1 ) ) ) )	overnight-recipes
for what meals require less than two recipes	( call SW.listValue ( call SW.countComparative ( call SW.getProperty ( call SW.singleton en.meal ) ( string ! type ) ) ( call SW.reverse ( string meal ) ) ( string < ) ( number 2 ) ( call SW.getProperty ( call SW.singleton en.recipe ) ( string ! type ) ) ) )	overnight-recipes
what recipe needs spinach or milk for its preparation	( call SW.listValue ( call SW.filter ( call SW.getProperty ( call SW.singleton en.recipe ) ( string ! type ) ) ( string requires ) ( string = ) ( call SW.concat en.ingredient.milk en.ingredient.spinach ) ) )	overnight-recipes
what is the cooking time for rice pudding	( call SW.listValue ( call SW.getProperty en.recipe.rice_pudding ( string cooking_time ) ) )	overnight-recipes
which is the recipe that was posted last	( call SW.listValue ( call SW.superlative ( call SW.getProperty ( call SW.singleton en.recipe ) ( string ! type ) ) ( string max ) ( call SW.ensureNumericProperty ( string posting_date ) ) ) )	overnight-recipes
name ingredients that is required in  three or more recipes	( call SW.listValue ( call SW.countComparative ( call SW.getProperty ( call SW.singleton en.ingredient ) ( string ! type ) ) ( call SW.reverse ( string requires ) ) ( string > ) ( number 2 ) ( call SW.getProperty ( call SW.singleton en.recipe ) ( string ! type ) ) ) )	overnight-recipes
show me recipes posted before rice pudding	( call SW.listValue ( call SW.filter ( call SW.getProperty ( call SW.singleton en.recipe ) ( string ! type ) ) ( call SW.ensureNumericProperty ( string posting_date ) ) ( string < ) ( call SW.ensureNumericEntity ( call SW.getProperty en.recipe.rice_pudding ( string posting_date ) ) ) ) )	overnight-recipes
average cooking time	( call SW.listValue ( call SW.aggregate ( string avg ) ( call SW.getProperty ( call SW.getProperty ( call SW.singleton en.recipe ) ( string ! type ) ) ( string cooking_time ) ) ) )	overnight-recipes
show me a recipe with the same prep time as rice pudding	( call SW.listValue ( call SW.filter ( call SW.getProperty ( call SW.singleton en.recipe ) ( string ! type ) ) ( string preparation_time ) ( string = ) ( call SW.getProperty en.recipe.rice_pudding ( string preparation_time ) ) ) )	overnight-recipes
what ingredient is used by two recipes	( call SW.listValue ( call SW.countComparative ( call SW.getProperty ( call SW.singleton en.ingredient ) ( string ! type ) ) ( call SW.reverse ( string requires ) ) ( string = ) ( number 2 ) ( call SW.getProperty ( call SW.singleton en.recipe ) ( string ! type ) ) ) )	overnight-recipes
find the recipes of multiple cuisine	( call SW.listValue ( call SW.countComparative ( call SW.getProperty ( call SW.singleton en.recipe ) ( string ! type ) ) ( string cuisine ) ( string >= ) ( number 2 ) ) )	overnight-recipes
show me recipes with cooking time greater than preparation time for rice pudding	( call SW.listValue ( call SW.filter ( call SW.getProperty ( call SW.singleton en.recipe ) ( string ! type ) ) ( call SW.ensureNumericProperty ( string cooking_time ) ) ( string > ) ( call SW.ensureNumericEntity ( call SW.getProperty en.recipe.rice_pudding ( string preparation_time ) ) ) ) )	overnight-recipes
name the recipe with a cooking time with at least the cooking time of rice pudding	( call SW.listValue ( call SW.filter ( call SW.getProperty ( call SW.singleton en.recipe ) ( string ! type ) ) ( call SW.ensureNumericProperty ( string cooking_time ) ) ( string >= ) ( call SW.ensureNumericEntity ( call SW.getProperty en.recipe.rice_pudding ( string cooking_time ) ) ) ) )	overnight-recipes
what ingredient is required in two or more recipes	( call SW.listValue ( call SW.countComparative ( call SW.getProperty ( call SW.singleton en.ingredient ) ( string ! type ) ) ( call SW.reverse ( string requires ) ) ( string >= ) ( number 2 ) ( call SW.getProperty ( call SW.singleton en.recipe ) ( string ! type ) ) ) )	overnight-recipes
what are ingredients in rice pudding	( call SW.listValue ( call SW.filter ( call SW.filter ( call SW.getProperty ( call SW.singleton en.ingredient ) ( string ! type ) ) ( call SW.reverse ( string requires ) ) ( string = ) en.recipe.rice_pudding ) ( call SW.reverse ( string requires ) ) ( string = ) en.recipe.rice_pudding ) )	overnight-recipes
find the recipes for same cuisine as rice pudding	( call SW.listValue ( call SW.filter ( call SW.getProperty ( call SW.singleton en.recipe ) ( string ! type ) ) ( string cuisine ) ( string = ) ( call SW.getProperty en.recipe.rice_pudding ( string cuisine ) ) ) )	overnight-recipes
what ingredients go in rice pudding	( call SW.listValue ( call SW.filter ( call SW.filter ( call SW.getProperty ( call SW.singleton en.ingredient ) ( string ! type ) ) ( call SW.reverse ( string requires ) ) ( string = ) en.recipe.rice_pudding ) ( call SW.reverse ( string requires ) ) ( string = ) en.recipe.rice_pudding ) )	overnight-recipes
what recipes take the same amount of time or less to cook as rice pudding	( call SW.listValue ( call SW.filter ( call SW.getProperty ( call SW.singleton en.recipe ) ( string ! type ) ) ( call SW.ensureNumericProperty ( string cooking_time ) ) ( string <= ) ( call SW.ensureNumericEntity ( call SW.getProperty en.recipe.rice_pudding ( string cooking_time ) ) ) ) )	overnight-recipes
recipe of cuisine of rice pudding	( call SW.listValue ( call SW.filter ( call SW.getProperty ( call SW.singleton en.recipe ) ( string ! type ) ) ( string cuisine ) ( string = ) ( call SW.getProperty en.recipe.rice_pudding ( string cuisine ) ) ) )	overnight-recipes
show me recipes that take less time to prepare than rice pudding	( call SW.listValue ( call SW.filter ( call SW.getProperty ( call SW.singleton en.recipe ) ( string ! type ) ) ( call SW.ensureNumericProperty ( string cooking_time ) ) ( string < ) ( call SW.ensureNumericEntity ( call SW.getProperty en.recipe.rice_pudding ( string preparation_time ) ) ) ) )	overnight-recipes
what recipe can make fewer than two meals	( call SW.listValue ( call SW.countComparative ( call SW.getProperty ( call SW.singleton en.recipe ) ( string ! type ) ) ( string meal ) ( string < ) ( number 2 ) ( call SW.getProperty ( call SW.singleton en.meal ) ( string ! type ) ) ) )	overnight-recipes
what lunch recipe was posted in 2004	( call SW.listValue ( call SW.filter ( call SW.filter ( call SW.getProperty ( call SW.singleton en.recipe ) ( string ! type ) ) ( string posting_date ) ( string = ) ( date 2004 -1 -1 ) ) ( string meal ) ( string = ) en.meal.lunch ) )	overnight-recipes
which recipe takes less time to prepare than rice pudding	( call SW.listValue ( call SW.filter ( call SW.getProperty ( call SW.singleton en.recipe ) ( string ! type ) ) ( call SW.ensureNumericProperty ( string cooking_time ) ) ( string < ) ( call SW.ensureNumericEntity ( call SW.getProperty en.recipe.rice_pudding ( string cooking_time ) ) ) ) )	overnight-recipes
what is the average preparation time across all recipes	( call SW.listValue ( call SW.aggregate ( string avg ) ( call SW.getProperty ( call SW.getProperty ( call SW.singleton en.recipe ) ( string ! type ) ) ( string preparation_time ) ) ) )	overnight-recipes
what recipe was posted no later than 2004 or 2010	( call SW.listValue ( call SW.filter ( call SW.getProperty ( call SW.singleton en.recipe ) ( string ! type ) ) ( call SW.ensureNumericProperty ( string posting_date ) ) ( string <= ) ( call SW.ensureNumericEntity ( call SW.concat ( date 2004 -1 -1 ) ( date 2010 -1 -1 ) ) ) ) )	overnight-recipes
recipes that require lesser time to prepare than rice pudding	( call SW.listValue ( call SW.filter ( call SW.getProperty ( call SW.singleton en.recipe ) ( string ! type ) ) ( call SW.ensureNumericProperty ( string preparation_time ) ) ( string < ) ( call SW.ensureNumericEntity ( call SW.getProperty en.recipe.rice_pudding ( string cooking_time ) ) ) ) )	overnight-recipes
how much time it takes to prepare recipe	( call SW.listValue ( call SW.aggregate ( string sum ) ( call SW.getProperty ( call SW.getProperty ( call SW.singleton en.recipe ) ( string ! type ) ) ( string preparation_time ) ) ) )	overnight-recipes
show me recipes posted before any posting for rice pudding	( call SW.listValue ( call SW.filter ( call SW.getProperty ( call SW.singleton en.recipe ) ( string ! type ) ) ( call SW.ensureNumericProperty ( string posting_date ) ) ( string < ) ( call SW.ensureNumericEntity ( call SW.getProperty en.recipe.rice_pudding ( string posting_date ) ) ) ) )	overnight-recipes
how many recipes	( call SW.listValue ( call .size ( call SW.getProperty ( call SW.singleton en.recipe ) ( string ! type ) ) ) )	overnight-recipes
show me recipes that take as long to prepare as rice pudding	( call SW.listValue ( call SW.filter ( call SW.getProperty ( call SW.singleton en.recipe ) ( string ! type ) ) ( call SW.ensureNumericProperty ( string preparation_time ) ) ( string <= ) ( call SW.ensureNumericEntity ( call SW.getProperty en.recipe.rice_pudding ( string preparation_time ) ) ) ) )	overnight-recipes
for what meal are there the fewest number of recipes	( call SW.listValue ( call SW.countSuperlative ( call SW.getProperty ( call SW.singleton en.meal ) ( string ! type ) ) ( string min ) ( call SW.reverse ( string meal ) ) ( call SW.getProperty ( call SW.singleton en.recipe ) ( string ! type ) ) ) )	overnight-recipes
what recipe was posted before 2010	( call SW.listValue ( call SW.filter ( call SW.getProperty ( call SW.singleton en.recipe ) ( string ! type ) ) ( call SW.ensureNumericProperty ( string posting_date ) ) ( string < ) ( call SW.ensureNumericEntity ( call SW.concat ( date 2004 -1 -1 ) ( date 2010 -1 -1 ) ) ) ) )	overnight-recipes
what recipes require milk and are for lunch	( call SW.listValue ( call SW.filter ( call SW.filter ( call SW.getProperty ( call SW.singleton en.recipe ) ( string ! type ) ) ( string meal ) ( string = ) en.meal.lunch ) ( string requires ) ( string = ) en.ingredient.milk ) )	overnight-recipes
what recipes preparation time is the same as rice pudding	( call SW.listValue ( call SW.filter ( call SW.getProperty ( call SW.singleton en.recipe ) ( string ! type ) ) ( string preparation_time ) ( string = ) ( call SW.getProperty en.recipe.rice_pudding ( string preparation_time ) ) ) )	overnight-recipes
find recipes that can be prepared sooner than rice pudding	( call SW.listValue ( call SW.filter ( call SW.getProperty ( call SW.singleton en.recipe ) ( string ! type ) ) ( call SW.ensureNumericProperty ( string preparation_time ) ) ( string < ) ( call SW.ensureNumericEntity ( call SW.getProperty en.recipe.rice_pudding ( string preparation_time ) ) ) ) )	overnight-recipes
show me recipes that fall under two cuisines or less	( call SW.listValue ( call SW.countComparative ( call SW.getProperty ( call SW.singleton en.recipe ) ( string ! type ) ) ( string cuisine ) ( string <= ) ( number 2 ) ) )	overnight-recipes
for what meal is rice pudding used for	( call SW.listValue ( call SW.filter ( call SW.getProperty ( call SW.singleton en.meal ) ( string ! type ) ) ( call SW.reverse ( string meal ) ) ( string = ) en.recipe.rice_pudding ) )	overnight-recipes
what recipe posted in 2004 can make a lunch meal	( call SW.listValue ( call SW.filter ( call SW.filter ( call SW.getProperty ( call SW.singleton en.recipe ) ( string ! type ) ) ( string meal ) ( string = ) en.meal.lunch ) ( string posting_date ) ( string = ) ( date 2004 -1 -1 ) ) )	overnight-recipes
show recipes with the maximum number of cuisines	( call SW.listValue ( call SW.countSuperlative ( call SW.getProperty ( call SW.singleton en.recipe ) ( string ! type ) ) ( string max ) ( string cuisine ) ) )	overnight-recipes
show me recipes that are not lunch recipes	( call SW.listValue ( call SW.filter ( call SW.getProperty ( call SW.singleton en.recipe ) ( string ! type ) ) ( string meal ) ( string ! = ) en.meal.lunch ) )	overnight-recipes
what is the posting date of rice pudding	( call SW.listValue ( call SW.getProperty en.recipe.rice_pudding ( string posting_date ) ) )	overnight-recipes
what is a recipe with the most ingredients	( call SW.listValue ( call SW.countSuperlative ( call SW.getProperty ( call SW.singleton en.recipe ) ( string ! type ) ) ( string max ) ( string cuisine ) ) )	overnight-recipes
what ingredient is called for by a recipe posted in 2004	( call SW.listValue ( call SW.filter ( call SW.getProperty ( call SW.singleton en.ingredient ) ( string ! type ) ) ( call SW.reverse ( string requires ) ) ( string = ) ( call SW.filter ( call SW.getProperty ( call SW.singleton en.recipe ) ( string ! type ) ) ( string posting_date ) ( string = ) ( date 2004 -1 -1 ) ) ) )	overnight-recipes
what ingredients are used only for lunch	( call SW.listValue ( call SW.filter ( call SW.getProperty ( call SW.singleton en.ingredient ) ( string ! type ) ) ( call SW.reverse ( string requires ) ) ( string = ) ( call SW.filter ( call SW.getProperty ( call SW.singleton en.recipe ) ( string ! type ) ) ( string meal ) ( string = ) en.meal.lunch ) ) )	overnight-recipes
what recipe has the latest date posted	( call SW.listValue ( call SW.superlative ( call SW.getProperty ( call SW.singleton en.recipe ) ( string ! type ) ) ( string max ) ( call SW.ensureNumericProperty ( string posting_date ) ) ) )	overnight-recipes
how many total recipes are there	( call SW.listValue ( call .size ( call SW.getProperty ( call SW.singleton en.recipe ) ( string ! type ) ) ) )	overnight-recipes
which recipe requires the same ingredient as rice pudding	( call SW.listValue ( call SW.filter ( call SW.getProperty ( call SW.singleton en.recipe ) ( string ! type ) ) ( string requires ) ( string = ) ( call SW.filter ( call SW.getProperty ( call SW.singleton en.ingredient ) ( string ! type ) ) ( call SW.reverse ( string requires ) ) ( string = ) en.recipe.rice_pudding ) ) )	overnight-recipes
which ingredient is needed in less than two recipes 	( call SW.listValue ( call SW.countComparative ( call SW.getProperty ( call SW.singleton en.ingredient ) ( string ! type ) ) ( call SW.reverse ( string requires ) ) ( string < ) ( number 2 ) ( call SW.getProperty ( call SW.singleton en.recipe ) ( string ! type ) ) ) )	overnight-recipes
how long does the recipe take to cook	( call SW.listValue ( call SW.aggregate ( string sum ) ( call SW.getProperty ( call SW.getProperty ( call SW.singleton en.recipe ) ( string ! type ) ) ( string cooking_time ) ) ) )	overnight-recipes
what recipe calls for over two ingredients	( call SW.listValue ( call SW.countComparative ( call SW.getProperty ( call SW.singleton en.recipe ) ( string ! type ) ) ( string requires ) ( string > ) ( number 2 ) ( call SW.getProperty ( call SW.singleton en.ingredient ) ( string ! type ) ) ) )	overnight-recipes
a recipe which takes at least as long to cook as rice pudding	( call SW.listValue ( call SW.filter ( call SW.getProperty ( call SW.singleton en.recipe ) ( string ! type ) ) ( call SW.ensureNumericProperty ( string cooking_time ) ) ( string >= ) ( call SW.ensureNumericEntity ( call SW.getProperty en.recipe.rice_pudding ( string cooking_time ) ) ) ) )	overnight-recipes
which food item is not needed in rice pudding	( call SW.listValue ( call SW.filter ( call SW.getProperty ( call SW.singleton en.ingredient ) ( string ! type ) ) ( call SW.reverse ( string requires ) ) ( string ! = ) en.recipe.rice_pudding ) )	overnight-recipes
what recipe was posted before rice pudding	( call SW.listValue ( call SW.filter ( call SW.getProperty ( call SW.singleton en.recipe ) ( string ! type ) ) ( call SW.ensureNumericProperty ( string posting_date ) ) ( string < ) ( call SW.ensureNumericEntity ( call SW.getProperty en.recipe.rice_pudding ( string posting_date ) ) ) ) )	overnight-recipes
how long does rice pudding take to prep	( call SW.listValue ( call SW.getProperty en.recipe.rice_pudding ( string preparation_time ) ) )	overnight-recipes
what is a lunch recipe	( call SW.listValue ( call SW.filter ( call SW.filter ( call SW.getProperty ( call SW.singleton en.recipe ) ( string ! type ) ) ( string meal ) ( string = ) en.meal.lunch ) ( string meal ) ( string = ) en.meal.lunch ) )	overnight-recipes
show me recipes posted in or before 2004	( call SW.listValue ( call SW.filter ( call SW.getProperty ( call SW.singleton en.recipe ) ( string ! type ) ) ( call SW.ensureNumericProperty ( string posting_date ) ) ( string <= ) ( call SW.ensureNumericEntity ( date 2004 -1 -1 ) ) ) )	overnight-recipes
what meal has two or more recipes	( call SW.listValue ( call SW.countComparative ( call SW.getProperty ( call SW.singleton en.meal ) ( string ! type ) ) ( call SW.reverse ( string meal ) ) ( string >= ) ( number 2 ) ( call SW.getProperty ( call SW.singleton en.recipe ) ( string ! type ) ) ) )	overnight-recipes
show me meals for one	( call SW.listValue ( call SW.countSuperlative ( call SW.getProperty ( call SW.singleton en.meal ) ( string ! type ) ) ( string min ) ( call SW.reverse ( string meal ) ) ( call SW.getProperty ( call SW.singleton en.recipe ) ( string ! type ) ) ) )	overnight-recipes
which recipes have two cuisines	( call SW.listValue ( call SW.countComparative ( call SW.getProperty ( call SW.singleton en.recipe ) ( string ! type ) ) ( string cuisine ) ( string = ) ( number 2 ) ) )	overnight-recipes
which food item is needed in  two recipes or more	( call SW.listValue ( call SW.countComparative ( call SW.getProperty ( call SW.singleton en.ingredient ) ( string ! type ) ) ( call SW.reverse ( string requires ) ) ( string > ) ( number 2 ) ( call SW.getProperty ( call SW.singleton en.recipe ) ( string ! type ) ) ) )	overnight-recipes
find recipe that needs the maximum number of food items	( call SW.listValue ( call SW.countSuperlative ( call SW.getProperty ( call SW.singleton en.recipe ) ( string ! type ) ) ( string max ) ( string requires ) ( call SW.getProperty ( call SW.singleton en.ingredient ) ( string ! type ) ) ) )	overnight-recipes
find recipes posted in 2004 or 2010	( call SW.listValue ( call SW.filter ( call SW.getProperty ( call SW.singleton en.recipe ) ( string ! type ) ) ( string posting_date ) ( string = ) ( call SW.concat ( date 2004 -1 -1 ) ( date 2010 -1 -1 ) ) ) )	overnight-recipes
how many recipes use more than two ingredients	( call SW.listValue ( call SW.countComparative ( call SW.getProperty ( call SW.singleton en.recipe ) ( string ! type ) ) ( string requires ) ( string > ) ( number 2 ) ( call SW.getProperty ( call SW.singleton en.ingredient ) ( string ! type ) ) ) )	overnight-recipes
what is recipe for a meal	( call SW.listValue ( call SW.countComparative ( call SW.getProperty ( call SW.singleton en.recipe ) ( string ! type ) ) ( string meal ) ( string < ) ( number 2 ) ( call SW.getProperty ( call SW.singleton en.meal ) ( string ! type ) ) ) )	overnight-recipes
what ingredient is not required to make rice pudding	( call SW.listValue ( call SW.filter ( call SW.getProperty ( call SW.singleton en.ingredient ) ( string ! type ) ) ( call SW.reverse ( string requires ) ) ( string ! = ) en.recipe.rice_pudding ) )	overnight-recipes
what recipe has the fewest amount of ingredients	( call SW.listValue ( call SW.countSuperlative ( call SW.getProperty ( call SW.singleton en.recipe ) ( string ! type ) ) ( string min ) ( string requires ) ( call SW.getProperty ( call SW.singleton en.ingredient ) ( string ! type ) ) ) )	overnight-recipes
show me recipes posted no earlier than 2004	( call SW.listValue ( call SW.filter ( call SW.getProperty ( call SW.singleton en.recipe ) ( string ! type ) ) ( call SW.ensureNumericProperty ( string posting_date ) ) ( string >= ) ( call SW.ensureNumericEntity ( date 2004 -1 -1 ) ) ) )	overnight-recipes
single ingredient recipe	( call SW.listValue ( call SW.countComparative ( call SW.getProperty ( call SW.singleton en.recipe ) ( string ! type ) ) ( string requires ) ( string < ) ( number 2 ) ( call SW.getProperty ( call SW.singleton en.ingredient ) ( string ! type ) ) ) )	overnight-recipes
show me meals with fewer than two recipes	( call SW.listValue ( call SW.countComparative ( call SW.getProperty ( call SW.singleton en.meal ) ( string ! type ) ) ( call SW.reverse ( string meal ) ) ( string < ) ( number 2 ) ( call SW.getProperty ( call SW.singleton en.recipe ) ( string ! type ) ) ) )	overnight-recipes
name the recipe used for lunch prepared with milk	( call SW.listValue ( call SW.filter ( call SW.filter ( call SW.getProperty ( call SW.singleton en.recipe ) ( string ! type ) ) ( string meal ) ( string = ) en.meal.lunch ) ( string requires ) ( string = ) en.ingredient.milk ) )	overnight-recipes
what recipe has at the most no more than two cuisines	( call SW.listValue ( call SW.countComparative ( call SW.getProperty ( call SW.singleton en.recipe ) ( string ! type ) ) ( string cuisine ) ( string <= ) ( number 2 ) ) )	overnight-recipes
what recipe has milk as an ingredient	( call SW.listValue ( call SW.filter ( call SW.filter ( call SW.getProperty ( call SW.singleton en.recipe ) ( string ! type ) ) ( string requires ) ( string = ) en.ingredient.milk ) ( string requires ) ( string = ) en.ingredient.milk ) )	overnight-recipes
which recipe is used for the most meals	( call SW.listValue ( call SW.countSuperlative ( call SW.getProperty ( call SW.singleton en.recipe ) ( string ! type ) ) ( string max ) ( string meal ) ( call SW.getProperty ( call SW.singleton en.meal ) ( string ! type ) ) ) )	overnight-recipes
which is the most used ingredient in recipes	( call SW.listValue ( call SW.countSuperlative ( call SW.getProperty ( call SW.singleton en.ingredient ) ( string ! type ) ) ( string max ) ( call SW.reverse ( string requires ) ) ( call SW.getProperty ( call SW.singleton en.recipe ) ( string ! type ) ) ) )	overnight-recipes
what recipes have the same or longer preparation time as rice pudding	( call SW.listValue ( call SW.filter ( call SW.getProperty ( call SW.singleton en.recipe ) ( string ! type ) ) ( call SW.ensureNumericProperty ( string preparation_time ) ) ( string >= ) ( call SW.ensureNumericEntity ( call SW.getProperty en.recipe.rice_pudding ( string preparation_time ) ) ) ) )	overnight-recipes
which recipe needs longer preparation time than that of rice pudding	( call SW.listValue ( call SW.filter ( call SW.getProperty ( call SW.singleton en.recipe ) ( string ! type ) ) ( call SW.ensureNumericProperty ( string preparation_time ) ) ( string > ) ( call SW.ensureNumericEntity ( call SW.getProperty en.recipe.rice_pudding ( string cooking_time ) ) ) ) )	overnight-recipes
what ingredient is most used	( call SW.listValue ( call SW.countSuperlative ( call SW.getProperty ( call SW.singleton en.ingredient ) ( string ! type ) ) ( string max ) ( call SW.reverse ( string requires ) ) ( call SW.getProperty ( call SW.singleton en.recipe ) ( string ! type ) ) ) )	overnight-recipes
show me recipes not posted in 2004	( call SW.listValue ( call SW.filter ( call SW.getProperty ( call SW.singleton en.recipe ) ( string ! type ) ) ( string posting_date ) ( string ! = ) ( date 2004 -1 -1 ) ) )	overnight-recipes
which recipe requires milk or spinach	( call SW.listValue ( call SW.concat en.ingredient.milk en.ingredient.spinach ) )	overnight-recipes
show me ingredients needed for rice pudding and quiche	( call SW.listValue ( call SW.filter ( call SW.getProperty ( call SW.singleton en.ingredient ) ( string ! type ) ) ( call SW.reverse ( string requires ) ) ( string = ) ( call SW.concat en.recipe.rice_pudding en.recipe.quiche ) ) )	overnight-recipes
what recipe requires the ingredients of rice pudding	( call SW.listValue ( call SW.filter ( call SW.getProperty ( call SW.singleton en.recipe ) ( string ! type ) ) ( string requires ) ( string = ) ( call SW.filter ( call SW.getProperty ( call SW.singleton en.ingredient ) ( string ! type ) ) ( call SW.reverse ( string requires ) ) ( string = ) en.recipe.rice_pudding ) ) )	overnight-recipes
for what meal is rice pudding or quiche	( call SW.listValue ( call SW.filter ( call SW.getProperty ( call SW.singleton en.meal ) ( string ! type ) ) ( call SW.reverse ( string meal ) ) ( string = ) ( call SW.concat en.recipe.rice_pudding en.recipe.quiche ) ) )	overnight-recipes
show me meal with less than two recipe	( call SW.listValue ( call SW.countComparative ( call SW.getProperty ( call SW.singleton en.meal ) ( string ! type ) ) ( call SW.reverse ( string meal ) ) ( string < ) ( number 2 ) ( call SW.getProperty ( call SW.singleton en.recipe ) ( string ! type ) ) ) )	overnight-recipes
a lunch recipe posted in 2004	( call SW.listValue ( call SW.filter ( call SW.filter ( call SW.getProperty ( call SW.singleton en.recipe ) ( string ! type ) ) ( string meal ) ( string = ) en.meal.lunch ) ( string posting_date ) ( string = ) ( date 2004 -1 -1 ) ) )	overnight-recipes
ingredients not required to prepare rice pudding	( call SW.listValue ( call SW.filter ( call SW.getProperty ( call SW.singleton en.ingredient ) ( string ! type ) ) ( call SW.reverse ( string requires ) ) ( string ! = ) en.recipe.rice_pudding ) )	overnight-recipes
what to prefer rice pudding or quiche	( call SW.listValue ( call SW.concat en.recipe.rice_pudding en.recipe.quiche ) )	overnight-recipes
what recipes require no more than two ingredients	( call SW.listValue ( call SW.countComparative ( call SW.getProperty ( call SW.singleton en.recipe ) ( string ! type ) ) ( string requires ) ( string <= ) ( number 2 ) ( call SW.getProperty ( call SW.singleton en.ingredient ) ( string ! type ) ) ) )	overnight-recipes
what recipe calls for fewer than two ingredients	( call SW.listValue ( call SW.countComparative ( call SW.getProperty ( call SW.singleton en.recipe ) ( string ! type ) ) ( string requires ) ( string < ) ( number 2 ) ( call SW.getProperty ( call SW.singleton en.ingredient ) ( string ! type ) ) ) )	overnight-recipes
recipes posted till 2004	( call SW.listValue ( call SW.filter ( call SW.getProperty ( call SW.singleton en.recipe ) ( string ! type ) ) ( call SW.ensureNumericProperty ( string posting_date ) ) ( string <= ) ( call SW.ensureNumericEntity ( date 2004 -1 -1 ) ) ) )	overnight-recipes
which meal has the least recipes dedicated to it	( call SW.listValue ( call SW.countSuperlative ( call SW.getProperty ( call SW.singleton en.meal ) ( string ! type ) ) ( string min ) ( call SW.reverse ( string meal ) ) ( call SW.getProperty ( call SW.singleton en.recipe ) ( string ! type ) ) ) )	overnight-recipes
find a recipe that is good for lunch or dinner	( call SW.listValue ( call SW.filter ( call SW.getProperty ( call SW.singleton en.recipe ) ( string ! type ) ) ( string meal ) ( string = ) ( call SW.concat en.meal.lunch en.meal.dinner ) ) )	overnight-recipes
what recipe can be prepped in equal or less time than rice pudding	( call SW.listValue ( call SW.filter ( call SW.getProperty ( call SW.singleton en.recipe ) ( string ! type ) ) ( call SW.ensureNumericProperty ( string preparation_time ) ) ( string <= ) ( call SW.ensureNumericEntity ( call SW.getProperty en.recipe.rice_pudding ( string preparation_time ) ) ) ) )	overnight-recipes
what meals have recipes that use milk	( call SW.listValue ( call SW.filter ( call SW.getProperty ( call SW.singleton en.meal ) ( string ! type ) ) ( call SW.reverse ( string meal ) ) ( string = ) ( call SW.filter ( call SW.getProperty ( call SW.singleton en.recipe ) ( string ! type ) ) ( string requires ) ( string = ) en.ingredient.milk ) ) )	overnight-recipes
what type of cuisine is rice pudding	( call SW.listValue ( call SW.getProperty en.recipe.rice_pudding ( string cuisine ) ) )	overnight-recipes
recipes for less than three meals	( call SW.listValue ( call SW.countComparative ( call SW.getProperty ( call SW.singleton en.recipe ) ( string ! type ) ) ( string meal ) ( string <= ) ( number 2 ) ( call SW.getProperty ( call SW.singleton en.meal ) ( string ! type ) ) ) )	overnight-recipes
show me recipes that require milk or spinach	( call SW.listValue ( call SW.filter ( call SW.getProperty ( call SW.singleton en.recipe ) ( string ! type ) ) ( string requires ) ( string = ) ( call SW.concat en.ingredient.milk en.ingredient.spinach ) ) )	overnight-recipes
how many recipes are there	( call SW.listValue ( call .size ( call SW.getProperty ( call SW.singleton en.recipe ) ( string ! type ) ) ) )	overnight-recipes
which recipe was posted in 2004	( call SW.listValue ( call SW.filter ( call SW.filter ( call SW.getProperty ( call SW.singleton en.recipe ) ( string ! type ) ) ( string posting_date ) ( string = ) ( date 2004 -1 -1 ) ) ( string posting_date ) ( string = ) ( date 2004 -1 -1 ) ) )	overnight-recipes
what ingredients does rice pudding not need	( call SW.listValue ( call SW.filter ( call SW.getProperty ( call SW.singleton en.ingredient ) ( string ! type ) ) ( call SW.reverse ( string requires ) ) ( string ! = ) en.recipe.rice_pudding ) )	overnight-recipes
recipes prepared in rice puddings cooking time	( call SW.listValue ( call SW.filter ( call SW.getProperty ( call SW.singleton en.recipe ) ( string ! type ) ) ( string preparation_time ) ( string = ) ( call SW.getProperty en.recipe.rice_pudding ( string cooking_time ) ) ) )	overnight-recipes
which ingredient is needed in more than one recipes	( call SW.listValue ( call SW.countComparative ( call SW.getProperty ( call SW.singleton en.ingredient ) ( string ! type ) ) ( call SW.reverse ( string requires ) ) ( string >= ) ( number 2 ) ( call SW.getProperty ( call SW.singleton en.recipe ) ( string ! type ) ) ) )	overnight-recipes
which recipes require two or more ingredients	( call SW.listValue ( call SW.countComparative ( call SW.getProperty ( call SW.singleton en.ingredient ) ( string ! type ) ) ( call SW.reverse ( string requires ) ) ( string >= ) ( number 2 ) ( call SW.getProperty ( call SW.singleton en.recipe ) ( string ! type ) ) ) )	overnight-recipes
show me recipes with two ingredients	( call SW.listValue ( call SW.countComparative ( call SW.getProperty ( call SW.singleton en.recipe ) ( string ! type ) ) ( string requires ) ( string = ) ( number 2 ) ( call SW.getProperty ( call SW.singleton en.ingredient ) ( string ! type ) ) ) )	overnight-recipes
what recipes take more time to prepare than rice pudding	( call SW.listValue ( call SW.filter ( call SW.getProperty ( call SW.singleton en.recipe ) ( string ! type ) ) ( call SW.ensureNumericProperty ( string cooking_time ) ) ( string > ) ( call SW.ensureNumericEntity ( call SW.getProperty en.recipe.rice_pudding ( string preparation_time ) ) ) ) )	overnight-recipes
show the first recipe posted	( call SW.listValue ( call SW.superlative ( call SW.getProperty ( call SW.singleton en.recipe ) ( string ! type ) ) ( string min ) ( call SW.ensureNumericProperty ( string posting_date ) ) ) )	overnight-recipes
what food items are needed to make rice pudding	( call SW.listValue ( call SW.filter ( call SW.getProperty ( call SW.singleton en.ingredient ) ( string ! type ) ) ( call SW.reverse ( string requires ) ) ( string = ) en.recipe.rice_pudding ) )	overnight-recipes
what recipe takes more time to prepare than rice pudding	( call SW.listValue ( call SW.filter ( call SW.getProperty ( call SW.singleton en.recipe ) ( string ! type ) ) ( call SW.ensureNumericProperty ( string cooking_time ) ) ( string > ) ( call SW.ensureNumericEntity ( call SW.getProperty en.recipe.rice_pudding ( string preparation_time ) ) ) ) )	overnight-recipes
when was rice pudding posted	( call SW.listValue ( call SW.getProperty en.recipe.rice_pudding ( string posting_date ) ) )	overnight-recipes
what recipe makes something for lunch	( call SW.listValue ( call SW.filter ( call SW.filter ( call SW.getProperty ( call SW.singleton en.recipe ) ( string ! type ) ) ( string meal ) ( string = ) en.meal.lunch ) ( string meal ) ( string = ) en.meal.lunch ) )	overnight-recipes
which recipes have at most two cuisines	( call SW.listValue ( call SW.countComparative ( call SW.getProperty ( call SW.singleton en.recipe ) ( string ! type ) ) ( string cuisine ) ( string <= ) ( number 2 ) ) )	overnight-recipes
show me recipes posted in 2004 requiring milk	( call SW.listValue ( call SW.filter ( call SW.filter ( call SW.getProperty ( call SW.singleton en.recipe ) ( string ! type ) ) ( string posting_date ) ( string = ) ( date 2004 -1 -1 ) ) ( string requires ) ( string = ) en.ingredient.milk ) )	overnight-recipes
show me all the recipes posted in 2004	( call SW.listValue ( call SW.filter ( call SW.filter ( call SW.getProperty ( call SW.singleton en.recipe ) ( string ! type ) ) ( string posting_date ) ( string = ) ( date 2004 -1 -1 ) ) ( string posting_date ) ( string = ) ( date 2004 -1 -1 ) ) )	overnight-recipes
show me recipes for lunch posted in 2004	( call SW.listValue ( call SW.filter ( call SW.filter ( call SW.getProperty ( call SW.singleton en.recipe ) ( string ! type ) ) ( string meal ) ( string = ) en.meal.lunch ) ( string posting_date ) ( string = ) ( date 2004 -1 -1 ) ) )	overnight-recipes
which recipes require milk or spinach	( call SW.listValue ( call SW.filter ( call SW.getProperty ( call SW.singleton en.recipe ) ( string ! type ) ) ( string requires ) ( string = ) ( call SW.concat en.ingredient.milk en.ingredient.spinach ) ) )	overnight-recipes
what recipe prepare in less or same time to cook rice pudding	( call SW.listValue ( call SW.filter ( call SW.getProperty ( call SW.singleton en.recipe ) ( string ! type ) ) ( call SW.ensureNumericProperty ( string preparation_time ) ) ( string >= ) ( call SW.ensureNumericEntity ( call SW.getProperty en.recipe.rice_pudding ( string cooking_time ) ) ) ) )	overnight-recipes
what day was rice pudding posted	( call SW.listValue ( call SW.getProperty en.recipe.rice_pudding ( string posting_date ) ) )	overnight-recipes
which recipes fall under more than two cuisines	( call SW.listValue ( call SW.countComparative ( call SW.getProperty ( call SW.singleton en.recipe ) ( string ! type ) ) ( string cuisine ) ( string > ) ( number 2 ) ) )	overnight-recipes
what recipe is prepared in preparation time of rice pudding or earlier	( call SW.listValue ( call SW.filter ( call SW.getProperty ( call SW.singleton en.recipe ) ( string ! type ) ) ( call SW.ensureNumericProperty ( string preparation_time ) ) ( string >= ) ( call SW.ensureNumericEntity ( call SW.getProperty en.recipe.rice_pudding ( string preparation_time ) ) ) ) )	overnight-recipes
which recipe needs less than two food items for its preparation	( call SW.listValue ( call SW.countComparative ( call SW.getProperty ( call SW.singleton en.recipe ) ( string ! type ) ) ( string requires ) ( string < ) ( number 2 ) ( call SW.getProperty ( call SW.singleton en.ingredient ) ( string ! type ) ) ) )	overnight-recipes
how many meals does this make	( call SW.listValue ( call .size ( call SW.getProperty ( call SW.singleton en.meal ) ( string ! type ) ) ) )	overnight-recipes
what recipes are cooked in same time as rice pudding	( call SW.listValue ( call SW.filter ( call SW.getProperty ( call SW.singleton en.recipe ) ( string ! type ) ) ( string cooking_time ) ( string = ) ( call SW.getProperty en.recipe.rice_pudding ( string cooking_time ) ) ) )	overnight-recipes
how many ingredients are needed	( call SW.listValue ( call .size ( call SW.getProperty ( call SW.singleton en.ingredient ) ( string ! type ) ) ) )	overnight-recipes
show me recipes that use two ingredients or less	( call SW.listValue ( call SW.countComparative ( call SW.getProperty ( call SW.singleton en.recipe ) ( string ! type ) ) ( string requires ) ( string <= ) ( number 2 ) ( call SW.getProperty ( call SW.singleton en.ingredient ) ( string ! type ) ) ) )	overnight-recipes
what is the usual time required to finish the recipe	( call SW.listValue ( call SW.aggregate ( string avg ) ( call SW.getProperty ( call SW.getProperty ( call SW.singleton en.recipe ) ( string ! type ) ) ( string preparation_time ) ) ) )	overnight-recipes
ingredients in recipe posted in 2004	( call SW.listValue ( call SW.filter ( call SW.getProperty ( call SW.singleton en.ingredient ) ( string ! type ) ) ( call SW.reverse ( string requires ) ) ( string = ) ( call SW.filter ( call SW.getProperty ( call SW.singleton en.recipe ) ( string ! type ) ) ( string posting_date ) ( string = ) ( date 2004 -1 -1 ) ) ) )	overnight-recipes
which recipes require more than two ingredients	( call SW.listValue ( call SW.countComparative ( call SW.getProperty ( call SW.singleton en.recipe ) ( string ! type ) ) ( string requires ) ( string > ) ( number 2 ) ( call SW.getProperty ( call SW.singleton en.ingredient ) ( string ! type ) ) ) )	overnight-recipes
show recipes whose cooking time is same as that of rice pudding	( call SW.listValue ( call SW.filter ( call SW.getProperty ( call SW.singleton en.recipe ) ( string ! type ) ) ( string cooking_time ) ( string = ) ( call SW.getProperty en.recipe.rice_pudding ( string preparation_time ) ) ) )	overnight-recipes
what is a recipe that was not posted in 2004	( call SW.listValue ( call SW.filter ( call SW.getProperty ( call SW.singleton en.recipe ) ( string ! type ) ) ( string posting_date ) ( string ! = ) ( date 2004 -1 -1 ) ) )	overnight-recipes
what recipe calls for the fewest ingredients	( call SW.listValue ( call SW.countSuperlative ( call SW.getProperty ( call SW.singleton en.recipe ) ( string ! type ) ) ( string min ) ( string requires ) ( call SW.getProperty ( call SW.singleton en.ingredient ) ( string ! type ) ) ) )	overnight-recipes
what recipes preparation time is no more than the cooking time of rice pudding	( call SW.listValue ( call SW.filter ( call SW.getProperty ( call SW.singleton en.recipe ) ( string ! type ) ) ( call SW.ensureNumericProperty ( string preparation_time ) ) ( string <= ) ( call SW.ensureNumericEntity ( call SW.getProperty en.recipe.rice_pudding ( string cooking_time ) ) ) ) )	overnight-recipes
what are the recipes for lunch	( call SW.listValue ( call SW.filter ( call SW.filter ( call SW.getProperty ( call SW.singleton en.recipe ) ( string ! type ) ) ( string meal ) ( string = ) en.meal.lunch ) ( string meal ) ( string = ) en.meal.lunch ) )	overnight-recipes
what recipes share at least two ingredients	( call SW.listValue ( call SW.countComparative ( call SW.getProperty ( call SW.singleton en.ingredient ) ( string ! type ) ) ( call SW.reverse ( string requires ) ) ( string >= ) ( number 2 ) ( call SW.getProperty ( call SW.singleton en.recipe ) ( string ! type ) ) ) )	overnight-recipes
what meal has quiche and rice pudding	( call SW.listValue ( call SW.filter ( call SW.getProperty ( call SW.singleton en.meal ) ( string ! type ) ) ( call SW.reverse ( string meal ) ) ( string = ) ( call SW.concat en.recipe.rice_pudding en.recipe.quiche ) ) )	overnight-recipes
what recipe was posted before 2004	( call SW.listValue ( call SW.filter ( call SW.getProperty ( call SW.singleton en.recipe ) ( string ! type ) ) ( call SW.ensureNumericProperty ( string posting_date ) ) ( string < ) ( call SW.ensureNumericEntity ( date 2004 -1 -1 ) ) ) )	overnight-recipes
show me recipes for lunch posted in 2004	( call SW.listValue ( call SW.filter ( call SW.filter ( call SW.getProperty ( call SW.singleton en.recipe ) ( string ! type ) ) ( string meal ) ( string = ) en.meal.lunch ) ( string posting_date ) ( string = ) ( date 2004 -1 -1 ) ) )	overnight-recipes
what is a meal with no more than two recipes	( call SW.listValue ( call SW.countComparative ( call SW.getProperty ( call SW.singleton en.meal ) ( string ! type ) ) ( call SW.reverse ( string meal ) ) ( string <= ) ( number 2 ) ( call SW.getProperty ( call SW.singleton en.recipe ) ( string ! type ) ) ) )	overnight-recipes
what is the total cooking time of the recipe	( call SW.listValue ( call SW.aggregate ( string sum ) ( call SW.getProperty ( call SW.getProperty ( call SW.singleton en.recipe ) ( string ! type ) ) ( string cooking_time ) ) ) )	overnight-recipes
what is a meal with the most number of recipes	( call SW.listValue ( call SW.countSuperlative ( call SW.getProperty ( call SW.singleton en.meal ) ( string ! type ) ) ( string max ) ( call SW.reverse ( string meal ) ) ( call SW.getProperty ( call SW.singleton en.recipe ) ( string ! type ) ) ) )	overnight-recipes
which meal has the least number of recipes	( call SW.listValue ( call SW.countSuperlative ( call SW.getProperty ( call SW.singleton en.meal ) ( string ! type ) ) ( string min ) ( call SW.reverse ( string meal ) ) ( call SW.getProperty ( call SW.singleton en.recipe ) ( string ! type ) ) ) )	overnight-recipes
what is an ingredient found in rice pudding	( call SW.listValue ( call SW.filter ( call SW.getProperty ( call SW.singleton en.ingredient ) ( string ! type ) ) ( call SW.reverse ( string requires ) ) ( string = ) en.recipe.rice_pudding ) )	overnight-recipes
find a meal with two recipes	( call SW.listValue ( call SW.countComparative ( call SW.getProperty ( call SW.singleton en.meal ) ( string ! type ) ) ( call SW.reverse ( string meal ) ) ( string = ) ( number 2 ) ( call SW.getProperty ( call SW.singleton en.recipe ) ( string ! type ) ) ) )	overnight-recipes
show me recipes that have the fewest ingredients	( call SW.listValue ( call SW.countSuperlative ( call SW.getProperty ( call SW.singleton en.recipe ) ( string ! type ) ) ( string min ) ( string requires ) ( call SW.getProperty ( call SW.singleton en.ingredient ) ( string ! type ) ) ) )	overnight-recipes
what is an ingredient required by the most recipes	( call SW.listValue ( call SW.countSuperlative ( call SW.getProperty ( call SW.singleton en.ingredient ) ( string ! type ) ) ( string max ) ( call SW.reverse ( string requires ) ) ( call SW.getProperty ( call SW.singleton en.recipe ) ( string ! type ) ) ) )	overnight-recipes
find all recipes posted after 2004	( call SW.listValue ( call SW.filter ( call SW.getProperty ( call SW.singleton en.recipe ) ( string ! type ) ) ( call SW.ensureNumericProperty ( string posting_date ) ) ( string > ) ( call SW.ensureNumericEntity ( call SW.concat ( date 2004 -1 -1 ) ( date 2010 -1 -1 ) ) ) ) )	overnight-recipes
what meal is rice pudding not used for	( call SW.listValue ( call SW.filter ( call SW.getProperty ( call SW.singleton en.meal ) ( string ! type ) ) ( call SW.reverse ( string meal ) ) ( string ! = ) en.recipe.rice_pudding ) )	overnight-recipes
when was the recipe for rice pudding posted	( call SW.listValue ( call SW.getProperty en.recipe.rice_pudding ( string posting_date ) ) )	overnight-recipes
show me ingredients not required for rice pudding	( call SW.listValue ( call SW.filter ( call SW.getProperty ( call SW.singleton en.ingredient ) ( string ! type ) ) ( call SW.reverse ( string requires ) ) ( string ! = ) en.recipe.rice_pudding ) )	overnight-recipes
show recipes with one cuisine	( call SW.listValue ( call SW.countSuperlative ( call SW.getProperty ( call SW.singleton en.recipe ) ( string ! type ) ) ( string min ) ( string cuisine ) ) )	overnight-recipes
what recipes are for less than two meals	( call SW.listValue ( call SW.countComparative ( call SW.getProperty ( call SW.singleton en.recipe ) ( string ! type ) ) ( string meal ) ( string < ) ( number 2 ) ( call SW.getProperty ( call SW.singleton en.meal ) ( string ! type ) ) ) )	overnight-recipes
what recipes have the same or less preparation time as rice pudding	( call SW.listValue ( call SW.filter ( call SW.getProperty ( call SW.singleton en.recipe ) ( string ! type ) ) ( call SW.ensureNumericProperty ( string preparation_time ) ) ( string <= ) ( call SW.ensureNumericEntity ( call SW.getProperty en.recipe.rice_pudding ( string preparation_time ) ) ) ) )	overnight-recipes
list recipes that require milk	( call SW.listValue ( call SW.filter ( call SW.getProperty ( call SW.singleton en.ingredient ) ( string ! type ) ) ( call SW.reverse ( string requires ) ) ( string = ) ( call SW.filter ( call SW.getProperty ( call SW.singleton en.recipe ) ( string ! type ) ) ( string requires ) ( string = ) en.ingredient.milk ) ) )	overnight-recipes
show me recipes that work for more than one meal	( call SW.listValue ( call SW.countSuperlative ( call SW.getProperty ( call SW.singleton en.recipe ) ( string ! type ) ) ( string min ) ( string meal ) ( call SW.getProperty ( call SW.singleton en.meal ) ( string ! type ) ) ) )	overnight-recipes
what is the most ingredient that this recipe requires	( call SW.listValue ( call SW.countSuperlative ( call SW.getProperty ( call SW.singleton en.ingredient ) ( string ! type ) ) ( string max ) ( call SW.reverse ( string requires ) ) ( call SW.getProperty ( call SW.singleton en.recipe ) ( string ! type ) ) ) )	overnight-recipes
what is the total number of recipes	( call SW.listValue ( call .size ( call SW.getProperty ( call SW.singleton en.recipe ) ( string ! type ) ) ) )	overnight-recipes
recipes posted after 2003	( call SW.listValue ( call SW.filter ( call SW.getProperty ( call SW.singleton en.recipe ) ( string ! type ) ) ( call SW.ensureNumericProperty ( string posting_date ) ) ( string >= ) ( call SW.ensureNumericEntity ( call SW.concat ( date 2004 -1 -1 ) ( date 2010 -1 -1 ) ) ) ) )	overnight-recipes
what meal is the recipe rice pudding for	( call SW.listValue ( call SW.filter ( call SW.getProperty ( call SW.singleton en.recipe ) ( string ! type ) ) ( string meal ) ( string = ) ( call SW.filter ( call SW.getProperty ( call SW.singleton en.meal ) ( string ! type ) ) ( call SW.reverse ( string meal ) ) ( string = ) en.recipe.rice_pudding ) ) )	overnight-recipes
what recipe requires fewer than two ingredients	( call SW.listValue ( call SW.countComparative ( call SW.getProperty ( call SW.singleton en.recipe ) ( string ! type ) ) ( string requires ) ( string < ) ( number 2 ) ( call SW.getProperty ( call SW.singleton en.ingredient ) ( string ! type ) ) ) )	overnight-recipes
what recipe do you cook for less time than rice pudding	( call SW.listValue ( call SW.filter ( call SW.getProperty ( call SW.singleton en.recipe ) ( string ! type ) ) ( call SW.ensureNumericProperty ( string cooking_time ) ) ( string < ) ( call SW.ensureNumericEntity ( call SW.getProperty en.recipe.rice_pudding ( string cooking_time ) ) ) ) )	overnight-recipes
show me recipes posted after 2004	( call SW.listValue ( call SW.filter ( call SW.getProperty ( call SW.singleton en.recipe ) ( string ! type ) ) ( call SW.ensureNumericProperty ( string posting_date ) ) ( string > ) ( call SW.ensureNumericEntity ( call SW.concat ( date 2004 -1 -1 ) ( date 2010 -1 -1 ) ) ) ) )	overnight-recipes
show me recipes that follows two or more cuisines	( call SW.listValue ( call SW.countComparative ( call SW.getProperty ( call SW.singleton en.recipe ) ( string ! type ) ) ( string cuisine ) ( string >= ) ( number 2 ) ) )	overnight-recipes
show me recipes requiring two or fewer ingredients	( call SW.listValue ( call SW.countComparative ( call SW.getProperty ( call SW.singleton en.recipe ) ( string ! type ) ) ( string requires ) ( string <= ) ( number 2 ) ( call SW.getProperty ( call SW.singleton en.ingredient ) ( string ! type ) ) ) )	overnight-recipes
which recipes need two ingredients	( call SW.listValue ( call SW.countComparative ( call SW.getProperty ( call SW.singleton en.recipe ) ( string ! type ) ) ( string requires ) ( string = ) ( number 2 ) ( call SW.getProperty ( call SW.singleton en.ingredient ) ( string ! type ) ) ) )	overnight-recipes
show me recipes that require two ingredients	( call SW.listValue ( call SW.countComparative ( call SW.getProperty ( call SW.singleton en.recipe ) ( string ! type ) ) ( string requires ) ( string = ) ( number 2 ) ( call SW.getProperty ( call SW.singleton en.ingredient ) ( string ! type ) ) ) )	overnight-recipes
show me recipes posted after 2004	( call SW.listValue ( call SW.filter ( call SW.getProperty ( call SW.singleton en.recipe ) ( string ! type ) ) ( call SW.ensureNumericProperty ( string posting_date ) ) ( string > ) ( call SW.ensureNumericEntity ( call SW.concat ( date 2004 -1 -1 ) ( date 2010 -1 -1 ) ) ) ) )	overnight-recipes
which recipe requires at least two ingredients	( call SW.listValue ( call SW.countComparative ( call SW.getProperty ( call SW.singleton en.recipe ) ( string ! type ) ) ( string requires ) ( string >= ) ( number 2 ) ( call SW.getProperty ( call SW.singleton en.ingredient ) ( string ! type ) ) ) )	overnight-recipes
how long does the recipe take to prepare	( call SW.listValue ( call SW.aggregate ( string sum ) ( call SW.getProperty ( call SW.getProperty ( call SW.singleton en.recipe ) ( string ! type ) ) ( string preparation_time ) ) ) )	overnight-recipes
what recipe can be used for at least two meals	( call SW.listValue ( call SW.countComparative ( call SW.getProperty ( call SW.singleton en.recipe ) ( string ! type ) ) ( string meal ) ( string >= ) ( number 2 ) ( call SW.getProperty ( call SW.singleton en.meal ) ( string ! type ) ) ) )	overnight-recipes
show recipes that require at the most time as rice pudding preparation	( call SW.listValue ( call SW.filter ( call SW.getProperty ( call SW.singleton en.recipe ) ( string ! type ) ) ( call SW.ensureNumericProperty ( string cooking_time ) ) ( string <= ) ( call SW.ensureNumericEntity ( call SW.getProperty en.recipe.rice_pudding ( string preparation_time ) ) ) ) )	overnight-recipes
which meal had two recipes or more	( call SW.listValue ( call SW.countComparative ( call SW.getProperty ( call SW.singleton en.meal ) ( string ! type ) ) ( call SW.reverse ( string meal ) ) ( string > ) ( number 2 ) ( call SW.getProperty ( call SW.singleton en.recipe ) ( string ! type ) ) ) )	overnight-recipes
which recipe requires the most ingredients	( call SW.listValue ( call SW.countSuperlative ( call SW.getProperty ( call SW.singleton en.recipe ) ( string ! type ) ) ( string max ) ( string requires ) ( call SW.getProperty ( call SW.singleton en.ingredient ) ( string ! type ) ) ) )	overnight-recipes
show me recipes posted in or after 2004 or in or after 2010	( call SW.listValue ( call SW.filter ( call SW.getProperty ( call SW.singleton en.recipe ) ( string ! type ) ) ( call SW.ensureNumericProperty ( string posting_date ) ) ( string >= ) ( call SW.ensureNumericEntity ( call SW.concat ( date 2004 -1 -1 ) ( date 2010 -1 -1 ) ) ) ) )	overnight-recipes
show me the total number of recipes	( call SW.listValue ( call .size ( call SW.getProperty ( call SW.singleton en.recipe ) ( string ! type ) ) ) )	overnight-recipes
what is the total preparation time of all the recipes	( call SW.listValue ( call SW.aggregate ( string sum ) ( call SW.getProperty ( call SW.getProperty ( call SW.singleton en.recipe ) ( string ! type ) ) ( string preparation_time ) ) ) )	overnight-recipes
what recipes cooking time is at lowest that of rice pudding	( call SW.listValue ( call SW.filter ( call SW.getProperty ( call SW.singleton en.recipe ) ( string ! type ) ) ( call SW.ensureNumericProperty ( string cooking_time ) ) ( string >= ) ( call SW.ensureNumericEntity ( call SW.getProperty en.recipe.rice_pudding ( string cooking_time ) ) ) ) )	overnight-recipes
which recipes are for lunch or dinner	( call SW.listValue ( call SW.filter ( call SW.getProperty ( call SW.singleton en.recipe ) ( string ! type ) ) ( string meal ) ( string = ) ( call SW.concat en.meal.lunch en.meal.dinner ) ) )	overnight-recipes
what is an ingredient not found in rice pudding	( call SW.listValue ( call SW.filter ( call SW.getProperty ( call SW.singleton en.ingredient ) ( string ! type ) ) ( call SW.reverse ( string requires ) ) ( string ! = ) en.recipe.rice_pudding ) )	overnight-recipes
what recipe was posted in 2004	( call SW.listValue ( call SW.filter ( call SW.getProperty ( call SW.singleton en.recipe ) ( string ! type ) ) ( string posting_date ) ( string = ) ( date 2004 -1 -1 ) ) )	overnight-recipes
a recipe that uses two or more ingredients	( call SW.listValue ( call SW.countComparative ( call SW.getProperty ( call SW.singleton en.recipe ) ( string ! type ) ) ( string requires ) ( string >= ) ( number 2 ) ( call SW.getProperty ( call SW.singleton en.ingredient ) ( string ! type ) ) ) )	overnight-recipes
show me recipes for lunch	( call SW.listValue ( call SW.filter ( call SW.filter ( call SW.getProperty ( call SW.singleton en.recipe ) ( string ! type ) ) ( string meal ) ( string = ) en.meal.lunch ) ( string meal ) ( string = ) en.meal.lunch ) )	overnight-recipes
what lunch recipe uses milk as an ingredient	( call SW.listValue ( call SW.filter ( call SW.filter ( call SW.getProperty ( call SW.singleton en.recipe ) ( string ! type ) ) ( string meal ) ( string = ) en.meal.lunch ) ( string requires ) ( string = ) en.ingredient.milk ) )	overnight-recipes
show me recipes that fall under the same cuisine as rice pudding	( call SW.listValue ( call SW.filter ( call SW.getProperty ( call SW.singleton en.recipe ) ( string ! type ) ) ( string cuisine ) ( string = ) ( call SW.getProperty en.recipe.rice_pudding ( string cuisine ) ) ) )	overnight-recipes
meal with more than two recipes	( call SW.listValue ( call SW.countComparative ( call SW.getProperty ( call SW.singleton en.meal ) ( string ! type ) ) ( call SW.reverse ( string meal ) ) ( string > ) ( number 2 ) ( call SW.getProperty ( call SW.singleton en.recipe ) ( string ! type ) ) ) )	overnight-recipes
find a lunch recipe that is prepared with milk	( call SW.listValue ( call SW.filter ( call SW.filter ( call SW.getProperty ( call SW.singleton en.recipe ) ( string ! type ) ) ( string requires ) ( string = ) en.ingredient.milk ) ( string meal ) ( string = ) en.meal.lunch ) )	overnight-recipes
what recipe can you prepare in the same or less time than it takes to cook rice pudding	( call SW.listValue ( call SW.filter ( call SW.getProperty ( call SW.singleton en.recipe ) ( string ! type ) ) ( call SW.ensureNumericProperty ( string preparation_time ) ) ( string <= ) ( call SW.ensureNumericEntity ( call SW.getProperty en.recipe.rice_pudding ( string cooking_time ) ) ) ) )	overnight-recipes
preparation time of recipe  not more than that of rice pudding	( call SW.listValue ( call SW.filter ( call SW.getProperty ( call SW.singleton en.recipe ) ( string ! type ) ) ( call SW.ensureNumericProperty ( string preparation_time ) ) ( string <= ) ( call SW.ensureNumericEntity ( call SW.getProperty en.recipe.rice_pudding ( string cooking_time ) ) ) ) )	overnight-recipes
what recipe serves at the most three	( call SW.listValue ( call SW.countSuperlative ( call SW.getProperty ( call SW.singleton en.recipe ) ( string ! type ) ) ( string max ) ( string meal ) ( call SW.getProperty ( call SW.singleton en.meal ) ( string ! type ) ) ) )	overnight-recipes
how many ingredients	( call SW.listValue ( call .size ( call SW.getProperty ( call SW.singleton en.ingredient ) ( string ! type ) ) ) )	overnight-recipes
what meal has over two recipes	( call SW.listValue ( call SW.countComparative ( call SW.getProperty ( call SW.singleton en.meal ) ( string ! type ) ) ( call SW.reverse ( string meal ) ) ( string > ) ( number 2 ) ( call SW.getProperty ( call SW.singleton en.recipe ) ( string ! type ) ) ) )	overnight-recipes
