find me the block with the least blocks below it	( call SW.listValue ( call SW.countSuperlative ( call SW.getProperty ( call SW.singleton en.block ) ( string ! type ) ) ( string min ) ( string above ) ( call SW.getProperty ( call SW.singleton en.block ) ( string ! type ) ) ) )	overnight-blocks
which block is below block that is at the right of block 1	( call SW.listValue ( call SW.filter ( call SW.getProperty ( call SW.singleton en.block ) ( string ! type ) ) ( string below ) ( string = ) ( call SW.filter ( call SW.getProperty ( call SW.singleton en.block ) ( string ! type ) ) ( string right ) ( string = ) en.block.block1 ) ) )	overnight-blocks
find the block that has a height that does not surpass the height of block 1	( call SW.listValue ( call SW.filter ( call SW.getProperty ( call SW.singleton en.block ) ( string ! type ) ) ( call SW.ensureNumericProperty ( string height ) ) ( string <= ) ( call SW.ensureNumericEntity ( call SW.getProperty en.block.block1 ( string height ) ) ) ) )	overnight-blocks
select the lower block that is 3 inches tall	( call SW.listValue ( call SW.filter ( call SW.getProperty ( call SW.singleton en.block ) ( string ! type ) ) ( string below ) ( string = ) ( call SW.filter ( call SW.getProperty ( call SW.singleton en.block ) ( string ! type ) ) ( string height ) ( string = ) ( number 3 en.inch ) ) ) )	overnight-blocks
what block is to the right of block 1 and is in the shape of a pyramid	( call SW.listValue ( call SW.filter ( call SW.filter ( call SW.getProperty ( call SW.singleton en.block ) ( string ! type ) ) ( call SW.reverse ( string left ) ) ( string = ) en.block.block1 ) ( string shape ) ( string = ) en.shape.pyramid ) )	overnight-blocks
find me all blocks taller than the length of block 1	( call SW.listValue ( call SW.filter ( call SW.getProperty ( call SW.singleton en.block ) ( string ! type ) ) ( call SW.ensureNumericProperty ( string height ) ) ( string >= ) ( call SW.ensureNumericEntity ( call SW.getProperty en.block.block1 ( string length ) ) ) ) )	overnight-blocks
what block is skinnier than the height of block 1	( call SW.listValue ( call SW.filter ( call SW.getProperty ( call SW.singleton en.block ) ( string ! type ) ) ( call SW.ensureNumericProperty ( string width ) ) ( string < ) ( call SW.ensureNumericEntity ( call SW.getProperty en.block.block1 ( string height ) ) ) ) )	overnight-blocks
block two spaces above block 1	( call SW.listValue ( call SW.filter ( call SW.getProperty ( call SW.singleton en.block ) ( string ! type ) ) ( string above ) ( string = ) ( call SW.filter ( call SW.getProperty ( call SW.singleton en.block ) ( string ! type ) ) ( string above ) ( string = ) en.block.block1 ) ) )	overnight-blocks
block taller or same height as the width of block 1	( call SW.listValue ( call SW.filter ( call SW.getProperty ( call SW.singleton en.block ) ( string ! type ) ) ( call SW.ensureNumericProperty ( string height ) ) ( string >= ) ( call SW.ensureNumericEntity ( call SW.getProperty en.block.block1 ( string width ) ) ) ) )	overnight-blocks
choose a block to the left of block 1	( call SW.listValue ( call SW.filter ( call SW.getProperty ( call SW.singleton en.block ) ( string ! type ) ) ( string above ) ( string = ) ( call SW.filter ( call SW.getProperty ( call SW.singleton en.block ) ( string ! type ) ) ( string left ) ( string = ) en.block.block1 ) ) )	overnight-blocks
which is the block to the right of special block	( call SW.listValue ( call SW.filter ( call SW.getProperty ( call SW.singleton en.block ) ( string ! type ) ) ( call SW.reverse ( string right ) ) ( string = ) ( call SW.filter ( call SW.getProperty ( call SW.singleton en.block ) ( string ! type ) ) ( string is_special ) ) ) )	overnight-blocks
find me all blocks with at least 2 blocks below	( call SW.listValue ( call SW.countComparative ( call SW.getProperty ( call SW.singleton en.block ) ( string ! type ) ) ( call SW.reverse ( string below ) ) ( string >= ) ( number 2 ) ( call SW.getProperty ( call SW.singleton en.block ) ( string ! type ) ) ) )	overnight-blocks
find me all blocks below and to the right of block 1	( call SW.listValue ( call SW.filter ( call SW.filter ( call SW.getProperty ( call SW.singleton en.block ) ( string ! type ) ) ( string below ) ( string = ) en.block.block1 ) ( call SW.reverse ( string left ) ) ( string = ) en.block.block1 ) )	overnight-blocks
choose the most colorful block	( call SW.listValue ( call SW.countSuperlative ( call SW.getProperty ( call SW.singleton en.block ) ( string ! type ) ) ( string max ) ( string color ) ) )	overnight-blocks
find me all 3 inch blocks left of block 1	( call SW.listValue ( call SW.filter ( call SW.filter ( call SW.getProperty ( call SW.singleton en.block ) ( string ! type ) ) ( string left ) ( string = ) en.block.block1 ) ( string length ) ( string = ) ( number 3 en.inch ) ) )	overnight-blocks
locate the block with a height measurement that equals at minimum the length of block 1	( call SW.listValue ( call SW.filter ( call SW.getProperty ( call SW.singleton en.block ) ( string ! type ) ) ( call SW.ensureNumericProperty ( string height ) ) ( string >= ) ( call SW.ensureNumericEntity ( call SW.getProperty en.block.block1 ( string length ) ) ) ) )	overnight-blocks
what block is left of block 1 and 3 inches in length	( call SW.listValue ( call SW.filter ( call SW.filter ( call SW.getProperty ( call SW.singleton en.block ) ( string ! type ) ) ( string length ) ( string = ) ( number 3 en.inch ) ) ( call SW.reverse ( string left ) ) ( string = ) en.block.block1 ) )	overnight-blocks
3 inch tall bock below block 1	( call SW.listValue ( call SW.filter ( call SW.filter ( call SW.getProperty ( call SW.singleton en.block ) ( string ! type ) ) ( call SW.reverse ( string above ) ) ( string = ) en.block.block1 ) ( string height ) ( string = ) ( number 3 en.inch ) ) )	overnight-blocks
block two right from block 1	( call SW.listValue ( call SW.filter ( call SW.getProperty ( call SW.singleton en.block ) ( string ! type ) ) ( call SW.reverse ( string right ) ) ( string = ) ( call SW.filter ( call SW.getProperty ( call SW.singleton en.block ) ( string ! type ) ) ( string right ) ( string = ) en.block.block1 ) ) )	overnight-blocks
choose a brick that is at least 3 inches wide	( call SW.listValue ( call SW.filter ( call SW.getProperty ( call SW.singleton en.block ) ( string ! type ) ) ( call SW.ensureNumericProperty ( string width ) ) ( string >= ) ( call SW.ensureNumericEntity ( call SW.concat ( number 3 en.inch ) ( number 6 en.inch ) ) ) ) )	overnight-blocks
what is the height of an average block	( call SW.listValue ( call SW.aggregate ( string avg ) ( call SW.getProperty ( call SW.getProperty ( call SW.singleton en.block ) ( string ! type ) ) ( string height ) ) ) )	overnight-blocks
which brick is below the brick that is above brick 1	( call SW.listValue ( call SW.filter ( call SW.getProperty ( call SW.singleton en.block ) ( string ! type ) ) ( string below ) ( string = ) ( call SW.filter ( call SW.getProperty ( call SW.singleton en.block ) ( string ! type ) ) ( string above ) ( string = ) en.block.block1 ) ) )	overnight-blocks
choose a block above a 3 inch block	( call SW.listValue ( call SW.filter ( call SW.getProperty ( call SW.singleton en.block ) ( string ! type ) ) ( string above ) ( string = ) ( call SW.filter ( call SW.getProperty ( call SW.singleton en.block ) ( string ! type ) ) ( string height ) ( string = ) ( number 3 en.inch ) ) ) )	overnight-blocks
select the brick with the least blocks above it	( call SW.listValue ( call SW.countSuperlative ( call SW.getProperty ( call SW.singleton en.block ) ( string ! type ) ) ( string min ) ( call SW.reverse ( string above ) ) ( call SW.getProperty ( call SW.singleton en.block ) ( string ! type ) ) ) )	overnight-blocks
find me all blocks at least 3 inches wide	( call SW.listValue ( call SW.filter ( call SW.getProperty ( call SW.singleton en.block ) ( string ! type ) ) ( call SW.ensureNumericProperty ( string width ) ) ( string >= ) ( call SW.ensureNumericEntity ( number 3 en.inch ) ) ) )	overnight-blocks
find me all pyramid blocks right of block 1	( call SW.listValue ( call SW.filter ( call SW.filter ( call SW.getProperty ( call SW.singleton en.block ) ( string ! type ) ) ( string right ) ( string = ) en.block.block1 ) ( string shape ) ( string = ) en.shape.pyramid ) )	overnight-blocks
what block has a width of 3 inches and block 1 is to the right of	( call SW.listValue ( call SW.filter ( call SW.filter ( call SW.getProperty ( call SW.singleton en.block ) ( string ! type ) ) ( string width ) ( string = ) ( number 3 en.inch ) ) ( call SW.reverse ( string right ) ) ( string = ) en.block.block1 ) )	overnight-blocks
which block is only a single color	( call SW.listValue ( call SW.countComparative ( call SW.getProperty ( call SW.singleton en.block ) ( string ! type ) ) ( string color ) ( string < ) ( number 2 ) ) )	overnight-blocks
select the block whose width is 3 inches	( call SW.listValue ( call SW.filter ( call SW.getProperty ( call SW.singleton en.block ) ( string ! type ) ) ( call SW.reverse ( string left ) ) ( string = ) ( call SW.filter ( call SW.getProperty ( call SW.singleton en.block ) ( string ! type ) ) ( string width ) ( string = ) ( number 3 en.inch ) ) ) )	overnight-blocks
look right of block 1 and get the special block	( call SW.listValue ( call SW.filter ( call SW.filter ( call SW.getProperty ( call SW.singleton en.block ) ( string ! type ) ) ( string is_special ) ) ( call SW.reverse ( string left ) ) ( string = ) en.block.block1 ) )	overnight-blocks
right of special block	( call SW.listValue ( call SW.filter ( call SW.getProperty ( call SW.singleton en.block ) ( string ! type ) ) ( call SW.reverse ( string left ) ) ( string = ) ( call SW.filter ( call SW.getProperty ( call SW.singleton en.block ) ( string ! type ) ) ( string is_special ) ) ) )	overnight-blocks
what blocks are left of block 1 and 3 inches in height	( call SW.listValue ( call SW.filter ( call SW.filter ( call SW.getProperty ( call SW.singleton en.block ) ( string ! type ) ) ( string height ) ( string = ) ( number 3 en.inch ) ) ( string left ) ( string = ) en.block.block1 ) )	overnight-blocks
get me a block below and above block 1	( call SW.listValue ( call SW.filter ( call SW.filter ( call SW.getProperty ( call SW.singleton en.block ) ( string ! type ) ) ( string below ) ( string = ) en.block.block1 ) ( string above ) ( string = ) en.block.block1 ) )	overnight-blocks
select the brick that has the least blocks to the right of it	( call SW.listValue ( call SW.countSuperlative ( call SW.getProperty ( call SW.singleton en.block ) ( string ! type ) ) ( string min ) ( string left ) ( call SW.getProperty ( call SW.singleton en.block ) ( string ! type ) ) ) )	overnight-blocks
block whose length is larger than width of block 1	( call SW.listValue ( call SW.filter ( call SW.getProperty ( call SW.singleton en.block ) ( string ! type ) ) ( call SW.ensureNumericProperty ( string length ) ) ( string > ) ( call SW.ensureNumericEntity ( call SW.getProperty en.block.block1 ( string width ) ) ) ) )	overnight-blocks
find me all blocks left of 3 inch wide blocks	( call SW.listValue ( call SW.filter ( call SW.getProperty ( call SW.singleton en.block ) ( string ! type ) ) ( call SW.reverse ( string left ) ) ( string = ) ( call SW.filter ( call SW.getProperty ( call SW.singleton en.block ) ( string ! type ) ) ( string width ) ( string = ) ( number 3 en.inch ) ) ) )	overnight-blocks
find me all blocks above that block 1 is right of	( call SW.listValue ( call SW.filter ( call SW.getProperty ( call SW.singleton en.block ) ( string ! type ) ) ( string above ) ( string = ) ( call SW.filter ( call SW.getProperty ( call SW.singleton en.block ) ( string ! type ) ) ( call SW.reverse ( string right ) ) ( string = ) en.block.block1 ) ) )	overnight-blocks
what pyramidshaped brick is 3 inches long	( call SW.listValue ( call SW.filter ( call SW.filter ( call SW.getProperty ( call SW.singleton en.block ) ( string ! type ) ) ( string length ) ( string = ) ( number 3 en.inch ) ) ( string shape ) ( string = ) en.shape.pyramid ) )	overnight-blocks
find me all the blocks with the same width as the length of block 1	( call SW.listValue ( call SW.filter ( call SW.getProperty ( call SW.singleton en.block ) ( string ! type ) ) ( string width ) ( string = ) ( call SW.getProperty en.block.block1 ( string length ) ) ) )	overnight-blocks
is there a block to the left of more than two blocks	( call SW.listValue ( call SW.countComparative ( call SW.getProperty ( call SW.singleton en.block ) ( string ! type ) ) ( call SW.reverse ( string right ) ) ( string > ) ( number 2 ) ( call SW.getProperty ( call SW.singleton en.block ) ( string ! type ) ) ) )	overnight-blocks
what is the total width of the brick	( call SW.listValue ( call SW.aggregate ( string sum ) ( call SW.getProperty ( call SW.getProperty ( call SW.singleton en.block ) ( string ! type ) ) ( string width ) ) ) )	overnight-blocks
find me the block that is left of two blocks	( call SW.listValue ( call SW.countComparative ( call SW.getProperty ( call SW.singleton en.block ) ( string ! type ) ) ( string left ) ( string = ) ( number 2 ) ( call SW.getProperty ( call SW.singleton en.block ) ( string ! type ) ) ) )	overnight-blocks
block whose width is smaller than height of block 1	( call SW.listValue ( call SW.filter ( call SW.getProperty ( call SW.singleton en.block ) ( string ! type ) ) ( call SW.ensureNumericProperty ( string width ) ) ( string < ) ( call SW.ensureNumericEntity ( call SW.getProperty en.block.block1 ( string height ) ) ) ) )	overnight-blocks
block whose length is at least 3 inches or 6 inches	( call SW.listValue ( call SW.filter ( call SW.getProperty ( call SW.singleton en.block ) ( string ! type ) ) ( call SW.ensureNumericProperty ( string length ) ) ( string >= ) ( call SW.ensureNumericEntity ( call SW.concat ( number 3 en.inch ) ( number 6 en.inch ) ) ) ) )	overnight-blocks
what block is above the 3 inch high block	( call SW.listValue ( call SW.filter ( call SW.getProperty ( call SW.singleton en.block ) ( string ! type ) ) ( string above ) ( string = ) ( call SW.filter ( call SW.getProperty ( call SW.singleton en.block ) ( string ! type ) ) ( string height ) ( string = ) ( number 3 en.inch ) ) ) )	overnight-blocks
find me all blocks above that is left of block 1	( call SW.listValue ( call SW.filter ( call SW.filter ( call SW.getProperty ( call SW.singleton en.block ) ( string ! type ) ) ( string left ) ( string = ) en.block.block1 ) ( call SW.reverse ( string above ) ) ( string = ) en.block.block1 ) )	overnight-blocks
what block is block 1 below and to the left of	( call SW.listValue ( call SW.filter ( call SW.filter ( call SW.getProperty ( call SW.singleton en.block ) ( string ! type ) ) ( call SW.reverse ( string below ) ) ( string = ) en.block.block1 ) ( call SW.reverse ( string left ) ) ( string = ) en.block.block1 ) )	overnight-blocks
block with more than two shapes	( call SW.listValue ( call SW.countComparative ( call SW.getProperty ( call SW.singleton en.block ) ( string ! type ) ) ( string shape ) ( string > ) ( number 2 ) ) )	overnight-blocks
find the block that is to the right of block 1	( call SW.listValue ( call SW.filter ( call SW.filter ( call SW.getProperty ( call SW.singleton en.block ) ( string ! type ) ) ( call SW.reverse ( string right ) ) ( string = ) en.block.block1 ) ( string right ) ( string = ) en.block.block1 ) )	overnight-blocks
find me all the blocks right of the pyramid block	( call SW.listValue ( call SW.filter ( call SW.getProperty ( call SW.singleton en.block ) ( string ! type ) ) ( string right ) ( string = ) ( call SW.filter ( call SW.getProperty ( call SW.singleton en.block ) ( string ! type ) ) ( string shape ) ( string = ) en.shape.pyramid ) ) )	overnight-blocks
which block is at least 3 or 6 inches long	( call SW.listValue ( call SW.filter ( call SW.getProperty ( call SW.singleton en.block ) ( string ! type ) ) ( call SW.ensureNumericProperty ( string length ) ) ( string >= ) ( call SW.ensureNumericEntity ( call SW.concat ( number 3 en.inch ) ( number 6 en.inch ) ) ) ) )	overnight-blocks
block that is below block 1 or block 2	( call SW.listValue ( call SW.filter ( call SW.getProperty ( call SW.singleton en.block ) ( string ! type ) ) ( string below ) ( string = ) ( call SW.concat en.block.block1 en.block.block2 ) ) )	overnight-blocks
locate a block that is no wider than the height of block 1	( call SW.listValue ( call SW.filter ( call SW.getProperty ( call SW.singleton en.block ) ( string ! type ) ) ( call SW.ensureNumericProperty ( string width ) ) ( string <= ) ( call SW.ensureNumericEntity ( call SW.getProperty en.block.block1 ( string height ) ) ) ) )	overnight-blocks
find me all blocks shorter than 3 inches	( call SW.listValue ( call SW.filter ( call SW.getProperty ( call SW.singleton en.block ) ( string ! type ) ) ( call SW.ensureNumericProperty ( string length ) ) ( string < ) ( call SW.ensureNumericEntity ( number 3 en.inch ) ) ) )	overnight-blocks
what block is above two blocks	( call SW.listValue ( call SW.countComparative ( call SW.getProperty ( call SW.singleton en.block ) ( string ! type ) ) ( string above ) ( string = ) ( number 2 ) ( call SW.getProperty ( call SW.singleton en.block ) ( string ! type ) ) ) )	overnight-blocks
what brick is at least as high as brick 1	( call SW.listValue ( call SW.filter ( call SW.getProperty ( call SW.singleton en.block ) ( string ! type ) ) ( call SW.ensureNumericProperty ( string height ) ) ( string >= ) ( call SW.ensureNumericEntity ( call SW.getProperty en.block.block1 ( string height ) ) ) ) )	overnight-blocks
find me all blocks shorter than the width of block 1	( call SW.listValue ( call SW.filter ( call SW.getProperty ( call SW.singleton en.block ) ( string ! type ) ) ( call SW.ensureNumericProperty ( string height ) ) ( string < ) ( call SW.ensureNumericEntity ( call SW.getProperty en.block.block1 ( string width ) ) ) ) )	overnight-blocks
find the block to the left of the largest number of blocks	( call SW.listValue ( call SW.countSuperlative ( call SW.getProperty ( call SW.singleton en.block ) ( string ! type ) ) ( string max ) ( string left ) ( call SW.getProperty ( call SW.singleton en.block ) ( string ! type ) ) ) )	overnight-blocks
find me all special blocks that is below	( call SW.listValue ( call SW.filter ( call SW.getProperty ( call SW.singleton en.block ) ( string ! type ) ) ( call SW.reverse ( string below ) ) ( string = ) ( call SW.filter ( call SW.getProperty ( call SW.singleton en.block ) ( string ! type ) ) ( string is_special ) ) ) )	overnight-blocks
find me all pyramid blocks left of block 1	( call SW.listValue ( call SW.filter ( call SW.filter ( call SW.getProperty ( call SW.singleton en.block ) ( string ! type ) ) ( string left ) ( string = ) en.block.block1 ) ( string shape ) ( string = ) en.shape.pyramid ) )	overnight-blocks
find me all blocks that block 1 is right and below	( call SW.listValue ( call SW.filter ( call SW.getProperty ( call SW.singleton en.block ) ( string ! type ) ) ( call SW.reverse ( string below ) ) ( string = ) ( call SW.filter ( call SW.getProperty ( call SW.singleton en.block ) ( string ! type ) ) ( call SW.reverse ( string right ) ) ( string = ) en.block.block1 ) ) )	overnight-blocks
block right of at least two block	( call SW.listValue ( call SW.countComparative ( call SW.getProperty ( call SW.singleton en.block ) ( string ! type ) ) ( string right ) ( string >= ) ( number 2 ) ( call SW.getProperty ( call SW.singleton en.block ) ( string ! type ) ) ) )	overnight-blocks
which block is above and to the right of block 1	( call SW.listValue ( call SW.filter ( call SW.getProperty ( call SW.singleton en.block ) ( string ! type ) ) ( call SW.reverse ( string right ) ) ( string = ) ( call SW.filter ( call SW.getProperty ( call SW.singleton en.block ) ( string ! type ) ) ( string above ) ( string = ) en.block.block1 ) ) )	overnight-blocks
choose block underneath block under block 1	( call SW.listValue ( call SW.filter ( call SW.getProperty ( call SW.singleton en.block ) ( string ! type ) ) ( string below ) ( string = ) ( call SW.filter ( call SW.getProperty ( call SW.singleton en.block ) ( string ! type ) ) ( string below ) ( string = ) en.block.block1 ) ) )	overnight-blocks
select all which is 3 inches in width and pyramid in shape	( call SW.listValue ( call SW.filter ( call SW.filter ( call SW.getProperty ( call SW.singleton en.block ) ( string ! type ) ) ( string width ) ( string = ) ( number 3 en.inch ) ) ( string shape ) ( string = ) en.shape.pyramid ) )	overnight-blocks
find me all blocks that block 1 is not right of	( call SW.listValue ( call SW.filter ( call SW.getProperty ( call SW.singleton en.block ) ( string ! type ) ) ( call SW.reverse ( string right ) ) ( string ! = ) en.block.block1 ) )	overnight-blocks
which brick is longer than brick 1	( call SW.listValue ( call SW.filter ( call SW.getProperty ( call SW.singleton en.block ) ( string ! type ) ) ( call SW.ensureNumericProperty ( string length ) ) ( string > ) ( call SW.ensureNumericEntity ( call SW.getProperty en.block.block1 ( string length ) ) ) ) )	overnight-blocks
block that is below block that is left of block 1	( call SW.listValue ( call SW.filter ( call SW.getProperty ( call SW.singleton en.block ) ( string ! type ) ) ( string below ) ( string = ) ( call SW.filter ( call SW.getProperty ( call SW.singleton en.block ) ( string ! type ) ) ( string left ) ( string = ) en.block.block1 ) ) )	overnight-blocks
choose the block below block 1 that is 3 inches long	( call SW.listValue ( call SW.filter ( call SW.filter ( call SW.getProperty ( call SW.singleton en.block ) ( string ! type ) ) ( string below ) ( string = ) en.block.block1 ) ( string length ) ( string = ) ( number 3 en.inch ) ) )	overnight-blocks
the blocks under block 2 are smaller	( call SW.listValue ( call SW.countComparative ( call SW.getProperty ( call SW.singleton en.block ) ( string ! type ) ) ( call SW.reverse ( string below ) ) ( string < ) ( number 2 ) ( call SW.getProperty ( call SW.singleton en.block ) ( string ! type ) ) ) )	overnight-blocks
block as long as block 1 is wide	( call SW.listValue ( call SW.filter ( call SW.getProperty ( call SW.singleton en.block ) ( string ! type ) ) ( string length ) ( string = ) ( call SW.getProperty en.block.block1 ( string width ) ) ) )	overnight-blocks
which block is to the left of the block that block 1 is below	( call SW.listValue ( call SW.filter ( call SW.getProperty ( call SW.singleton en.block ) ( string ! type ) ) ( string left ) ( string = ) ( call SW.filter ( call SW.getProperty ( call SW.singleton en.block ) ( string ! type ) ) ( call SW.reverse ( string below ) ) ( string = ) en.block.block1 ) ) )	overnight-blocks
what block is to the right of block 1	( call SW.listValue ( call SW.filter ( call SW.filter ( call SW.getProperty ( call SW.singleton en.block ) ( string ! type ) ) ( call SW.reverse ( string left ) ) ( string = ) en.block.block1 ) ( string right ) ( string = ) en.block.block1 ) )	overnight-blocks
find me all blocks to the right and above block 1	( call SW.listValue ( call SW.filter ( call SW.filter ( call SW.getProperty ( call SW.singleton en.block ) ( string ! type ) ) ( string right ) ( string = ) en.block.block1 ) ( call SW.reverse ( string below ) ) ( string = ) en.block.block1 ) )	overnight-blocks
which brick is below the brick to the right of brick 1	( call SW.listValue ( call SW.filter ( call SW.getProperty ( call SW.singleton en.block ) ( string ! type ) ) ( string below ) ( string = ) ( call SW.filter ( call SW.getProperty ( call SW.singleton en.block ) ( string ! type ) ) ( string right ) ( string = ) en.block.block1 ) ) )	overnight-blocks
locate the block that has a shape other than that of a pyramid	( call SW.listValue ( call SW.filter ( call SW.getProperty ( call SW.singleton en.block ) ( string ! type ) ) ( string shape ) ( string ! = ) en.shape.pyramid ) )	overnight-blocks
look below and right of block 1	( call SW.listValue ( call SW.filter ( call SW.filter ( call SW.getProperty ( call SW.singleton en.block ) ( string ! type ) ) ( string right ) ( string = ) en.block.block1 ) ( string below ) ( string = ) en.block.block1 ) )	overnight-blocks
block whose shape is a pyramid and that is special	( call SW.listValue ( call SW.filter ( call SW.filter ( call SW.getProperty ( call SW.singleton en.block ) ( string ! type ) ) ( string shape ) ( string = ) en.shape.pyramid ) ( string is_special ) ) )	overnight-blocks
choose the most shapeless block	( call SW.listValue ( call SW.countSuperlative ( call SW.getProperty ( call SW.singleton en.block ) ( string ! type ) ) ( string min ) ( string shape ) ) )	overnight-blocks
which brick is to the right of the pyramidshaped brick	( call SW.listValue ( call SW.filter ( call SW.getProperty ( call SW.singleton en.block ) ( string ! type ) ) ( string right ) ( string = ) ( call SW.filter ( call SW.getProperty ( call SW.singleton en.block ) ( string ! type ) ) ( string shape ) ( string = ) en.shape.pyramid ) ) )	overnight-blocks
what block is above and to the left of block 1 	( call SW.listValue ( call SW.filter ( call SW.filter ( call SW.getProperty ( call SW.singleton en.block ) ( string ! type ) ) ( string above ) ( string = ) en.block.block1 ) ( call SW.reverse ( string left ) ) ( string = ) en.block.block1 ) )	overnight-blocks
special block to right of block 1	( call SW.listValue ( call SW.filter ( call SW.filter ( call SW.getProperty ( call SW.singleton en.block ) ( string ! type ) ) ( string right ) ( string = ) en.block.block1 ) ( string is_special ) ) )	overnight-blocks
3 inches high block below block 1	( call SW.listValue ( call SW.filter ( call SW.filter ( call SW.getProperty ( call SW.singleton en.block ) ( string ! type ) ) ( string height ) ( string = ) ( number 3 en.inch ) ) ( string below ) ( string = ) en.block.block1 ) )	overnight-blocks
block 3 inches long and below block one	( call SW.listValue ( call SW.filter ( call SW.filter ( call SW.getProperty ( call SW.singleton en.block ) ( string ! type ) ) ( string length ) ( string = ) ( number 3 en.inch ) ) ( call SW.reverse ( string below ) ) ( string = ) en.block.block1 ) )	overnight-blocks
see block below block 1 and choose the one left of it	( call SW.listValue ( call SW.filter ( call SW.getProperty ( call SW.singleton en.block ) ( string ! type ) ) ( string left ) ( string = ) ( call SW.filter ( call SW.getProperty ( call SW.singleton en.block ) ( string ! type ) ) ( call SW.reverse ( string above ) ) ( string = ) en.block.block1 ) ) )	overnight-blocks
2 blocks right of block 1	( call SW.listValue ( call SW.filter ( call SW.getProperty ( call SW.singleton en.block ) ( string ! type ) ) ( string left ) ( string = ) ( call SW.filter ( call SW.getProperty ( call SW.singleton en.block ) ( string ! type ) ) ( string right ) ( string = ) en.block.block1 ) ) )	overnight-blocks
block left of block above block 1	( call SW.listValue ( call SW.filter ( call SW.getProperty ( call SW.singleton en.block ) ( string ! type ) ) ( call SW.reverse ( string below ) ) ( string = ) ( call SW.filter ( call SW.getProperty ( call SW.singleton en.block ) ( string ! type ) ) ( string left ) ( string = ) en.block.block1 ) ) )	overnight-blocks
find the block above the least blocks	( call SW.listValue ( call SW.countSuperlative ( call SW.getProperty ( call SW.singleton en.block ) ( string ! type ) ) ( string min ) ( call SW.reverse ( string below ) ) ( call SW.getProperty ( call SW.singleton en.block ) ( string ! type ) ) ) )	overnight-blocks
which block is the smallest	( call SW.listValue ( call SW.superlative ( call SW.getProperty ( call SW.singleton en.block ) ( string ! type ) ) ( string min ) ( call SW.ensureNumericProperty ( string height ) ) ) )	overnight-blocks
find me all special blocks that are above	( call SW.listValue ( call SW.filter ( call SW.getProperty ( call SW.singleton en.block ) ( string ! type ) ) ( call SW.reverse ( string above ) ) ( string = ) ( call SW.filter ( call SW.getProperty ( call SW.singleton en.block ) ( string ! type ) ) ( string is_special ) ) ) )	overnight-blocks
block to the left of a block that block 1 is left of	( call SW.listValue ( call SW.filter ( call SW.getProperty ( call SW.singleton en.block ) ( string ! type ) ) ( string left ) ( string = ) ( call SW.filter ( call SW.getProperty ( call SW.singleton en.block ) ( string ! type ) ) ( call SW.reverse ( string left ) ) ( string = ) en.block.block1 ) ) )	overnight-blocks
which brick has a width smaller than 3 inches	( call SW.listValue ( call SW.filter ( call SW.getProperty ( call SW.singleton en.block ) ( string ! type ) ) ( call SW.ensureNumericProperty ( string width ) ) ( string < ) ( call SW.ensureNumericEntity ( number 3 en.inch ) ) ) )	overnight-blocks
block above block 1	( call SW.listValue ( call SW.filter ( call SW.filter ( call SW.getProperty ( call SW.singleton en.block ) ( string ! type ) ) ( string above ) ( string = ) en.block.block1 ) ( call SW.reverse ( string below ) ) ( string = ) en.block.block1 ) )	overnight-blocks
find me the block that block 1 is to the right and above	( call SW.listValue ( call SW.filter ( call SW.filter ( call SW.getProperty ( call SW.singleton en.block ) ( string ! type ) ) ( call SW.reverse ( string above ) ) ( string = ) en.block.block1 ) ( string right ) ( string = ) en.block.block1 ) )	overnight-blocks
find me all blocks that above and below block 1	( call SW.listValue ( call SW.filter ( call SW.filter ( call SW.getProperty ( call SW.singleton en.block ) ( string ! type ) ) ( call SW.reverse ( string above ) ) ( string = ) en.block.block1 ) ( call SW.reverse ( string below ) ) ( string = ) en.block.block1 ) )	overnight-blocks
block below block that is above block 1	( call SW.listValue ( call SW.filter ( call SW.getProperty ( call SW.singleton en.block ) ( string ! type ) ) ( string below ) ( string = ) ( call SW.filter ( call SW.getProperty ( call SW.singleton en.block ) ( string ! type ) ) ( string above ) ( string = ) en.block.block1 ) ) )	overnight-blocks
find the block that is not less than 3 inches tall	( call SW.listValue ( call SW.filter ( call SW.getProperty ( call SW.singleton en.block ) ( string ! type ) ) ( call SW.ensureNumericProperty ( string height ) ) ( string >= ) ( call SW.ensureNumericEntity ( number 3 en.inch ) ) ) )	overnight-blocks
blocks of more than two colours	( call SW.listValue ( call SW.countComparative ( call SW.getProperty ( call SW.singleton en.block ) ( string ! type ) ) ( string color ) ( string > ) ( number 2 ) ) )	overnight-blocks
is there a block on the right side of block 1	( call SW.listValue ( call SW.filter ( call SW.filter ( call SW.getProperty ( call SW.singleton en.block ) ( string ! type ) ) ( string right ) ( string = ) en.block.block1 ) ( string right ) ( string = ) en.block.block1 ) )	overnight-blocks
above and left of block 1	( call SW.listValue ( call SW.filter ( call SW.filter ( call SW.getProperty ( call SW.singleton en.block ) ( string ! type ) ) ( call SW.reverse ( string below ) ) ( string = ) en.block.block1 ) ( call SW.reverse ( string right ) ) ( string = ) en.block.block1 ) )	overnight-blocks
what pyramidshaped block is to the right of block 1	( call SW.listValue ( call SW.filter ( call SW.filter ( call SW.getProperty ( call SW.singleton en.block ) ( string ! type ) ) ( string shape ) ( string = ) en.shape.pyramid ) ( string right ) ( string = ) en.block.block1 ) )	overnight-blocks
block right of block which is left of block 1	( call SW.listValue ( call SW.filter ( call SW.getProperty ( call SW.singleton en.block ) ( string ! type ) ) ( string right ) ( string = ) ( call SW.filter ( call SW.getProperty ( call SW.singleton en.block ) ( string ! type ) ) ( string left ) ( string = ) en.block.block1 ) ) )	overnight-blocks
select all bricks that are not 3 inches wide	( call SW.listValue ( call SW.filter ( call SW.getProperty ( call SW.singleton en.block ) ( string ! type ) ) ( string width ) ( string ! = ) ( number 3 en.inch ) ) )	overnight-blocks
select the blocks to the left of and above block 1	( call SW.listValue ( call SW.filter ( call SW.filter ( call SW.getProperty ( call SW.singleton en.block ) ( string ! type ) ) ( call SW.reverse ( string right ) ) ( string = ) en.block.block1 ) ( string above ) ( string = ) en.block.block1 ) )	overnight-blocks
find all special blocks to the right of block 1 	( call SW.listValue ( call SW.filter ( call SW.filter ( call SW.getProperty ( call SW.singleton en.block ) ( string ! type ) ) ( string right ) ( string = ) en.block.block1 ) ( string is_special ) ) )	overnight-blocks
find me all the bricks at least as wide as block 1 is tall	( call SW.listValue ( call SW.filter ( call SW.getProperty ( call SW.singleton en.block ) ( string ! type ) ) ( call SW.ensureNumericProperty ( string width ) ) ( string >= ) ( call SW.ensureNumericEntity ( call SW.getProperty en.block.block1 ( string height ) ) ) ) )	overnight-blocks
find me all the blocks longer than block 1	( call SW.listValue ( call SW.filter ( call SW.getProperty ( call SW.singleton en.block ) ( string ! type ) ) ( call SW.ensureNumericProperty ( string length ) ) ( string > ) ( call SW.ensureNumericEntity ( call SW.getProperty en.block.block1 ( string length ) ) ) ) )	overnight-blocks
choose a block between 3 or 6 inches	( call SW.listValue ( call SW.concat ( number 3 en.inch ) ( number 6 en.inch ) ) )	overnight-blocks
find all blocks that are as long as or longer than block 1	( call SW.listValue ( call SW.filter ( call SW.getProperty ( call SW.singleton en.block ) ( string ! type ) ) ( call SW.ensureNumericProperty ( string width ) ) ( string >= ) ( call SW.ensureNumericEntity ( call SW.getProperty en.block.block1 ( string length ) ) ) ) )	overnight-blocks
select the block to the left of the block above block 1	( call SW.listValue ( call SW.filter ( call SW.getProperty ( call SW.singleton en.block ) ( string ! type ) ) ( call SW.reverse ( string right ) ) ( string = ) ( call SW.filter ( call SW.getProperty ( call SW.singleton en.block ) ( string ! type ) ) ( string above ) ( string = ) en.block.block1 ) ) )	overnight-blocks
select the brick below and to the right of block 1	( call SW.listValue ( call SW.filter ( call SW.getProperty ( call SW.singleton en.block ) ( string ! type ) ) ( string below ) ( string = ) ( call SW.filter ( call SW.getProperty ( call SW.singleton en.block ) ( string ! type ) ) ( string right ) ( string = ) en.block.block1 ) ) )	overnight-blocks
what block is to the left of more than two blocks	( call SW.listValue ( call SW.countComparative ( call SW.getProperty ( call SW.singleton en.block ) ( string ! type ) ) ( string left ) ( string > ) ( number 2 ) ( call SW.getProperty ( call SW.singleton en.block ) ( string ! type ) ) ) )	overnight-blocks
find me all blocks at most 3 inches wide	( call SW.listValue ( call SW.filter ( call SW.getProperty ( call SW.singleton en.block ) ( string ! type ) ) ( call SW.ensureNumericProperty ( string width ) ) ( string <= ) ( call SW.ensureNumericEntity ( number 3 en.inch ) ) ) )	overnight-blocks
find me all blocks longer than 3 inches	( call SW.listValue ( call SW.filter ( call SW.getProperty ( call SW.singleton en.block ) ( string ! type ) ) ( call SW.ensureNumericProperty ( string length ) ) ( string > ) ( call SW.ensureNumericEntity ( number 3 en.inch ) ) ) )	overnight-blocks
select a special pyramid block	( call SW.listValue ( call SW.filter ( call SW.filter ( call SW.getProperty ( call SW.singleton en.block ) ( string ! type ) ) ( string shape ) ( string = ) en.shape.pyramid ) ( string is_special ) ) )	overnight-blocks
find a block that block 1 is longer than	( call SW.listValue ( call SW.filter ( call SW.getProperty ( call SW.singleton en.block ) ( string ! type ) ) ( call SW.ensureNumericProperty ( string length ) ) ( string < ) ( call SW.ensureNumericEntity ( call SW.getProperty en.block.block1 ( string length ) ) ) ) )	overnight-blocks
find blocks above block 1 or block 2	( call SW.listValue ( call SW.filter ( call SW.getProperty ( call SW.singleton en.block ) ( string ! type ) ) ( call SW.reverse ( string below ) ) ( string = ) ( call SW.concat en.block.block1 en.block.block2 ) ) )	overnight-blocks
which brick is at most 3 or 6 inches long	( call SW.listValue ( call SW.filter ( call SW.getProperty ( call SW.singleton en.block ) ( string ! type ) ) ( call SW.ensureNumericProperty ( string length ) ) ( string <= ) ( call SW.ensureNumericEntity ( call SW.concat ( number 3 en.inch ) ( number 6 en.inch ) ) ) ) )	overnight-blocks
find me all blocks left of block 1 or 2	( call SW.listValue ( call SW.filter ( call SW.getProperty ( call SW.singleton en.block ) ( string ! type ) ) ( string left ) ( string = ) ( call SW.concat en.block.block1 en.block.block2 ) ) )	overnight-blocks
what brick is to the right of the 3 inch brick	( call SW.listValue ( call SW.filter ( call SW.getProperty ( call SW.singleton en.block ) ( string ! type ) ) ( string right ) ( string = ) ( call SW.filter ( call SW.getProperty ( call SW.singleton en.block ) ( string ! type ) ) ( string length ) ( string = ) ( number 3 en.inch ) ) ) )	overnight-blocks
what 3 inch brick is to the right of brick 1	( call SW.listValue ( call SW.filter ( call SW.filter ( call SW.getProperty ( call SW.singleton en.block ) ( string ! type ) ) ( string right ) ( string = ) en.block.block1 ) ( string length ) ( string = ) ( number 3 en.inch ) ) )	overnight-blocks
select the block that block 1 is not below it	( call SW.listValue ( call SW.filter ( call SW.getProperty ( call SW.singleton en.block ) ( string ! type ) ) ( string above ) ( string ! = ) en.block.block1 ) )	overnight-blocks
block with maximum two colors	( call SW.listValue ( call SW.countComparative ( call SW.getProperty ( call SW.singleton en.block ) ( string ! type ) ) ( string color ) ( string <= ) ( number 2 ) ) )	overnight-blocks
what block is 3 or less inches tall	( call SW.listValue ( call SW.filter ( call SW.getProperty ( call SW.singleton en.block ) ( string ! type ) ) ( call SW.ensureNumericProperty ( string height ) ) ( string <= ) ( call SW.ensureNumericEntity ( number 3 en.inch ) ) ) )	overnight-blocks
find me the block that is to the left and below block 1	( call SW.listValue ( call SW.filter ( call SW.filter ( call SW.getProperty ( call SW.singleton en.block ) ( string ! type ) ) ( call SW.reverse ( string right ) ) ( string = ) en.block.block1 ) ( call SW.reverse ( string above ) ) ( string = ) en.block.block1 ) )	overnight-blocks
find me all the pyramid or cube bricks	( call SW.listValue ( call SW.filter ( call SW.getProperty ( call SW.singleton en.block ) ( string ! type ) ) ( string shape ) ( string = ) ( call SW.concat en.shape.pyramid en.shape.cube ) ) )	overnight-blocks
choose block with pyramid shape under block 1	( call SW.listValue ( call SW.filter ( call SW.filter ( call SW.getProperty ( call SW.singleton en.block ) ( string ! type ) ) ( string shape ) ( string = ) en.shape.pyramid ) ( string below ) ( string = ) en.block.block1 ) )	overnight-blocks
what block is to the right and above block 1	( call SW.listValue ( call SW.filter ( call SW.filter ( call SW.getProperty ( call SW.singleton en.block ) ( string ! type ) ) ( string right ) ( string = ) en.block.block1 ) ( call SW.reverse ( string below ) ) ( string = ) en.block.block1 ) )	overnight-blocks
block whose length is minimum the height of block 1	( call SW.listValue ( call SW.filter ( call SW.getProperty ( call SW.singleton en.block ) ( string ! type ) ) ( call SW.ensureNumericProperty ( string length ) ) ( string >= ) ( call SW.ensureNumericEntity ( call SW.getProperty en.block.block1 ( string height ) ) ) ) )	overnight-blocks
what block is to the left of the 3 inch tall block	( call SW.listValue ( call SW.filter ( call SW.getProperty ( call SW.singleton en.block ) ( string ! type ) ) ( string left ) ( string = ) ( call SW.filter ( call SW.getProperty ( call SW.singleton en.block ) ( string ! type ) ) ( string height ) ( string = ) ( number 3 en.inch ) ) ) )	overnight-blocks
which block is at least as high as block 1 is wide	( call SW.listValue ( call SW.filter ( call SW.getProperty ( call SW.singleton en.block ) ( string ! type ) ) ( call SW.ensureNumericProperty ( string height ) ) ( string >= ) ( call SW.ensureNumericEntity ( call SW.getProperty en.block.block1 ( string width ) ) ) ) )	overnight-blocks
what block is to the left of block one	( call SW.listValue ( call SW.filter ( call SW.filter ( call SW.getProperty ( call SW.singleton en.block ) ( string ! type ) ) ( string left ) ( string = ) en.block.block1 ) ( string left ) ( string = ) en.block.block1 ) )	overnight-blocks
find me all the blocks at most as long as the width of block 1	( call SW.listValue ( call SW.filter ( call SW.getProperty ( call SW.singleton en.block ) ( string ! type ) ) ( call SW.ensureNumericProperty ( string length ) ) ( string <= ) ( call SW.ensureNumericEntity ( call SW.getProperty en.block.block1 ( string width ) ) ) ) )	overnight-blocks
left of block over block 1	( call SW.listValue ( call SW.filter ( call SW.getProperty ( call SW.singleton en.block ) ( string ! type ) ) ( string left ) ( string = ) ( call SW.filter ( call SW.getProperty ( call SW.singleton en.block ) ( string ! type ) ) ( string above ) ( string = ) en.block.block1 ) ) )	overnight-blocks
find me all blocks left of 3 inch blocks	( call SW.listValue ( call SW.filter ( call SW.getProperty ( call SW.singleton en.block ) ( string ! type ) ) ( string left ) ( string = ) ( call SW.filter ( call SW.getProperty ( call SW.singleton en.block ) ( string ! type ) ) ( string length ) ( string = ) ( number 3 en.inch ) ) ) )	overnight-blocks
left of block 1	( call SW.listValue ( call SW.filter ( call SW.filter ( call SW.getProperty ( call SW.singleton en.block ) ( string ! type ) ) ( string left ) ( string = ) en.block.block1 ) ( call SW.reverse ( string left ) ) ( string = ) en.block.block1 ) )	overnight-blocks
is there a block located to the left of another block that is 3 inches long	( call SW.listValue ( call SW.filter ( call SW.getProperty ( call SW.singleton en.block ) ( string ! type ) ) ( string left ) ( string = ) ( call SW.filter ( call SW.getProperty ( call SW.singleton en.block ) ( string ! type ) ) ( string length ) ( string = ) ( number 3 en.inch ) ) ) )	overnight-blocks
block whose length is 3 inches or 6 inches	( call SW.listValue ( call SW.filter ( call SW.getProperty ( call SW.singleton en.block ) ( string ! type ) ) ( string length ) ( string = ) ( call SW.concat ( number 3 en.inch ) ( number 6 en.inch ) ) ) )	overnight-blocks
find me all blocks right of 3 inch tall blocks	( call SW.listValue ( call SW.filter ( call SW.getProperty ( call SW.singleton en.block ) ( string ! type ) ) ( call SW.reverse ( string right ) ) ( string = ) ( call SW.filter ( call SW.getProperty ( call SW.singleton en.block ) ( string ! type ) ) ( string height ) ( string = ) ( number 3 en.inch ) ) ) )	overnight-blocks
what block has two or less shapes	( call SW.listValue ( call SW.countComparative ( call SW.getProperty ( call SW.singleton en.block ) ( string ! type ) ) ( string shape ) ( string <= ) ( number 2 ) ) )	overnight-blocks
find me a block below at least two blocks	( call SW.listValue ( call SW.countComparative ( call SW.getProperty ( call SW.singleton en.block ) ( string ! type ) ) ( call SW.reverse ( string above ) ) ( string >= ) ( number 2 ) ( call SW.getProperty ( call SW.singleton en.block ) ( string ! type ) ) ) )	overnight-blocks
find me the block that has a length of 3 inches	( call SW.listValue ( call SW.filter ( call SW.getProperty ( call SW.singleton en.block ) ( string ! type ) ) ( call SW.reverse ( string below ) ) ( string = ) ( call SW.filter ( call SW.getProperty ( call SW.singleton en.block ) ( string ! type ) ) ( string length ) ( string = ) ( number 3 en.inch ) ) ) )	overnight-blocks
look right of block 1 and find 3 inch block	( call SW.listValue ( call SW.filter ( call SW.filter ( call SW.getProperty ( call SW.singleton en.block ) ( string ! type ) ) ( string length ) ( string = ) ( number 3 en.inch ) ) ( call SW.reverse ( string left ) ) ( string = ) en.block.block1 ) )	overnight-blocks
select the block above block 1 and on the left side	( call SW.listValue ( call SW.filter ( call SW.filter ( call SW.getProperty ( call SW.singleton en.block ) ( string ! type ) ) ( call SW.reverse ( string right ) ) ( string = ) en.block.block1 ) ( call SW.reverse ( string above ) ) ( string = ) en.block.block1 ) )	overnight-blocks
find me a block with the same width as block 1s length	( call SW.listValue ( call SW.filter ( call SW.getProperty ( call SW.singleton en.block ) ( string ! type ) ) ( string width ) ( string = ) ( call SW.getProperty en.block.block1 ( string length ) ) ) )	overnight-blocks
what block is above block 1 and has a height of 3 inches	( call SW.listValue ( call SW.filter ( call SW.filter ( call SW.getProperty ( call SW.singleton en.block ) ( string ! type ) ) ( call SW.reverse ( string above ) ) ( string = ) en.block.block1 ) ( string height ) ( string = ) ( number 3 en.inch ) ) )	overnight-blocks
find a pyramidshaped block with a 3 inch height	( call SW.listValue ( call SW.filter ( call SW.filter ( call SW.getProperty ( call SW.singleton en.block ) ( string ! type ) ) ( string shape ) ( string = ) en.shape.pyramid ) ( string height ) ( string = ) ( number 3 en.inch ) ) )	overnight-blocks
find me all blocks with 2 blocks below it	( call SW.listValue ( call SW.countComparative ( call SW.getProperty ( call SW.singleton en.block ) ( string ! type ) ) ( call SW.reverse ( string below ) ) ( string = ) ( number 2 ) ( call SW.getProperty ( call SW.singleton en.block ) ( string ! type ) ) ) )	overnight-blocks
what is the height of block 1	( call SW.listValue ( call SW.getProperty en.block.block1 ( string height ) ) )	overnight-blocks
which brick is closest to the bottom	( call SW.listValue ( call SW.countSuperlative ( call SW.getProperty ( call SW.singleton en.block ) ( string ! type ) ) ( string min ) ( string above ) ( call SW.getProperty ( call SW.singleton en.block ) ( string ! type ) ) ) )	overnight-blocks
find me all blocks with less than 2 colors	( call SW.listValue ( call SW.countComparative ( call SW.getProperty ( call SW.singleton en.block ) ( string ! type ) ) ( string color ) ( string < ) ( number 2 ) ) )	overnight-blocks
what block is left and below block 1	( call SW.listValue ( call SW.filter ( call SW.filter ( call SW.getProperty ( call SW.singleton en.block ) ( string ! type ) ) ( string left ) ( string = ) en.block.block1 ) ( string below ) ( string = ) en.block.block1 ) )	overnight-blocks
which blocks have a height equal to the width of block 1	( call SW.listValue ( call SW.filter ( call SW.getProperty ( call SW.singleton en.block ) ( string ! type ) ) ( string height ) ( string = ) ( call SW.getProperty en.block.block1 ( string width ) ) ) )	overnight-blocks
block whose height is smaller than 3 inches	( call SW.listValue ( call SW.filter ( call SW.getProperty ( call SW.singleton en.block ) ( string ! type ) ) ( call SW.ensureNumericProperty ( string height ) ) ( string < ) ( call SW.ensureNumericEntity ( number 3 en.inch ) ) ) )	overnight-blocks
what block has block 1 at its left and right	( call SW.listValue ( call SW.filter ( call SW.filter ( call SW.getProperty ( call SW.singleton en.block ) ( string ! type ) ) ( string right ) ( string = ) en.block.block1 ) ( call SW.reverse ( string right ) ) ( string = ) en.block.block1 ) )	overnight-blocks
find me all blocks 3 inch long right of block 1	( call SW.listValue ( call SW.filter ( call SW.filter ( call SW.getProperty ( call SW.singleton en.block ) ( string ! type ) ) ( string length ) ( string = ) ( number 3 en.inch ) ) ( string right ) ( string = ) en.block.block1 ) )	overnight-blocks
what block is to the right of more than two blocks	( call SW.listValue ( call SW.countComparative ( call SW.getProperty ( call SW.singleton en.block ) ( string ! type ) ) ( call SW.reverse ( string left ) ) ( string > ) ( number 2 ) ( call SW.getProperty ( call SW.singleton en.block ) ( string ! type ) ) ) )	overnight-blocks
above and to the right of block 1	( call SW.listValue ( call SW.filter ( call SW.filter ( call SW.getProperty ( call SW.singleton en.block ) ( string ! type ) ) ( call SW.reverse ( string below ) ) ( string = ) en.block.block1 ) ( string right ) ( string = ) en.block.block1 ) )	overnight-blocks
choose the block below the special looking block 1	( call SW.listValue ( call SW.filter ( call SW.filter ( call SW.getProperty ( call SW.singleton en.block ) ( string ! type ) ) ( string below ) ( string = ) en.block.block1 ) ( string is_special ) ) )	overnight-blocks
block that is above block which is right of block 1	( call SW.listValue ( call SW.filter ( call SW.getProperty ( call SW.singleton en.block ) ( string ! type ) ) ( string above ) ( string = ) ( call SW.filter ( call SW.getProperty ( call SW.singleton en.block ) ( string ! type ) ) ( string right ) ( string = ) en.block.block1 ) ) )	overnight-blocks
pyramid block rght of block 1	( call SW.listValue ( call SW.filter ( call SW.filter ( call SW.getProperty ( call SW.singleton en.block ) ( string ! type ) ) ( string right ) ( string = ) en.block.block1 ) ( string shape ) ( string = ) en.shape.pyramid ) )	overnight-blocks
find a block with equal height and width measurements specifically 3 inches	( call SW.listValue ( call SW.filter ( call SW.filter ( call SW.getProperty ( call SW.singleton en.block ) ( string ! type ) ) ( string width ) ( string = ) ( number 3 en.inch ) ) ( string length ) ( string = ) ( number 3 en.inch ) ) )	overnight-blocks
block right of more than two blocks	( call SW.listValue ( call SW.countComparative ( call SW.getProperty ( call SW.singleton en.block ) ( string ! type ) ) ( call SW.reverse ( string right ) ) ( string > ) ( number 2 ) ( call SW.getProperty ( call SW.singleton en.block ) ( string ! type ) ) ) )	overnight-blocks
find the block that has a width of 3 inches and is to the right of block 1	( call SW.listValue ( call SW.filter ( call SW.filter ( call SW.getProperty ( call SW.singleton en.block ) ( string ! type ) ) ( string width ) ( string = ) ( number 3 en.inch ) ) ( string right ) ( string = ) en.block.block1 ) )	overnight-blocks
get the blocks below block 1	( call SW.listValue ( call SW.filter ( call SW.getProperty ( call SW.singleton en.block ) ( string ! type ) ) ( call SW.reverse ( string above ) ) ( string = ) en.block.block1 ) )	overnight-blocks
which brick has a width smaller than the height of brick 1	( call SW.listValue ( call SW.filter ( call SW.getProperty ( call SW.singleton en.block ) ( string ! type ) ) ( call SW.ensureNumericProperty ( string width ) ) ( string < ) ( call SW.ensureNumericEntity ( call SW.getProperty en.block.block1 ( string height ) ) ) ) )	overnight-blocks
block that has the largest height	( call SW.listValue ( call SW.superlative ( call SW.getProperty ( call SW.singleton en.block ) ( string ! type ) ) ( string max ) ( call SW.ensureNumericProperty ( string height ) ) ) )	overnight-blocks
what is the height of brick 1	( call SW.listValue ( call SW.getProperty en.block.block1 ( string height ) ) )	overnight-blocks
what block is to the right of the 3 inch long block	( call SW.listValue ( call SW.filter ( call SW.getProperty ( call SW.singleton en.block ) ( string ! type ) ) ( string right ) ( string = ) ( call SW.filter ( call SW.getProperty ( call SW.singleton en.block ) ( string ! type ) ) ( string length ) ( string = ) ( number 3 en.inch ) ) ) )	overnight-blocks
gather all the blocks that are 3 inches or more	( call SW.listValue ( call SW.filter ( call SW.getProperty ( call SW.singleton en.block ) ( string ! type ) ) ( call SW.ensureNumericProperty ( string length ) ) ( string >= ) ( call SW.ensureNumericEntity ( number 3 en.inch ) ) ) )	overnight-blocks
what block is between block 1 and a block to the left of block 1	( call SW.listValue ( call SW.filter ( call SW.getProperty ( call SW.singleton en.block ) ( string ! type ) ) ( string right ) ( string = ) ( call SW.filter ( call SW.getProperty ( call SW.singleton en.block ) ( string ! type ) ) ( string left ) ( string = ) en.block.block1 ) ) )	overnight-blocks
find the blocks who have a height of 3 inches are are to the left of block 1	( call SW.listValue ( call SW.filter ( call SW.filter ( call SW.getProperty ( call SW.singleton en.block ) ( string ! type ) ) ( string height ) ( string = ) ( number 3 en.inch ) ) ( string left ) ( string = ) en.block.block1 ) )	overnight-blocks
select the brick at the very right	( call SW.listValue ( call SW.countSuperlative ( call SW.getProperty ( call SW.singleton en.block ) ( string ! type ) ) ( string max ) ( call SW.reverse ( string left ) ) ( call SW.getProperty ( call SW.singleton en.block ) ( string ! type ) ) ) )	overnight-blocks
is  there a special block with a height that is only 3 inches	( call SW.listValue ( call SW.filter ( call SW.filter ( call SW.getProperty ( call SW.singleton en.block ) ( string ! type ) ) ( string is_special ) ) ( string height ) ( string = ) ( number 3 en.inch ) ) )	overnight-blocks
the 3x3 inch block	( call SW.listValue ( call SW.filter ( call SW.filter ( call SW.getProperty ( call SW.singleton en.block ) ( string ! type ) ) ( string height ) ( string = ) ( number 3 en.inch ) ) ( string width ) ( string = ) ( number 3 en.inch ) ) )	overnight-blocks
block that is right of block 1 and whose length is 3 inches	( call SW.listValue ( call SW.filter ( call SW.filter ( call SW.getProperty ( call SW.singleton en.block ) ( string ! type ) ) ( string right ) ( string = ) en.block.block1 ) ( string length ) ( string = ) ( number 3 en.inch ) ) )	overnight-blocks
select the pyramidshaped blocks	( call SW.listValue ( call SW.filter ( call SW.getProperty ( call SW.singleton en.block ) ( string ! type ) ) ( call SW.reverse ( string left ) ) ( string = ) ( call SW.filter ( call SW.getProperty ( call SW.singleton en.block ) ( string ! type ) ) ( string shape ) ( string = ) en.shape.pyramid ) ) )	overnight-blocks
find me all 3 or 6 inch wide blocks	( call SW.listValue ( call SW.filter ( call SW.getProperty ( call SW.singleton en.block ) ( string ! type ) ) ( string width ) ( string = ) ( call SW.concat ( number 3 en.inch ) ( number 6 en.inch ) ) ) )	overnight-blocks
find me all 3 inch high blocks	( call SW.listValue ( call SW.filter ( call SW.getProperty ( call SW.singleton en.block ) ( string ! type ) ) ( string height ) ( string = ) ( number 3 en.inch ) ) )	overnight-blocks
find me all blocks 2 below block 1	( call SW.listValue ( call SW.filter ( call SW.getProperty ( call SW.singleton en.block ) ( string ! type ) ) ( call SW.reverse ( string below ) ) ( string = ) ( call SW.filter ( call SW.getProperty ( call SW.singleton en.block ) ( string ! type ) ) ( string below ) ( string = ) en.block.block1 ) ) )	overnight-blocks
find a block that has block 1 to its right	( call SW.listValue ( call SW.filter ( call SW.getProperty ( call SW.singleton en.block ) ( string ! type ) ) ( string left ) ( string = ) en.block.block1 ) )	overnight-blocks
which brick has two blocks below it	( call SW.listValue ( call SW.countComparative ( call SW.getProperty ( call SW.singleton en.block ) ( string ! type ) ) ( call SW.reverse ( string below ) ) ( string < ) ( number 2 ) ( call SW.getProperty ( call SW.singleton en.block ) ( string ! type ) ) ) )	overnight-blocks
which 3 inches long block is above block 1	( call SW.listValue ( call SW.filter ( call SW.filter ( call SW.getProperty ( call SW.singleton en.block ) ( string ! type ) ) ( call SW.reverse ( string below ) ) ( string = ) en.block.block1 ) ( string length ) ( string = ) ( number 3 en.inch ) ) )	overnight-blocks
below and left of block 1	( call SW.listValue ( call SW.filter ( call SW.filter ( call SW.getProperty ( call SW.singleton en.block ) ( string ! type ) ) ( string left ) ( string = ) en.block.block1 ) ( string below ) ( string = ) en.block.block1 ) )	overnight-blocks
find a block at least 3 inches long	( call SW.listValue ( call SW.filter ( call SW.getProperty ( call SW.singleton en.block ) ( string ! type ) ) ( call SW.ensureNumericProperty ( string length ) ) ( string >= ) ( call SW.ensureNumericEntity ( call SW.concat ( number 3 en.inch ) ( number 6 en.inch ) ) ) ) )	overnight-blocks
what is the total length of the blocks	( call SW.listValue ( call SW.aggregate ( string sum ) ( call SW.getProperty ( call SW.getProperty ( call SW.singleton en.block ) ( string ! type ) ) ( string length ) ) ) )	overnight-blocks
choose a 3 inch block that is left of block 1	( call SW.listValue ( call SW.filter ( call SW.filter ( call SW.getProperty ( call SW.singleton en.block ) ( string ! type ) ) ( string left ) ( string = ) en.block.block1 ) ( string length ) ( string = ) ( number 3 en.inch ) ) )	overnight-blocks
find me all special blocks above block 1	( call SW.listValue ( call SW.filter ( call SW.filter ( call SW.getProperty ( call SW.singleton en.block ) ( string ! type ) ) ( string is_special ) ) ( string above ) ( string = ) en.block.block1 ) )	overnight-blocks
choose the block beneath the 2 block	( call SW.listValue ( call SW.countComparative ( call SW.getProperty ( call SW.singleton en.block ) ( string ! type ) ) ( call SW.reverse ( string below ) ) ( string > ) ( number 2 ) ( call SW.getProperty ( call SW.singleton en.block ) ( string ! type ) ) ) )	overnight-blocks
what block is unique and shaped like a pyramid	( call SW.listValue ( call SW.filter ( call SW.filter ( call SW.getProperty ( call SW.singleton en.block ) ( string ! type ) ) ( string is_special ) ) ( string shape ) ( string = ) en.shape.pyramid ) )	overnight-blocks
get a 3inch long block below block 1	( call SW.listValue ( call SW.filter ( call SW.filter ( call SW.getProperty ( call SW.singleton en.block ) ( string ! type ) ) ( string length ) ( string = ) ( number 3 en.inch ) ) ( call SW.reverse ( string above ) ) ( string = ) en.block.block1 ) )	overnight-blocks
find me all 3 inch tall blocks right of block 1	( call SW.listValue ( call SW.filter ( call SW.filter ( call SW.getProperty ( call SW.singleton en.block ) ( string ! type ) ) ( string right ) ( string = ) en.block.block1 ) ( string height ) ( string = ) ( number 3 en.inch ) ) )	overnight-blocks
find me the block that has a height of 3 inches	( call SW.listValue ( call SW.filter ( call SW.getProperty ( call SW.singleton en.block ) ( string ! type ) ) ( call SW.reverse ( string above ) ) ( string = ) ( call SW.filter ( call SW.getProperty ( call SW.singleton en.block ) ( string ! type ) ) ( string height ) ( string = ) ( number 3 en.inch ) ) ) )	overnight-blocks
find me all blocks above and to the left of block 1	( call SW.listValue ( call SW.filter ( call SW.filter ( call SW.getProperty ( call SW.singleton en.block ) ( string ! type ) ) ( call SW.reverse ( string above ) ) ( string = ) en.block.block1 ) ( call SW.reverse ( string right ) ) ( string = ) en.block.block1 ) )	overnight-blocks
find me all blocks not 3 inches high	( call SW.listValue ( call SW.filter ( call SW.getProperty ( call SW.singleton en.block ) ( string ! type ) ) ( string height ) ( string ! = ) ( number 3 en.inch ) ) )	overnight-blocks
find the average height of a block	( call SW.listValue ( call SW.aggregate ( string avg ) ( call SW.getProperty ( call SW.getProperty ( call SW.singleton en.block ) ( string ! type ) ) ( string height ) ) ) )	overnight-blocks
locate the block that is no taller in inches than the width of block 1	( call SW.listValue ( call SW.filter ( call SW.getProperty ( call SW.singleton en.block ) ( string ! type ) ) ( call SW.ensureNumericProperty ( string height ) ) ( string <= ) ( call SW.ensureNumericEntity ( call SW.getProperty en.block.block1 ( string width ) ) ) ) )	overnight-blocks
find blocks that are taller than block 1 is long	( call SW.listValue ( call SW.filter ( call SW.getProperty ( call SW.singleton en.block ) ( string ! type ) ) ( call SW.ensureNumericProperty ( string height ) ) ( string > ) ( call SW.ensureNumericEntity ( call SW.getProperty en.block.block1 ( string length ) ) ) ) )	overnight-blocks
block whose shape is not a pyramid	( call SW.listValue ( call SW.filter ( call SW.getProperty ( call SW.singleton en.block ) ( string ! type ) ) ( string shape ) ( string ! = ) en.shape.pyramid ) )	overnight-blocks
find a block of 3 height above block 1	( call SW.listValue ( call SW.filter ( call SW.filter ( call SW.getProperty ( call SW.singleton en.block ) ( string ! type ) ) ( string above ) ( string = ) en.block.block1 ) ( string height ) ( string = ) ( number 3 en.inch ) ) )	overnight-blocks
find a block wider than block 1 is tall	( call SW.listValue ( call SW.filter ( call SW.getProperty ( call SW.singleton en.block ) ( string ! type ) ) ( call SW.ensureNumericProperty ( string width ) ) ( string > ) ( call SW.ensureNumericEntity ( call SW.getProperty en.block.block1 ( string height ) ) ) ) )	overnight-blocks
right and below block 1	( call SW.listValue ( call SW.filter ( call SW.filter ( call SW.getProperty ( call SW.singleton en.block ) ( string ! type ) ) ( call SW.reverse ( string left ) ) ( string = ) en.block.block1 ) ( call SW.reverse ( string above ) ) ( string = ) en.block.block1 ) )	overnight-blocks
choose brick 1 or brick 2	( call SW.listValue ( call SW.concat en.block.block1 en.block.block2 ) )	overnight-blocks
describe the shape of block 1	( call SW.listValue ( call SW.getProperty en.block.block1 ( string shape ) ) )	overnight-blocks
find me all the special blocks above block 1	( call SW.listValue ( call SW.filter ( call SW.filter ( call SW.getProperty ( call SW.singleton en.block ) ( string ! type ) ) ( string above ) ( string = ) en.block.block1 ) ( string is_special ) ) )	overnight-blocks
choose a block that is shape like a cube or pyramid	( call SW.listValue ( call SW.filter ( call SW.getProperty ( call SW.singleton en.block ) ( string ! type ) ) ( string shape ) ( string = ) ( call SW.concat en.shape.pyramid en.shape.cube ) ) )	overnight-blocks
what block has a width of 3 inches and is to the left of block 1	( call SW.listValue ( call SW.filter ( call SW.filter ( call SW.getProperty ( call SW.singleton en.block ) ( string ! type ) ) ( string width ) ( string = ) ( number 3 en.inch ) ) ( string left ) ( string = ) en.block.block1 ) )	overnight-blocks
find me all blocks right of blocks 1 or 2	( call SW.listValue ( call SW.filter ( call SW.getProperty ( call SW.singleton en.block ) ( string ! type ) ) ( call SW.reverse ( string right ) ) ( string = ) ( call SW.concat en.block.block1 en.block.block2 ) ) )	overnight-blocks
pyramid block above block 1	( call SW.listValue ( call SW.filter ( call SW.filter ( call SW.getProperty ( call SW.singleton en.block ) ( string ! type ) ) ( call SW.reverse ( string below ) ) ( string = ) en.block.block1 ) ( string shape ) ( string = ) en.shape.pyramid ) )	overnight-blocks
block whose width is smaller than 3 inches or 6 inches	( call SW.listValue ( call SW.filter ( call SW.getProperty ( call SW.singleton en.block ) ( string ! type ) ) ( call SW.ensureNumericProperty ( string width ) ) ( string < ) ( call SW.ensureNumericEntity ( call SW.concat ( number 3 en.inch ) ( number 6 en.inch ) ) ) ) )	overnight-blocks
which block is to the left of no more than two blocks	( call SW.listValue ( call SW.countComparative ( call SW.getProperty ( call SW.singleton en.block ) ( string ! type ) ) ( string left ) ( string <= ) ( number 2 ) ( call SW.getProperty ( call SW.singleton en.block ) ( string ! type ) ) ) )	overnight-blocks
what is the width of block 1	( call SW.listValue ( call SW.getProperty en.block.block1 ( string width ) ) )	overnight-blocks
what block is shorter than block 1	( call SW.listValue ( call SW.filter ( call SW.getProperty ( call SW.singleton en.block ) ( string ! type ) ) ( call SW.ensureNumericProperty ( string height ) ) ( string < ) ( call SW.ensureNumericEntity ( call SW.getProperty en.block.block1 ( string height ) ) ) ) )	overnight-blocks
3 inch block left of block 1	( call SW.listValue ( call SW.filter ( call SW.filter ( call SW.getProperty ( call SW.singleton en.block ) ( string ! type ) ) ( string length ) ( string = ) ( number 3 en.inch ) ) ( call SW.reverse ( string right ) ) ( string = ) en.block.block1 ) )	overnight-blocks
what pyramid blocks are above block 1	( call SW.listValue ( call SW.filter ( call SW.filter ( call SW.getProperty ( call SW.singleton en.block ) ( string ! type ) ) ( string shape ) ( string = ) en.shape.pyramid ) ( call SW.reverse ( string below ) ) ( string = ) en.block.block1 ) )	overnight-blocks
find the block that is at least 3 inches long	( call SW.listValue ( call SW.filter ( call SW.getProperty ( call SW.singleton en.block ) ( string ! type ) ) ( call SW.ensureNumericProperty ( string length ) ) ( string >= ) ( call SW.ensureNumericEntity ( number 3 en.inch ) ) ) )	overnight-blocks
what brick has at least two bricks to its left	( call SW.listValue ( call SW.countComparative ( call SW.getProperty ( call SW.singleton en.block ) ( string ! type ) ) ( call SW.reverse ( string left ) ) ( string >= ) ( number 2 ) ( call SW.getProperty ( call SW.singleton en.block ) ( string ! type ) ) ) )	overnight-blocks
block right of 3 inch wide block	( call SW.listValue ( call SW.filter ( call SW.getProperty ( call SW.singleton en.block ) ( string ! type ) ) ( call SW.reverse ( string left ) ) ( string = ) ( call SW.filter ( call SW.getProperty ( call SW.singleton en.block ) ( string ! type ) ) ( string width ) ( string = ) ( number 3 en.inch ) ) ) )	overnight-blocks
find me all blocks right of 3 inch high blocks	( call SW.listValue ( call SW.filter ( call SW.getProperty ( call SW.singleton en.block ) ( string ! type ) ) ( string right ) ( string = ) ( call SW.filter ( call SW.getProperty ( call SW.singleton en.block ) ( string ! type ) ) ( string height ) ( string = ) ( number 3 en.inch ) ) ) )	overnight-blocks
choose a block that is right of a 3 inch brick	( call SW.listValue ( call SW.filter ( call SW.getProperty ( call SW.singleton en.block ) ( string ! type ) ) ( string right ) ( string = ) ( call SW.filter ( call SW.getProperty ( call SW.singleton en.block ) ( string ! type ) ) ( string height ) ( string = ) ( number 3 en.inch ) ) ) )	overnight-blocks
select the shortest block	( call SW.listValue ( call SW.superlative ( call SW.getProperty ( call SW.singleton en.block ) ( string ! type ) ) ( string min ) ( call SW.ensureNumericProperty ( string length ) ) ) )	overnight-blocks
which brick is below the special brick	( call SW.listValue ( call SW.filter ( call SW.getProperty ( call SW.singleton en.block ) ( string ! type ) ) ( string below ) ( string = ) ( call SW.filter ( call SW.getProperty ( call SW.singleton en.block ) ( string ! type ) ) ( string is_special ) ) ) )	overnight-blocks
find me all blocks left of that block 1 is below	( call SW.listValue ( call SW.filter ( call SW.getProperty ( call SW.singleton en.block ) ( string ! type ) ) ( string left ) ( string = ) ( call SW.filter ( call SW.getProperty ( call SW.singleton en.block ) ( string ! type ) ) ( call SW.reverse ( string below ) ) ( string = ) en.block.block1 ) ) )	overnight-blocks
find me a block that block 1 is to the left of	( call SW.listValue ( call SW.filter ( call SW.getProperty ( call SW.singleton en.block ) ( string ! type ) ) ( string right ) ( string = ) ( call SW.filter ( call SW.getProperty ( call SW.singleton en.block ) ( string ! type ) ) ( call SW.reverse ( string left ) ) ( string = ) en.block.block1 ) ) )	overnight-blocks
which brick is at least as long as brick 1 is wide	( call SW.listValue ( call SW.filter ( call SW.getProperty ( call SW.singleton en.block ) ( string ! type ) ) ( call SW.ensureNumericProperty ( string length ) ) ( string >= ) ( call SW.ensureNumericEntity ( call SW.getProperty en.block.block1 ( string width ) ) ) ) )	overnight-blocks
select the block that block 1 is below	( call SW.listValue ( call SW.filter ( call SW.filter ( call SW.getProperty ( call SW.singleton en.block ) ( string ! type ) ) ( call SW.reverse ( string below ) ) ( string = ) en.block.block1 ) ( string below ) ( string = ) en.block.block1 ) )	overnight-blocks
locate the block beneath block 1 that also has a width of 3 inches	( call SW.listValue ( call SW.filter ( call SW.filter ( call SW.getProperty ( call SW.singleton en.block ) ( string ! type ) ) ( string below ) ( string = ) en.block.block1 ) ( string width ) ( string = ) ( number 3 en.inch ) ) )	overnight-blocks
find me all special blocks that block 1 is below	( call SW.listValue ( call SW.filter ( call SW.filter ( call SW.getProperty ( call SW.singleton en.block ) ( string ! type ) ) ( call SW.reverse ( string below ) ) ( string = ) en.block.block1 ) ( string is_special ) ) )	overnight-blocks
find me the block that is to the left of block 1 with a height of 3 inches	( call SW.listValue ( call SW.filter ( call SW.filter ( call SW.getProperty ( call SW.singleton en.block ) ( string ! type ) ) ( string left ) ( string = ) en.block.block1 ) ( string height ) ( string = ) ( number 3 en.inch ) ) )	overnight-blocks
find me all blocks at most as tall as block 1	( call SW.listValue ( call SW.filter ( call SW.getProperty ( call SW.singleton en.block ) ( string ! type ) ) ( call SW.ensureNumericProperty ( string height ) ) ( string <= ) ( call SW.ensureNumericEntity ( call SW.getProperty en.block.block1 ( string width ) ) ) ) )	overnight-blocks
find me the special block on top of the block	( call SW.listValue ( call SW.filter ( call SW.getProperty ( call SW.singleton en.block ) ( string ! type ) ) ( string above ) ( string = ) ( call SW.filter ( call SW.getProperty ( call SW.singleton en.block ) ( string ! type ) ) ( string is_special ) ) ) )	overnight-blocks
below and left of block 1	( call SW.listValue ( call SW.filter ( call SW.filter ( call SW.getProperty ( call SW.singleton en.block ) ( string ! type ) ) ( call SW.reverse ( string above ) ) ( string = ) en.block.block1 ) ( call SW.reverse ( string right ) ) ( string = ) en.block.block1 ) )	overnight-blocks
block with height of either 3 inches or 6 inches	( call SW.listValue ( call SW.filter ( call SW.getProperty ( call SW.singleton en.block ) ( string ! type ) ) ( string height ) ( string = ) ( call SW.concat ( number 3 en.inch ) ( number 6 en.inch ) ) ) )	overnight-blocks
find me a block to the right of either block 1 or block 2	( call SW.listValue ( call SW.filter ( call SW.getProperty ( call SW.singleton en.block ) ( string ! type ) ) ( string right ) ( string = ) ( call SW.concat en.block.block1 en.block.block2 ) ) )	overnight-blocks
find me all blocks left of 2 blocks	( call SW.listValue ( call SW.countComparative ( call SW.getProperty ( call SW.singleton en.block ) ( string ! type ) ) ( string left ) ( string = ) ( number 2 ) ( call SW.getProperty ( call SW.singleton en.block ) ( string ! type ) ) ) )	overnight-blocks
what block is at least as long as block 1s height	( call SW.listValue ( call SW.filter ( call SW.getProperty ( call SW.singleton en.block ) ( string ! type ) ) ( call SW.ensureNumericProperty ( string length ) ) ( string >= ) ( call SW.ensureNumericEntity ( call SW.getProperty en.block.block1 ( string height ) ) ) ) )	overnight-blocks
block whose height is at most 3 inches or 6 inches	( call SW.listValue ( call SW.filter ( call SW.getProperty ( call SW.singleton en.block ) ( string ! type ) ) ( call SW.ensureNumericProperty ( string height ) ) ( string <= ) ( call SW.ensureNumericEntity ( call SW.concat ( number 3 en.inch ) ( number 6 en.inch ) ) ) ) )	overnight-blocks
how wide is block 1	( call SW.listValue ( call SW.getProperty en.block.block1 ( string width ) ) )	overnight-blocks
block whose shape is a pyramid and whose width is 3 inches	( call SW.listValue ( call SW.filter ( call SW.filter ( call SW.getProperty ( call SW.singleton en.block ) ( string ! type ) ) ( string shape ) ( string = ) en.shape.pyramid ) ( string width ) ( string = ) ( number 3 en.inch ) ) )	overnight-blocks
select the 3 inch wide special block	( call SW.listValue ( call SW.filter ( call SW.filter ( call SW.getProperty ( call SW.singleton en.block ) ( string ! type ) ) ( string is_special ) ) ( string width ) ( string = ) ( number 3 en.inch ) ) )	overnight-blocks
what block is to the right of and below block 1	( call SW.listValue ( call SW.filter ( call SW.getProperty ( call SW.singleton en.block ) ( string ! type ) ) ( call SW.reverse ( string below ) ) ( string = ) ( call SW.filter ( call SW.getProperty ( call SW.singleton en.block ) ( string ! type ) ) ( call SW.reverse ( string right ) ) ( string = ) en.block.block1 ) ) )	overnight-blocks
find me all blocks below of which is above block 1	( call SW.listValue ( call SW.filter ( call SW.filter ( call SW.getProperty ( call SW.singleton en.block ) ( string ! type ) ) ( string below ) ( string = ) en.block.block1 ) ( string above ) ( string = ) en.block.block1 ) )	overnight-blocks
select the block with the most shapes	( call SW.listValue ( call SW.countSuperlative ( call SW.getProperty ( call SW.singleton en.block ) ( string ! type ) ) ( string max ) ( string shape ) ) )	overnight-blocks
find me all blocks not above block 1	( call SW.listValue ( call SW.filter ( call SW.getProperty ( call SW.singleton en.block ) ( string ! type ) ) ( string above ) ( string ! = ) en.block.block1 ) )	overnight-blocks
block whose length is 3 inches and whose length is 3 inches	( call SW.listValue ( call SW.filter ( call SW.filter ( call SW.getProperty ( call SW.singleton en.block ) ( string ! type ) ) ( string length ) ( string = ) ( number 3 en.inch ) ) ( string length ) ( string = ) ( number 3 en.inch ) ) )	overnight-blocks
find me all the blocks above 3 inch long blocks	( call SW.listValue ( call SW.filter ( call SW.getProperty ( call SW.singleton en.block ) ( string ! type ) ) ( string above ) ( string = ) ( call SW.filter ( call SW.getProperty ( call SW.singleton en.block ) ( string ! type ) ) ( string length ) ( string = ) ( number 3 en.inch ) ) ) )	overnight-blocks
what block is block 1 to the right of	( call SW.listValue ( call SW.filter ( call SW.getProperty ( call SW.singleton en.block ) ( string ! type ) ) ( call SW.reverse ( string right ) ) ( string = ) en.block.block1 ) )	overnight-blocks
select the special block that is to the right of block 1	( call SW.listValue ( call SW.filter ( call SW.filter ( call SW.getProperty ( call SW.singleton en.block ) ( string ! type ) ) ( string right ) ( string = ) en.block.block1 ) ( string is_special ) ) )	overnight-blocks
is there a block that is on top of the fewest number of other blocks	( call SW.listValue ( call SW.countSuperlative ( call SW.getProperty ( call SW.singleton en.block ) ( string ! type ) ) ( string min ) ( string above ) ( call SW.getProperty ( call SW.singleton en.block ) ( string ! type ) ) ) )	overnight-blocks
find me all blocks with height and width equal to 3 inches	( call SW.listValue ( call SW.filter ( call SW.filter ( call SW.getProperty ( call SW.singleton en.block ) ( string ! type ) ) ( string height ) ( string = ) ( number 3 en.inch ) ) ( string height ) ( string = ) ( number 3 en.inch ) ) )	overnight-blocks
block that block one isnt left of	( call SW.listValue ( call SW.filter ( call SW.getProperty ( call SW.singleton en.block ) ( string ! type ) ) ( call SW.reverse ( string left ) ) ( string ! = ) en.block.block1 ) )	overnight-blocks
what is the blocks height	( call SW.listValue ( call SW.aggregate ( string sum ) ( call SW.getProperty ( call SW.getProperty ( call SW.singleton en.block ) ( string ! type ) ) ( string height ) ) ) )	overnight-blocks
what is the block below and left of block 1	( call SW.listValue ( call SW.filter ( call SW.getProperty ( call SW.singleton en.block ) ( string ! type ) ) ( call SW.reverse ( string left ) ) ( string = ) ( call SW.filter ( call SW.getProperty ( call SW.singleton en.block ) ( string ! type ) ) ( call SW.reverse ( string above ) ) ( string = ) en.block.block1 ) ) )	overnight-blocks
which brick is above the pyramidshaped block	( call SW.listValue ( call SW.filter ( call SW.getProperty ( call SW.singleton en.block ) ( string ! type ) ) ( string above ) ( string = ) ( call SW.filter ( call SW.getProperty ( call SW.singleton en.block ) ( string ! type ) ) ( string shape ) ( string = ) en.shape.pyramid ) ) )	overnight-blocks
choose a block that is left of block 1	( call SW.listValue ( call SW.filter ( call SW.getProperty ( call SW.singleton en.block ) ( string ! type ) ) ( string left ) ( string = ) en.block.block1 ) )	overnight-blocks
select a block with less than two colors	( call SW.listValue ( call SW.countComparative ( call SW.getProperty ( call SW.singleton en.block ) ( string ! type ) ) ( string color ) ( string < ) ( number 2 ) ) )	overnight-blocks
find me all blocks with at least 2 colors	( call SW.listValue ( call SW.countComparative ( call SW.getProperty ( call SW.singleton en.block ) ( string ! type ) ) ( string color ) ( string >= ) ( number 2 ) ) )	overnight-blocks
find all pyramid blocks below block 1	( call SW.listValue ( call SW.filter ( call SW.filter ( call SW.getProperty ( call SW.singleton en.block ) ( string ! type ) ) ( string below ) ( string = ) en.block.block1 ) ( string shape ) ( string = ) en.shape.pyramid ) )	overnight-blocks
what pyramidshaped block is above block 1	( call SW.listValue ( call SW.filter ( call SW.filter ( call SW.getProperty ( call SW.singleton en.block ) ( string ! type ) ) ( string above ) ( string = ) en.block.block1 ) ( string shape ) ( string = ) en.shape.pyramid ) )	overnight-blocks
block that is above more than two blocks	( call SW.listValue ( call SW.countComparative ( call SW.getProperty ( call SW.singleton en.block ) ( string ! type ) ) ( call SW.reverse ( string above ) ) ( string > ) ( number 2 ) ( call SW.getProperty ( call SW.singleton en.block ) ( string ! type ) ) ) )	overnight-blocks
bricks that are the same size as brick 1	( call SW.listValue ( call SW.filter ( call SW.getProperty ( call SW.singleton en.block ) ( string ! type ) ) ( string width ) ( string = ) ( call SW.getProperty en.block.block1 ( string width ) ) ) )	overnight-blocks
block whose length is length of block 1	( call SW.listValue ( call SW.filter ( call SW.getProperty ( call SW.singleton en.block ) ( string ! type ) ) ( string length ) ( string = ) ( call SW.getProperty en.block.block1 ( string length ) ) ) )	overnight-blocks
what is the total width of the block	( call SW.listValue ( call SW.aggregate ( string sum ) ( call SW.getProperty ( call SW.getProperty ( call SW.singleton en.block ) ( string ! type ) ) ( string width ) ) ) )	overnight-blocks
find a special block above block 1	( call SW.listValue ( call SW.filter ( call SW.filter ( call SW.getProperty ( call SW.singleton en.block ) ( string ! type ) ) ( call SW.reverse ( string below ) ) ( string = ) en.block.block1 ) ( string is_special ) ) )	overnight-blocks
what block is less than 3 inches wide	( call SW.listValue ( call SW.filter ( call SW.getProperty ( call SW.singleton en.block ) ( string ! type ) ) ( call SW.ensureNumericProperty ( string width ) ) ( string < ) ( call SW.ensureNumericEntity ( number 3 en.inch ) ) ) )	overnight-blocks
find me the block that is to the left of block 1	( call SW.listValue ( call SW.filter ( call SW.filter ( call SW.getProperty ( call SW.singleton en.block ) ( string ! type ) ) ( call SW.reverse ( string left ) ) ( string = ) en.block.block1 ) ( string left ) ( string = ) en.block.block1 ) )	overnight-blocks
find me all blocks right of pyramid blocks	( call SW.listValue ( call SW.filter ( call SW.getProperty ( call SW.singleton en.block ) ( string ! type ) ) ( call SW.reverse ( string right ) ) ( string = ) ( call SW.filter ( call SW.getProperty ( call SW.singleton en.block ) ( string ! type ) ) ( string shape ) ( string = ) en.shape.pyramid ) ) )	overnight-blocks
left of block 1	( call SW.listValue ( call SW.filter ( call SW.filter ( call SW.getProperty ( call SW.singleton en.block ) ( string ! type ) ) ( call SW.reverse ( string right ) ) ( string = ) en.block.block1 ) ( call SW.reverse ( string right ) ) ( string = ) en.block.block1 ) )	overnight-blocks
pyramid block below block 1	( call SW.listValue ( call SW.filter ( call SW.filter ( call SW.getProperty ( call SW.singleton en.block ) ( string ! type ) ) ( string shape ) ( string = ) en.shape.pyramid ) ( call SW.reverse ( string above ) ) ( string = ) en.block.block1 ) )	overnight-blocks
select the block that is two blocks above that block	( call SW.listValue ( call SW.countComparative ( call SW.getProperty ( call SW.singleton en.block ) ( string ! type ) ) ( call SW.reverse ( string above ) ) ( string = ) ( number 2 ) ( call SW.getProperty ( call SW.singleton en.block ) ( string ! type ) ) ) )	overnight-blocks
select the widest block	( call SW.listValue ( call SW.superlative ( call SW.getProperty ( call SW.singleton en.block ) ( string ! type ) ) ( string max ) ( call SW.ensureNumericProperty ( string width ) ) ) )	overnight-blocks
left and above block 1	( call SW.listValue ( call SW.filter ( call SW.filter ( call SW.getProperty ( call SW.singleton en.block ) ( string ! type ) ) ( call SW.reverse ( string right ) ) ( string = ) en.block.block1 ) ( string above ) ( string = ) en.block.block1 ) )	overnight-blocks
is there a block beneath two other blocks	( call SW.listValue ( call SW.countComparative ( call SW.getProperty ( call SW.singleton en.block ) ( string ! type ) ) ( call SW.reverse ( string above ) ) ( string = ) ( number 2 ) ( call SW.getProperty ( call SW.singleton en.block ) ( string ! type ) ) ) )	overnight-blocks
select the blocks that are under no more than 2 blocks	( call SW.listValue ( call SW.countComparative ( call SW.getProperty ( call SW.singleton en.block ) ( string ! type ) ) ( call SW.reverse ( string above ) ) ( string <= ) ( number 2 ) ( call SW.getProperty ( call SW.singleton en.block ) ( string ! type ) ) ) )	overnight-blocks
pyramid block left of block 1	( call SW.listValue ( call SW.filter ( call SW.filter ( call SW.getProperty ( call SW.singleton en.block ) ( string ! type ) ) ( call SW.reverse ( string right ) ) ( string = ) en.block.block1 ) ( string shape ) ( string = ) en.shape.pyramid ) )	overnight-blocks
find me all the blocks below at most 1 blocks	( call SW.listValue ( call SW.countComparative ( call SW.getProperty ( call SW.singleton en.block ) ( string ! type ) ) ( string below ) ( string < ) ( number 2 ) ( call SW.getProperty ( call SW.singleton en.block ) ( string ! type ) ) ) )	overnight-blocks
find me a block that is to the left of the block with a width of 3 inches	( call SW.listValue ( call SW.filter ( call SW.getProperty ( call SW.singleton en.block ) ( string ! type ) ) ( string left ) ( string = ) ( call SW.filter ( call SW.getProperty ( call SW.singleton en.block ) ( string ! type ) ) ( string width ) ( string = ) ( number 3 en.inch ) ) ) )	overnight-blocks
pyramid shaped block that is to the left of block 1	( call SW.listValue ( call SW.filter ( call SW.filter ( call SW.getProperty ( call SW.singleton en.block ) ( string ! type ) ) ( string left ) ( string = ) en.block.block1 ) ( string shape ) ( string = ) en.shape.pyramid ) )	overnight-blocks
find me all 3 inch tall blocks that block 1 is left of	( call SW.listValue ( call SW.filter ( call SW.filter ( call SW.getProperty ( call SW.singleton en.block ) ( string ! type ) ) ( call SW.reverse ( string left ) ) ( string = ) en.block.block1 ) ( string height ) ( string = ) ( number 3 en.inch ) ) )	overnight-blocks
find me all 3 inch tall special blocks	( call SW.listValue ( call SW.filter ( call SW.filter ( call SW.getProperty ( call SW.singleton en.block ) ( string ! type ) ) ( string height ) ( string = ) ( number 3 en.inch ) ) ( string is_special ) ) )	overnight-blocks
a brick between 3 and 6 inches	( call SW.listValue ( call SW.filter ( call SW.getProperty ( call SW.singleton en.block ) ( string ! type ) ) ( call SW.ensureNumericProperty ( string height ) ) ( string <= ) ( call SW.ensureNumericEntity ( call SW.concat ( number 3 en.inch ) ( number 6 en.inch ) ) ) ) )	overnight-blocks
find the block with 3 inches of width	( call SW.listValue ( call SW.filter ( call SW.filter ( call SW.getProperty ( call SW.singleton en.block ) ( string ! type ) ) ( string width ) ( string = ) ( number 3 en.inch ) ) ( call SW.reverse ( string above ) ) ( string = ) en.block.block1 ) )	overnight-blocks
select a block longer than 3 inches	( call SW.listValue ( call SW.filter ( call SW.getProperty ( call SW.singleton en.block ) ( string ! type ) ) ( call SW.ensureNumericProperty ( string length ) ) ( string > ) ( call SW.ensureNumericEntity ( call SW.concat ( number 3 en.inch ) ( number 6 en.inch ) ) ) ) )	overnight-blocks
find me a block with a height of 3 inches that block 1 is to the left of	( call SW.listValue ( call SW.filter ( call SW.filter ( call SW.getProperty ( call SW.singleton en.block ) ( string ! type ) ) ( string height ) ( string = ) ( number 3 en.inch ) ) ( call SW.reverse ( string left ) ) ( string = ) en.block.block1 ) )	overnight-blocks
which brick is below brick 1 or 2	( call SW.listValue ( call SW.filter ( call SW.getProperty ( call SW.singleton en.block ) ( string ! type ) ) ( string below ) ( string = ) ( call SW.concat en.block.block1 en.block.block2 ) ) )	overnight-blocks
choose a 3 inch tall brick	( call SW.listValue ( call SW.filter ( call SW.getProperty ( call SW.singleton en.block ) ( string ! type ) ) ( call SW.ensureNumericProperty ( string height ) ) ( string >= ) ( call SW.ensureNumericEntity ( number 3 en.inch ) ) ) )	overnight-blocks
block right of block 1 which is 3 inches high	( call SW.listValue ( call SW.filter ( call SW.filter ( call SW.getProperty ( call SW.singleton en.block ) ( string ! type ) ) ( call SW.reverse ( string right ) ) ( string = ) en.block.block1 ) ( string height ) ( string = ) ( number 3 en.inch ) ) )	overnight-blocks
select the blocks that are above and below block 1	( call SW.listValue ( call SW.filter ( call SW.filter ( call SW.getProperty ( call SW.singleton en.block ) ( string ! type ) ) ( string below ) ( string = ) en.block.block1 ) ( string above ) ( string = ) en.block.block1 ) )	overnight-blocks
find me a block below the 3 inch tall block	( call SW.listValue ( call SW.filter ( call SW.getProperty ( call SW.singleton en.block ) ( string ! type ) ) ( string below ) ( string = ) ( call SW.filter ( call SW.getProperty ( call SW.singleton en.block ) ( string ! type ) ) ( string height ) ( string = ) ( number 3 en.inch ) ) ) )	overnight-blocks
find the block with a height less than 3 inches	( call SW.listValue ( call SW.filter ( call SW.getProperty ( call SW.singleton en.block ) ( string ! type ) ) ( call SW.ensureNumericProperty ( string height ) ) ( string < ) ( call SW.ensureNumericEntity ( number 3 en.inch ) ) ) )	overnight-blocks
find me all blocks below that block 1 is above	( call SW.listValue ( call SW.filter ( call SW.filter ( call SW.getProperty ( call SW.singleton en.block ) ( string ! type ) ) ( string below ) ( string = ) en.block.block1 ) ( call SW.reverse ( string above ) ) ( string = ) en.block.block1 ) )	overnight-blocks
find me a block above at least two blocks	( call SW.listValue ( call SW.countComparative ( call SW.getProperty ( call SW.singleton en.block ) ( string ! type ) ) ( call SW.reverse ( string below ) ) ( string >= ) ( number 2 ) ( call SW.getProperty ( call SW.singleton en.block ) ( string ! type ) ) ) )	overnight-blocks
block that is below block 1 and whose width is 3 inches	( call SW.listValue ( call SW.filter ( call SW.filter ( call SW.getProperty ( call SW.singleton en.block ) ( string ! type ) ) ( string below ) ( string = ) en.block.block1 ) ( string width ) ( string = ) ( number 3 en.inch ) ) )	overnight-blocks
find the block up 1 and right 1 of block 1	( call SW.listValue ( call SW.filter ( call SW.getProperty ( call SW.singleton en.block ) ( string ! type ) ) ( string above ) ( string = ) ( call SW.filter ( call SW.getProperty ( call SW.singleton en.block ) ( string ! type ) ) ( string right ) ( string = ) en.block.block1 ) ) )	overnight-blocks
block that is above block whose width is 3 inches	( call SW.listValue ( call SW.filter ( call SW.getProperty ( call SW.singleton en.block ) ( string ! type ) ) ( string above ) ( string = ) ( call SW.filter ( call SW.getProperty ( call SW.singleton en.block ) ( string ! type ) ) ( string width ) ( string = ) ( number 3 en.inch ) ) ) )	overnight-blocks
select the block above the left one	( call SW.listValue ( call SW.filter ( call SW.filter ( call SW.getProperty ( call SW.singleton en.block ) ( string ! type ) ) ( call SW.reverse ( string above ) ) ( string = ) en.block.block1 ) ( string left ) ( string = ) en.block.block1 ) )	overnight-blocks
find me all 3 inch wide blocks above block 1	( call SW.listValue ( call SW.filter ( call SW.filter ( call SW.getProperty ( call SW.singleton en.block ) ( string ! type ) ) ( call SW.reverse ( string below ) ) ( string = ) en.block.block1 ) ( string width ) ( string = ) ( number 3 en.inch ) ) )	overnight-blocks
find me all the bricks below at most 2 blocks	( call SW.listValue ( call SW.countComparative ( call SW.getProperty ( call SW.singleton en.block ) ( string ! type ) ) ( string below ) ( string <= ) ( number 2 ) ( call SW.getProperty ( call SW.singleton en.block ) ( string ! type ) ) ) )	overnight-blocks
find me all the blocks that is at most below 2 blocks	( call SW.listValue ( call SW.countComparative ( call SW.getProperty ( call SW.singleton en.block ) ( string ! type ) ) ( call SW.reverse ( string above ) ) ( string <= ) ( number 2 ) ( call SW.getProperty ( call SW.singleton en.block ) ( string ! type ) ) ) )	overnight-blocks
which special block is to the left of brick 1	( call SW.listValue ( call SW.filter ( call SW.filter ( call SW.getProperty ( call SW.singleton en.block ) ( string ! type ) ) ( string is_special ) ) ( string left ) ( string = ) en.block.block1 ) )	overnight-blocks
find me the block that block 1 is to the right of	( call SW.listValue ( call SW.filter ( call SW.filter ( call SW.getProperty ( call SW.singleton en.block ) ( string ! type ) ) ( call SW.reverse ( string right ) ) ( string = ) en.block.block1 ) ( string below ) ( string = ) en.block.block1 ) )	overnight-blocks
block more wider than length of block 1	( call SW.listValue ( call SW.filter ( call SW.getProperty ( call SW.singleton en.block ) ( string ! type ) ) ( call SW.ensureNumericProperty ( string width ) ) ( string > ) ( call SW.ensureNumericEntity ( call SW.getProperty en.block.block1 ( string length ) ) ) ) )	overnight-blocks
the block beneath the block which is less than two	( call SW.listValue ( call SW.countComparative ( call SW.getProperty ( call SW.singleton en.block ) ( string ! type ) ) ( call SW.reverse ( string above ) ) ( string < ) ( number 2 ) ( call SW.getProperty ( call SW.singleton en.block ) ( string ! type ) ) ) )	overnight-blocks
find the 3 inch long block to the left of block 1	( call SW.listValue ( call SW.filter ( call SW.filter ( call SW.getProperty ( call SW.singleton en.block ) ( string ! type ) ) ( string left ) ( string = ) en.block.block1 ) ( string length ) ( string = ) ( number 3 en.inch ) ) )	overnight-blocks
select block below and to the left of block 1	( call SW.listValue ( call SW.filter ( call SW.getProperty ( call SW.singleton en.block ) ( string ! type ) ) ( string below ) ( string = ) ( call SW.filter ( call SW.getProperty ( call SW.singleton en.block ) ( string ! type ) ) ( string left ) ( string = ) en.block.block1 ) ) )	overnight-blocks
which brick is shorter than brick 1 is high	( call SW.listValue ( call SW.filter ( call SW.getProperty ( call SW.singleton en.block ) ( string ! type ) ) ( call SW.ensureNumericProperty ( string height ) ) ( string < ) ( call SW.ensureNumericEntity ( call SW.getProperty en.block.block1 ( string width ) ) ) ) )	overnight-blocks
3 inch block above block 1	( call SW.listValue ( call SW.filter ( call SW.filter ( call SW.getProperty ( call SW.singleton en.block ) ( string ! type ) ) ( string above ) ( string = ) en.block.block1 ) ( string length ) ( string = ) ( number 3 en.inch ) ) )	overnight-blocks
select the block that is to the right of a block with a length of 3 inches	( call SW.listValue ( call SW.filter ( call SW.getProperty ( call SW.singleton en.block ) ( string ! type ) ) ( string right ) ( string = ) ( call SW.filter ( call SW.getProperty ( call SW.singleton en.block ) ( string ! type ) ) ( string length ) ( string = ) ( number 3 en.inch ) ) ) )	overnight-blocks
find me all blocks left of pyramid blocks	( call SW.listValue ( call SW.filter ( call SW.getProperty ( call SW.singleton en.block ) ( string ! type ) ) ( string left ) ( string = ) ( call SW.filter ( call SW.getProperty ( call SW.singleton en.block ) ( string ! type ) ) ( string shape ) ( string = ) en.shape.pyramid ) ) )	overnight-blocks
what block is at least as tall as block 1 is wide	( call SW.listValue ( call SW.filter ( call SW.getProperty ( call SW.singleton en.block ) ( string ! type ) ) ( call SW.ensureNumericProperty ( string height ) ) ( string >= ) ( call SW.ensureNumericEntity ( call SW.getProperty en.block.block1 ( string width ) ) ) ) )	overnight-blocks
find the blocks that are above and left to the block 1 	( call SW.listValue ( call SW.filter ( call SW.filter ( call SW.getProperty ( call SW.singleton en.block ) ( string ! type ) ) ( string above ) ( string = ) en.block.block1 ) ( string left ) ( string = ) en.block.block1 ) )	overnight-blocks
a pyramid or a cube	( call SW.listValue ( call SW.concat en.shape.pyramid en.shape.cube ) )	overnight-blocks
block whose length is width of block 1	( call SW.listValue ( call SW.filter ( call SW.getProperty ( call SW.singleton en.block ) ( string ! type ) ) ( string length ) ( string = ) ( call SW.getProperty en.block.block1 ( string width ) ) ) )	overnight-blocks
find a block whose width is three inches that block 1 is to the right of	( call SW.listValue ( call SW.filter ( call SW.filter ( call SW.getProperty ( call SW.singleton en.block ) ( string ! type ) ) ( call SW.reverse ( string right ) ) ( string = ) en.block.block1 ) ( string width ) ( string = ) ( number 3 en.inch ) ) )	overnight-blocks
find the block that is shaped like a pyramid or a cube	( call SW.listValue ( call SW.filter ( call SW.getProperty ( call SW.singleton en.block ) ( string ! type ) ) ( string shape ) ( string = ) ( call SW.concat en.shape.pyramid en.shape.cube ) ) )	overnight-blocks
find a block to the right and above block 1	( call SW.listValue ( call SW.filter ( call SW.getProperty ( call SW.singleton en.block ) ( string ! type ) ) ( string above ) ( string = ) ( call SW.filter ( call SW.getProperty ( call SW.singleton en.block ) ( string ! type ) ) ( string right ) ( string = ) en.block.block1 ) ) )	overnight-blocks
block whose width is at least height of block 1	( call SW.listValue ( call SW.filter ( call SW.getProperty ( call SW.singleton en.block ) ( string ! type ) ) ( call SW.ensureNumericProperty ( string width ) ) ( string >= ) ( call SW.ensureNumericEntity ( call SW.getProperty en.block.block1 ( string height ) ) ) ) )	overnight-blocks
block with one shape	( call SW.listValue ( call SW.countComparative ( call SW.getProperty ( call SW.singleton en.block ) ( string ! type ) ) ( string shape ) ( string < ) ( number 2 ) ) )	overnight-blocks
what is the height of block 1	( call SW.listValue ( call SW.getProperty en.block.block1 ( string height ) ) )	overnight-blocks
