housing units with 2 neighborhoods	( call SW.listValue ( call SW.countComparative ( call SW.getProperty ( call SW.singleton en.housing_unit ) ( string ! type ) ) ( string neighborhood ) ( string = ) ( number 2 ) ) )	overnight-housing
find me a housing unti that chagres 1500 for rent and has a priiiiiiat bathroom	( call SW.listValue ( call SW.filter ( call SW.filter ( call SW.getProperty ( call SW.singleton en.housing_unit ) ( string ! type ) ) ( string rent ) ( string = ) ( number 1500 en.dollar ) ) ( string has_private_room ) ) )	overnight-housing
housing with a private room and bath	( call SW.listValue ( call SW.filter ( call SW.filter ( call SW.getProperty ( call SW.singleton en.housing_unit ) ( string ! type ) ) ( string has_private_room ) ) ( string has_private_bath ) ) )	overnight-housing
apartment with a private room	( call SW.listValue ( call SW.filter ( call SW.filter ( call SW.getProperty ( call SW.singleton en.housing_unit ) ( string ! type ) ) ( string housing_type ) ( string = ) en.housing.apartment ) ( string has_private_room ) ) )	overnight-housing
housing posted before 123 sesame street	( call SW.listValue ( call SW.filter ( call SW.getProperty ( call SW.singleton en.housing_unit ) ( string ! type ) ) ( call SW.ensureNumericProperty ( string posting_date ) ) ( string < ) ( call SW.ensureNumericEntity ( call SW.getProperty en.housing_unit.123_sesame_street ( string posting_date ) ) ) ) )	overnight-housing
find cat friendly housing units with a private bath	( call SW.listValue ( call SW.filter ( call SW.filter ( call SW.getProperty ( call SW.singleton en.housing_unit ) ( string ! type ) ) ( string allows_cats ) ) ( string has_private_bath ) ) )	overnight-housing
find apartments with a private bath	( call SW.listValue ( call SW.filter ( call SW.filter ( call SW.getProperty ( call SW.singleton en.housing_unit ) ( string ! type ) ) ( string housing_type ) ( string = ) en.housing.apartment ) ( string has_private_bath ) ) )	overnight-housing
housing that was posted after january 2 or after february 3	( call SW.listValue ( call SW.filter ( call SW.getProperty ( call SW.singleton en.housing_unit ) ( string ! type ) ) ( call SW.ensureNumericProperty ( string posting_date ) ) ( string >= ) ( call SW.ensureNumericEntity ( call SW.concat ( date 2015 1 2 ) ( date 2015 2 3 ) ) ) ) )	overnight-housing
how much is 123 sesame street per month	( call SW.listValue ( call SW.getProperty en.housing_unit.123_sesame_street ( string rent ) ) )	overnight-housing
neighborhoods not near 123 sesame street	( call SW.listValue ( call SW.filter ( call SW.getProperty ( call SW.singleton en.neighborhood ) ( string ! type ) ) ( call SW.reverse ( string neighborhood ) ) ( string ! = ) en.housing_unit.123_sesame_street ) )	overnight-housing
800 square foot unit with rent of 1500 monthly	( call SW.listValue ( call SW.filter ( call SW.filter ( call SW.getProperty ( call SW.singleton en.housing_unit ) ( string ! type ) ) ( string rent ) ( string = ) ( number 1500 en.dollar ) ) ( string size ) ( string = ) ( number 800 en.square_feet ) ) )	overnight-housing
housing unit with a private bath and 1500 dollar rent	( call SW.listValue ( call SW.filter ( call SW.filter ( call SW.getProperty ( call SW.singleton en.housing_unit ) ( string ! type ) ) ( string has_private_bath ) ) ( string rent ) ( string = ) ( number 1500 en.dollar ) ) )	overnight-housing
which housing unit has a rent of 1500 dollars per month	( call SW.listValue ( call SW.filter ( call SW.getProperty ( call SW.singleton en.housing_unit ) ( string ! type ) ) ( call SW.ensureNumericProperty ( string rent ) ) ( string <= ) ( call SW.ensureNumericEntity ( number 1500 en.dollar ) ) ) )	overnight-housing
find apartments posted on january 2	( call SW.listValue ( call SW.filter ( call SW.filter ( call SW.getProperty ( call SW.singleton en.housing_unit ) ( string ! type ) ) ( string posting_date ) ( string = ) ( date 2015 1 2 ) ) ( string housing_type ) ( string = ) en.housing.apartment ) )	overnight-housing
housing with the same rent as 123 sesame street	( call SW.listValue ( call SW.filter ( call SW.getProperty ( call SW.singleton en.housing_unit ) ( string ! type ) ) ( string rent ) ( string = ) ( call SW.getProperty en.housing_unit.123_sesame_street ( string rent ) ) ) )	overnight-housing
housing 800 sq in size posted on january 2	( call SW.listValue ( call SW.filter ( call SW.filter ( call SW.getProperty ( call SW.singleton en.housing_unit ) ( string ! type ) ) ( string posting_date ) ( string = ) ( date 2015 1 2 ) ) ( string size ) ( string = ) ( number 800 en.square_feet ) ) )	overnight-housing
which housing unit has apartment kind of houses with an area of 800 square feet	( call SW.listValue ( call SW.filter ( call SW.filter ( call SW.getProperty ( call SW.singleton en.housing_unit ) ( string ! type ) ) ( string housing_type ) ( string = ) en.housing.apartment ) ( string size ) ( string = ) ( number 800 en.square_feet ) ) )	overnight-housing
800 square foot housing unit with a private room	( call SW.listValue ( call SW.filter ( call SW.filter ( call SW.getProperty ( call SW.singleton en.housing_unit ) ( string ! type ) ) ( string size ) ( string = ) ( number 800 en.square_feet ) ) ( string has_private_room ) ) )	overnight-housing
find all housing units posted on january 2	( call SW.listValue ( call SW.filter ( call SW.getProperty ( call SW.singleton en.housing ) ( string ! type ) ) ( call SW.reverse ( string housing_type ) ) ( string = ) ( call SW.filter ( call SW.getProperty ( call SW.singleton en.housing_unit ) ( string ! type ) ) ( string posting_date ) ( string = ) ( date 2015 1 2 ) ) ) )	overnight-housing
what is the neighborhood of the  housing unit with a private room	( call SW.listValue ( call SW.filter ( call SW.getProperty ( call SW.singleton en.neighborhood ) ( string ! type ) ) ( call SW.reverse ( string neighborhood ) ) ( string = ) ( call SW.filter ( call SW.getProperty ( call SW.singleton en.housing_unit ) ( string ! type ) ) ( string has_private_room ) ) ) )	overnight-housing
show me housing whose rent is 1500 dollars and which provides a private bathroom	( call SW.listValue ( call SW.filter ( call SW.filter ( call SW.getProperty ( call SW.singleton en.housing_unit ) ( string ! type ) ) ( string has_private_bath ) ) ( string rent ) ( string = ) ( number 1500 en.dollar ) ) )	overnight-housing
private housing in midtown west	( call SW.listValue ( call SW.filter ( call SW.filter ( call SW.getProperty ( call SW.singleton en.housing_unit ) ( string ! type ) ) ( string has_private_room ) ) ( string neighborhood ) ( string = ) en.neighborhood.midtown_west ) )	overnight-housing
housing with with largest posting date	( call SW.listValue ( call SW.superlative ( call SW.getProperty ( call SW.singleton en.housing_unit ) ( string ! type ) ) ( string max ) ( call SW.ensureNumericProperty ( string posting_date ) ) ) )	overnight-housing
a neighborhood with at most twohouse units	( call SW.listValue ( call SW.countComparative ( call SW.getProperty ( call SW.singleton en.neighborhood ) ( string ! type ) ) ( call SW.reverse ( string neighborhood ) ) ( string <= ) ( number 2 ) ( call SW.getProperty ( call SW.singleton en.housing_unit ) ( string ! type ) ) ) )	overnight-housing
looking for a unit with a private bathroom and dog friendly	( call SW.listValue ( call SW.filter ( call SW.filter ( call SW.getProperty ( call SW.singleton en.housing_unit ) ( string ! type ) ) ( string has_private_bath ) ) ( string allows_dogs ) ) )	overnight-housing
which housing type allows pets	( call SW.listValue ( call SW.filter ( call SW.getProperty ( call SW.singleton en.housing ) ( string ! type ) ) ( call SW.reverse ( string housing_type ) ) ( string = ) ( call SW.filter ( call SW.getProperty ( call SW.singleton en.housing_unit ) ( string ! type ) ) ( string allows_dogs ) ) ) )	overnight-housing
what housing unit posted on jan 2 is in midtown west	( call SW.listValue ( call SW.filter ( call SW.filter ( call SW.getProperty ( call SW.singleton en.housing_unit ) ( string ! type ) ) ( string posting_date ) ( string = ) ( date 2015 1 2 ) ) ( string neighborhood ) ( string = ) en.neighborhood.midtown_west ) )	overnight-housing
housing posted on or before january 2	( call SW.listValue ( call SW.filter ( call SW.getProperty ( call SW.singleton en.housing_unit ) ( string ! type ) ) ( call SW.ensureNumericProperty ( string posting_date ) ) ( string <= ) ( call SW.ensureNumericEntity ( date 2015 1 2 ) ) ) )	overnight-housing
which housing unit with an area of 800 square feet is available fora rent of 1500 dollars per month	( call SW.listValue ( call SW.filter ( call SW.filter ( call SW.getProperty ( call SW.singleton en.housing_unit ) ( string ! type ) ) ( string size ) ( string = ) ( number 800 en.square_feet ) ) ( string rent ) ( string = ) ( number 1500 en.dollar ) ) )	overnight-housing
smallest apartments	( call SW.listValue ( call SW.superlative ( call SW.getProperty ( call SW.singleton en.housing_unit ) ( string ! type ) ) ( string min ) ( call SW.ensureNumericProperty ( string size ) ) ) )	overnight-housing
which housing posted jan 2nd permits cats	( call SW.listValue ( call SW.filter ( call SW.filter ( call SW.getProperty ( call SW.singleton en.housing_unit ) ( string ! type ) ) ( string allows_cats ) ) ( string posting_date ) ( string = ) ( date 2015 1 2 ) ) )	overnight-housing
area around 123sesame street	( call SW.listValue ( call SW.getProperty en.housing_unit.123_sesame_street ( string neighborhood ) ) )	overnight-housing
find housing that has a private room and bath	( call SW.listValue ( call SW.filter ( call SW.filter ( call SW.getProperty ( call SW.singleton en.housing_unit ) ( string ! type ) ) ( string has_private_bath ) ) ( string has_private_room ) ) )	overnight-housing
catfriendly apartments with a private room	( call SW.listValue ( call SW.filter ( call SW.filter ( call SW.getProperty ( call SW.singleton en.housing_unit ) ( string ! type ) ) ( string allows_cats ) ) ( string has_private_room ) ) )	overnight-housing
housing posted on january 2nd that allows dogs	( call SW.listValue ( call SW.filter ( call SW.filter ( call SW.getProperty ( call SW.singleton en.housing_unit ) ( string ! type ) ) ( string allows_dogs ) ) ( string posting_date ) ( string = ) ( date 2015 1 2 ) ) )	overnight-housing
apartments similar in size to 123 sesame street	( call SW.listValue ( call SW.filter ( call SW.getProperty ( call SW.singleton en.housing_unit ) ( string ! type ) ) ( string size ) ( string = ) ( call SW.getProperty en.housing_unit.123_sesame_street ( string size ) ) ) )	overnight-housing
which housing unit has an area of 800 square feet	( call SW.listValue ( call SW.filter ( call SW.filter ( call SW.getProperty ( call SW.singleton en.housing_unit ) ( string ! type ) ) ( string size ) ( string = ) ( number 800 en.square_feet ) ) ( string size ) ( string = ) ( number 800 en.square_feet ) ) )	overnight-housing
housing in a neighborhood larger than two houses	( call SW.listValue ( call SW.countComparative ( call SW.getProperty ( call SW.singleton en.neighborhood ) ( string ! type ) ) ( call SW.reverse ( string neighborhood ) ) ( string > ) ( number 2 ) ( call SW.getProperty ( call SW.singleton en.housing_unit ) ( string ! type ) ) ) )	overnight-housing
housing that allows dogs and was posted on january 2	( call SW.listValue ( call SW.filter ( call SW.filter ( call SW.getProperty ( call SW.singleton en.housing_unit ) ( string ! type ) ) ( string posting_date ) ( string = ) ( date 2015 1 2 ) ) ( string allows_dogs ) ) )	overnight-housing
housing posted before or on the same day as 123 sesame street	( call SW.listValue ( call SW.filter ( call SW.getProperty ( call SW.singleton en.housing_unit ) ( string ! type ) ) ( call SW.ensureNumericProperty ( string posting_date ) ) ( string <= ) ( call SW.ensureNumericEntity ( call SW.getProperty en.housing_unit.123_sesame_street ( string posting_date ) ) ) ) )	overnight-housing
find a housing unit posted on january 2 and that has a private room	( call SW.listValue ( call SW.filter ( call SW.filter ( call SW.getProperty ( call SW.singleton en.housing_unit ) ( string ! type ) ) ( string posting_date ) ( string = ) ( date 2015 1 2 ) ) ( string has_private_room ) ) )	overnight-housing
housing that was posted on february 3	( call SW.listValue ( call SW.filter ( call SW.getProperty ( call SW.singleton en.housing_unit ) ( string ! type ) ) ( call SW.ensureNumericProperty ( string posting_date ) ) ( string >= ) ( call SW.ensureNumericEntity ( call SW.concat ( date 2015 1 2 ) ( date 2015 2 3 ) ) ) ) )	overnight-housing
housing unit sizes on 123 sesame street	( call SW.listValue ( call SW.filter ( call SW.getProperty ( call SW.singleton en.housing_unit ) ( string ! type ) ) ( string size ) ( string = ) ( call SW.getProperty en.housing_unit.123_sesame_street ( string size ) ) ) )	overnight-housing
which housing unit has an apartment kind of house	( call SW.listValue ( call SW.filter ( call SW.getProperty ( call SW.singleton en.housing ) ( string ! type ) ) ( call SW.reverse ( string housing_type ) ) ( string = ) ( call SW.filter ( call SW.getProperty ( call SW.singleton en.housing_unit ) ( string ! type ) ) ( string housing_type ) ( string = ) en.housing.apartment ) ) )	overnight-housing
housing unit that allows dogs and has a private bath	( call SW.listValue ( call SW.filter ( call SW.filter ( call SW.getProperty ( call SW.singleton en.housing_unit ) ( string ! type ) ) ( string allows_dogs ) ) ( string has_private_bath ) ) )	overnight-housing
what is the average size of an apartment	( call SW.listValue ( call SW.aggregate ( string avg ) ( call SW.getProperty ( call SW.getProperty ( call SW.singleton en.housing_unit ) ( string ! type ) ) ( string size ) ) ) )	overnight-housing
housing unit which is an apartment that is dogs friendly	( call SW.listValue ( call SW.filter ( call SW.filter ( call SW.getProperty ( call SW.singleton en.housing_unit ) ( string ! type ) ) ( string allows_dogs ) ) ( string housing_type ) ( string = ) en.housing.apartment ) )	overnight-housing
housing listed in the fewest neighborhoods	( call SW.listValue ( call SW.countSuperlative ( call SW.getProperty ( call SW.singleton en.housing_unit ) ( string ! type ) ) ( string min ) ( string neighborhood ) ) )	overnight-housing
what is the average price of apartments	( call SW.listValue ( call SW.aggregate ( string avg ) ( call SW.getProperty ( call SW.getProperty ( call SW.singleton en.housing_unit ) ( string ! type ) ) ( string rent ) ) ) )	overnight-housing
housing unit posted after january 2 or february 3	( call SW.listValue ( call SW.filter ( call SW.getProperty ( call SW.singleton en.housing_unit ) ( string ! type ) ) ( call SW.ensureNumericProperty ( string posting_date ) ) ( string > ) ( call SW.ensureNumericEntity ( call SW.concat ( date 2015 1 2 ) ( date 2015 2 3 ) ) ) ) )	overnight-housing
find housing units with rental charges lesser than 2000 dollars	( call SW.listValue ( call SW.filter ( call SW.getProperty ( call SW.singleton en.housing_unit ) ( string ! type ) ) ( call SW.ensureNumericProperty ( string rent ) ) ( string < ) ( call SW.ensureNumericEntity ( call SW.concat ( number 1500 en.dollar ) ( number 2000 en.dollar ) ) ) ) )	overnight-housing
what kind of housing type is the only of its kind	( call SW.listValue ( call SW.countComparative ( call SW.getProperty ( call SW.singleton en.housing ) ( string ! type ) ) ( call SW.reverse ( string housing_type ) ) ( string < ) ( number 2 ) ( call SW.getProperty ( call SW.singleton en.housing_unit ) ( string ! type ) ) ) )	overnight-housing
housing units with one housing type	( call SW.listValue ( call SW.countComparative ( call SW.getProperty ( call SW.singleton en.housing_unit ) ( string ! type ) ) ( string housing_type ) ( string < ) ( number 2 ) ) )	overnight-housing
housing that allows cats and includes a private bath	( call SW.listValue ( call SW.filter ( call SW.filter ( call SW.getProperty ( call SW.singleton en.housing_unit ) ( string ! type ) ) ( string allows_cats ) ) ( string has_private_bath ) ) )	overnight-housing
housing posted on january 2 around 123 sesame street	( call SW.listValue ( call SW.filter ( call SW.filter ( call SW.getProperty ( call SW.singleton en.housing_unit ) ( string ! type ) ) ( string posting_date ) ( string = ) ( date 2015 1 2 ) ) ( call SW.reverse ( string neighborhood ) ) ( string = ) en.housing_unit.123_sesame_street ) )	overnight-housing
housing unit with the same monthly rent as 123 sesame street	( call SW.listValue ( call SW.filter ( call SW.getProperty ( call SW.singleton en.housing_unit ) ( string ! type ) ) ( string rent ) ( string = ) ( call SW.getProperty en.housing_unit.123_sesame_street ( string rent ) ) ) )	overnight-housing
housing unit within at most 2 neighborhoods	( call SW.listValue ( call SW.countComparative ( call SW.getProperty ( call SW.singleton en.housing_unit ) ( string ! type ) ) ( string neighborhood ) ( string <= ) ( number 2 ) ) )	overnight-housing
show me the housing with the most space available	( call SW.listValue ( call SW.superlative ( call SW.getProperty ( call SW.singleton en.housing_unit ) ( string ! type ) ) ( string max ) ( call SW.ensureNumericProperty ( string size ) ) ) )	overnight-housing
what is the monthly rent of this apartment	( call SW.listValue ( call SW.aggregate ( string sum ) ( call SW.getProperty ( call SW.getProperty ( call SW.singleton en.housing_unit ) ( string ! type ) ) ( string rent ) ) ) )	overnight-housing
housing unit with posting date less than that of 123 sesame street	( call SW.listValue ( call SW.filter ( call SW.getProperty ( call SW.singleton en.housing_unit ) ( string ! type ) ) ( call SW.ensureNumericProperty ( string posting_date ) ) ( string < ) ( call SW.ensureNumericEntity ( call SW.getProperty en.housing_unit.123_sesame_street ( string posting_date ) ) ) ) )	overnight-housing
find 800 square feet housing units in the neighborhoods of midtown west	( call SW.listValue ( call SW.filter ( call SW.filter ( call SW.getProperty ( call SW.singleton en.housing_unit ) ( string ! type ) ) ( string neighborhood ) ( string = ) en.neighborhood.midtown_west ) ( string size ) ( string = ) ( number 800 en.square_feet ) ) )	overnight-housing
what kind of housing is 123 sesame street or 900 mission ave	( call SW.listValue ( call SW.filter ( call SW.getProperty ( call SW.singleton en.housing ) ( string ! type ) ) ( call SW.reverse ( string housing_type ) ) ( string = ) ( call SW.concat en.housing_unit.123_sesame_street en.housing_unit.900_mission_ave ) ) )	overnight-housing
find housing units with 1500 dollars to 2000 as rent	( call SW.listValue ( call SW.filter ( call SW.getProperty ( call SW.singleton en.housing_unit ) ( string ! type ) ) ( call SW.ensureNumericProperty ( string rent ) ) ( string <= ) ( call SW.ensureNumericEntity ( call SW.concat ( number 1500 en.dollar ) ( number 2000 en.dollar ) ) ) ) )	overnight-housing
what is the kind of housing available in 123 sesamre street	( call SW.listValue ( call SW.filter ( call SW.getProperty ( call SW.singleton en.housing ) ( string ! type ) ) ( call SW.reverse ( string housing_type ) ) ( string = ) en.housing_unit.123_sesame_street ) )	overnight-housing
what are the  units that  do  not belong to the area around midtown west	( call SW.listValue ( call SW.filter ( call SW.getProperty ( call SW.singleton en.housing_unit ) ( string ! type ) ) ( string neighborhood ) ( string ! = ) en.neighborhood.midtown_west ) )	overnight-housing
800 square foot apartments	( call SW.listValue ( call SW.filter ( call SW.getProperty ( call SW.singleton en.housing_unit ) ( string ! type ) ) ( call SW.ensureNumericProperty ( string size ) ) ( string <= ) ( call SW.ensureNumericEntity ( number 800 en.square_feet ) ) ) )	overnight-housing
housing unit in west midtown posted on january 2	( call SW.listValue ( call SW.filter ( call SW.filter ( call SW.getProperty ( call SW.singleton en.housing_unit ) ( string ! type ) ) ( string posting_date ) ( string = ) ( date 2015 1 2 ) ) ( string neighborhood ) ( string = ) en.neighborhood.midtown_west ) )	overnight-housing
apartments 800 square feet and above	( call SW.listValue ( call SW.filter ( call SW.getProperty ( call SW.singleton en.housing_unit ) ( string ! type ) ) ( call SW.ensureNumericProperty ( string size ) ) ( string >= ) ( call SW.ensureNumericEntity ( number 800 en.square_feet ) ) ) )	overnight-housing
what apartment costs 1500 dollars	( call SW.listValue ( call SW.filter ( call SW.filter ( call SW.getProperty ( call SW.singleton en.housing_unit ) ( string ! type ) ) ( string housing_type ) ( string = ) en.housing.apartment ) ( string rent ) ( string = ) ( number 1500 en.dollar ) ) )	overnight-housing
which housing unit resembles 123 sesame street in size	( call SW.listValue ( call SW.filter ( call SW.getProperty ( call SW.singleton en.housing_unit ) ( string ! type ) ) ( string size ) ( string = ) ( call SW.getProperty en.housing_unit.123_sesame_street ( string size ) ) ) )	overnight-housing
which housing unit has the smallest size	( call SW.listValue ( call SW.superlative ( call SW.getProperty ( call SW.singleton en.housing_unit ) ( string ! type ) ) ( string min ) ( call SW.ensureNumericProperty ( string size ) ) ) )	overnight-housing
what housing unit was posted on jan 2	( call SW.listValue ( call SW.filter ( call SW.getProperty ( call SW.singleton en.housing_unit ) ( string ! type ) ) ( string posting_date ) ( string = ) ( call SW.filter ( call SW.getProperty ( call SW.singleton en.housing_unit ) ( string ! type ) ) ( string posting_date ) ( string = ) ( date 2015 1 2 ) ) ) )	overnight-housing
which housing unit with an area of 800 square feet has a private room	( call SW.listValue ( call SW.filter ( call SW.filter ( call SW.getProperty ( call SW.singleton en.housing_unit ) ( string ! type ) ) ( string has_private_room ) ) ( string size ) ( string = ) ( number 800 en.square_feet ) ) )	overnight-housing
apartments with a private bathroom that allow cats	( call SW.listValue ( call SW.filter ( call SW.filter ( call SW.getProperty ( call SW.singleton en.housing_unit ) ( string ! type ) ) ( string has_private_room ) ) ( string allows_cats ) ) )	overnight-housing
apartments that are dog friendly	( call SW.listValue ( call SW.filter ( call SW.filter ( call SW.getProperty ( call SW.singleton en.housing_unit ) ( string ! type ) ) ( string allows_dogs ) ) ( string allows_dogs ) ) )	overnight-housing
which housing unit is in midtown west and was posted on january 2	( call SW.listValue ( call SW.filter ( call SW.filter ( call SW.getProperty ( call SW.singleton en.housing_unit ) ( string ! type ) ) ( string neighborhood ) ( string = ) en.neighborhood.midtown_west ) ( string posting_date ) ( string = ) ( date 2015 1 2 ) ) )	overnight-housing
specify the housing type of the housing unit that has a private bath	( call SW.listValue ( call SW.filter ( call SW.getProperty ( call SW.singleton en.housing ) ( string ! type ) ) ( call SW.reverse ( string housing_type ) ) ( string = ) ( call SW.filter ( call SW.getProperty ( call SW.singleton en.housing_unit ) ( string ! type ) ) ( string has_private_bath ) ) ) )	overnight-housing
which housing unit is available in the area around mid town west	( call SW.listValue ( call SW.filter ( call SW.filter ( call SW.getProperty ( call SW.singleton en.housing_unit ) ( string ! type ) ) ( string neighborhood ) ( string = ) en.neighborhood.midtown_west ) ( string neighborhood ) ( string = ) en.neighborhood.midtown_west ) )	overnight-housing
housing that has at least two types	( call SW.listValue ( call SW.countComparative ( call SW.getProperty ( call SW.singleton en.housing_unit ) ( string ! type ) ) ( string housing_type ) ( string >= ) ( number 2 ) ) )	overnight-housing
apartments with a private bathroom	( call SW.listValue ( call SW.filter ( call SW.getProperty ( call SW.singleton en.housing ) ( string ! type ) ) ( call SW.reverse ( string housing_type ) ) ( string = ) ( call SW.filter ( call SW.getProperty ( call SW.singleton en.housing_unit ) ( string ! type ) ) ( string has_private_bath ) ) ) )	overnight-housing
which housing unit permits dogs and has the facility of a private room	( call SW.listValue ( call SW.filter ( call SW.filter ( call SW.getProperty ( call SW.singleton en.housing_unit ) ( string ! type ) ) ( string has_private_room ) ) ( string allows_dogs ) ) )	overnight-housing
which housing units in the neighbourhood permits dogs inside it	( call SW.listValue ( call SW.filter ( call SW.getProperty ( call SW.singleton en.neighborhood ) ( string ! type ) ) ( call SW.reverse ( string neighborhood ) ) ( string = ) ( call SW.filter ( call SW.getProperty ( call SW.singleton en.housing_unit ) ( string ! type ) ) ( string allows_dogs ) ) ) )	overnight-housing
what housing unit has 2 or more types	( call SW.listValue ( call SW.countComparative ( call SW.getProperty ( call SW.singleton en.housing_unit ) ( string ! type ) ) ( string housing_type ) ( string >= ) ( number 2 ) ) )	overnight-housing
what is the date of 123 sesame street posting	( call SW.listValue ( call SW.getProperty en.housing_unit.123_sesame_street ( string posting_date ) ) )	overnight-housing
housing with more square footage than 123 sesame street	( call SW.listValue ( call SW.filter ( call SW.getProperty ( call SW.singleton en.housing_unit ) ( string ! type ) ) ( call SW.ensureNumericProperty ( string size ) ) ( string > ) ( call SW.ensureNumericEntity ( call SW.getProperty en.housing_unit.123_sesame_street ( string size ) ) ) ) )	overnight-housing
housing that is at least 800 square feet or at least 1000 square feet	( call SW.listValue ( call SW.filter ( call SW.getProperty ( call SW.singleton en.housing_unit ) ( string ! type ) ) ( call SW.ensureNumericProperty ( string size ) ) ( string >= ) ( call SW.ensureNumericEntity ( call SW.concat ( number 800 en.square_feet ) ( number 1000 en.square_feet ) ) ) ) )	overnight-housing
find housing units posted before january 2nd	( call SW.listValue ( call SW.filter ( call SW.getProperty ( call SW.singleton en.housing_unit ) ( string ! type ) ) ( call SW.ensureNumericProperty ( string posting_date ) ) ( string <= ) ( call SW.ensureNumericEntity ( date 2015 1 2 ) ) ) )	overnight-housing
what is that housing unit size	( call SW.listValue ( call SW.aggregate ( string sum ) ( call SW.getProperty ( call SW.getProperty ( call SW.singleton en.housing_unit ) ( string ! type ) ) ( string size ) ) ) )	overnight-housing
apartments posted on january 2	( call SW.listValue ( call SW.filter ( call SW.getProperty ( call SW.singleton en.housing_unit ) ( string ! type ) ) ( call SW.ensureNumericProperty ( string posting_date ) ) ( string <= ) ( call SW.ensureNumericEntity ( date 2015 1 2 ) ) ) )	overnight-housing
find housing with rental charges between 1500 and 2000 dollars	( call SW.listValue ( call SW.filter ( call SW.getProperty ( call SW.singleton en.housing_unit ) ( string ! type ) ) ( string rent ) ( string = ) ( call SW.concat ( number 1500 en.dollar ) ( number 2000 en.dollar ) ) ) )	overnight-housing
what is the phone number of this apartment complex	( call SW.listValue ( call .size ( call SW.getProperty ( call SW.singleton en.housing ) ( string ! type ) ) ) )	overnight-housing
dog and cat friendly housing	( call SW.listValue ( call SW.filter ( call SW.filter ( call SW.getProperty ( call SW.singleton en.housing_unit ) ( string ! type ) ) ( string allows_cats ) ) ( string allows_dogs ) ) )	overnight-housing
neighborhood of 123 sesame street or 900 mission ave	( call SW.listValue ( call SW.filter ( call SW.getProperty ( call SW.singleton en.neighborhood ) ( string ! type ) ) ( call SW.reverse ( string neighborhood ) ) ( string = ) ( call SW.concat en.housing_unit.123_sesame_street en.housing_unit.900_mission_ave ) ) )	overnight-housing
which housing unit has apartment kind of house with an area of 800 square feet	( call SW.listValue ( call SW.filter ( call SW.filter ( call SW.getProperty ( call SW.singleton en.housing_unit ) ( string ! type ) ) ( string size ) ( string = ) ( number 800 en.square_feet ) ) ( string housing_type ) ( string = ) en.housing.apartment ) )	overnight-housing
midtown west unit with 1500 rent monthly	( call SW.listValue ( call SW.filter ( call SW.filter ( call SW.getProperty ( call SW.singleton en.housing_unit ) ( string ! type ) ) ( string rent ) ( string = ) ( number 1500 en.dollar ) ) ( string neighborhood ) ( string = ) en.neighborhood.midtown_west ) )	overnight-housing
what is the monthly rent of housing units posted on january 2nd	( call SW.listValue ( call SW.filter ( call SW.getProperty ( call SW.singleton en.housing_unit ) ( string ! type ) ) ( string rent ) ( string = ) ( call SW.filter ( call SW.getProperty ( call SW.singleton en.housing_unit ) ( string ! type ) ) ( string posting_date ) ( string = ) ( date 2015 1 2 ) ) ) )	overnight-housing
which housing unit has houses of apartment kind	( call SW.listValue ( call SW.filter ( call SW.filter ( call SW.getProperty ( call SW.singleton en.housing_unit ) ( string ! type ) ) ( string housing_type ) ( string = ) en.housing.apartment ) ( string housing_type ) ( string = ) en.housing.apartment ) )	overnight-housing
what housing unit is in two neighborhoods	( call SW.listValue ( call SW.countComparative ( call SW.getProperty ( call SW.singleton en.housing_unit ) ( string ! type ) ) ( string neighborhood ) ( string = ) ( number 2 ) ) )	overnight-housing
find housing that allows dogs and cats	( call SW.listValue ( call SW.filter ( call SW.filter ( call SW.getProperty ( call SW.singleton en.housing_unit ) ( string ! type ) ) ( string allows_dogs ) ) ( string allows_cats ) ) )	overnight-housing
when was 123 sesame street posted	( call SW.listValue ( call SW.getProperty en.housing_unit.123_sesame_street ( string posting_date ) ) )	overnight-housing
show me housing in midtown west where dogs are welcome	( call SW.listValue ( call SW.filter ( call SW.filter ( call SW.getProperty ( call SW.singleton en.housing_unit ) ( string ! type ) ) ( string neighborhood ) ( string = ) en.neighborhood.midtown_west ) ( string allows_dogs ) ) )	overnight-housing
apartments in the midtown west neighborhood	( call SW.listValue ( call SW.filter ( call SW.filter ( call SW.getProperty ( call SW.singleton en.housing_unit ) ( string ! type ) ) ( string housing_type ) ( string = ) en.housing.apartment ) ( string neighborhood ) ( string = ) en.neighborhood.midtown_west ) )	overnight-housing
units that have a private room	( call SW.listValue ( call SW.filter ( call SW.filter ( call SW.getProperty ( call SW.singleton en.housing_unit ) ( string ! type ) ) ( string has_private_room ) ) ( string has_private_room ) ) )	overnight-housing
800 square foot apartment with private bathroom	( call SW.listValue ( call SW.filter ( call SW.filter ( call SW.getProperty ( call SW.singleton en.housing_unit ) ( string ! type ) ) ( string size ) ( string = ) ( number 800 en.square_feet ) ) ( string has_private_bath ) ) )	overnight-housing
show me housing with 800 square feet of space where cats are acceptable	( call SW.listValue ( call SW.filter ( call SW.filter ( call SW.getProperty ( call SW.singleton en.housing_unit ) ( string ! type ) ) ( string allows_cats ) ) ( string size ) ( string = ) ( number 800 en.square_feet ) ) )	overnight-housing
what kind of housing is the housing unit posted on jan 2	( call SW.listValue ( call SW.filter ( call SW.getProperty ( call SW.singleton en.housing ) ( string ! type ) ) ( call SW.reverse ( string housing_type ) ) ( string = ) ( call SW.filter ( call SW.getProperty ( call SW.singleton en.housing_unit ) ( string ! type ) ) ( string posting_date ) ( string = ) ( date 2015 1 2 ) ) ) )	overnight-housing
which neighborhoods have housing where dogs are allowed	( call SW.listValue ( call SW.filter ( call SW.getProperty ( call SW.singleton en.neighborhood ) ( string ! type ) ) ( call SW.reverse ( string neighborhood ) ) ( string = ) ( call SW.filter ( call SW.getProperty ( call SW.singleton en.housing_unit ) ( string ! type ) ) ( string allows_dogs ) ) ) )	overnight-housing
housing units with a private bath	( call SW.listValue ( call SW.filter ( call SW.getProperty ( call SW.singleton en.housing_unit ) ( string ! type ) ) ( string has_private_bath ) ) )	overnight-housing
housing unit bigger than 800 square feet	( call SW.listValue ( call SW.filter ( call SW.getProperty ( call SW.singleton en.housing_unit ) ( string ! type ) ) ( call SW.ensureNumericProperty ( string size ) ) ( string >= ) ( call SW.ensureNumericEntity ( number 800 en.square_feet ) ) ) )	overnight-housing
apartments with rent that is more expensive than 123 sesame street	( call SW.listValue ( call SW.filter ( call SW.getProperty ( call SW.singleton en.housing_unit ) ( string ! type ) ) ( call SW.ensureNumericProperty ( string rent ) ) ( string > ) ( call SW.ensureNumericEntity ( call SW.getProperty en.housing_unit.123_sesame_street ( string rent ) ) ) ) )	overnight-housing
housing units that have a private room that was posted on january 2	( call SW.listValue ( call SW.filter ( call SW.filter ( call SW.getProperty ( call SW.singleton en.housing_unit ) ( string ! type ) ) ( string has_private_room ) ) ( string posting_date ) ( string = ) ( date 2015 1 2 ) ) )	overnight-housing
apartments that were posted on january 2	( call SW.listValue ( call SW.filter ( call SW.filter ( call SW.getProperty ( call SW.singleton en.housing_unit ) ( string ! type ) ) ( string housing_type ) ( string = ) en.housing.apartment ) ( string posting_date ) ( string = ) ( date 2015 1 2 ) ) )	overnight-housing
what housing unit contains a private bath	( call SW.listValue ( call SW.filter ( call SW.getProperty ( call SW.singleton en.housing_unit ) ( string ! type ) ) ( string has_private_bath ) ) )	overnight-housing
what housing has been posted lately	( call SW.listValue ( call SW.superlative ( call SW.getProperty ( call SW.singleton en.housing_unit ) ( string ! type ) ) ( string min ) ( call SW.ensureNumericProperty ( string posting_date ) ) ) )	overnight-housing
housing that accepts dogs	( call SW.listValue ( call SW.filter ( call SW.getProperty ( call SW.singleton en.housing_unit ) ( string ! type ) ) ( string allows_dogs ) ) )	overnight-housing
show only neighborhood units of 800 square feet	( call SW.listValue ( call SW.filter ( call SW.getProperty ( call SW.singleton en.neighborhood ) ( string ! type ) ) ( call SW.reverse ( string neighborhood ) ) ( string = ) ( call SW.filter ( call SW.getProperty ( call SW.singleton en.housing_unit ) ( string ! type ) ) ( string size ) ( string = ) ( number 800 en.square_feet ) ) ) )	overnight-housing
housing units with less than two nieghborhoods	( call SW.listValue ( call SW.countComparative ( call SW.getProperty ( call SW.singleton en.housing_unit ) ( string ! type ) ) ( string neighborhood ) ( string < ) ( number 2 ) ) )	overnight-housing
what kind of housing has two housing types	( call SW.listValue ( call SW.countComparative ( call SW.getProperty ( call SW.singleton en.housing_unit ) ( string ! type ) ) ( string housing_type ) ( string >= ) ( number 2 ) ) )	overnight-housing
what neighborhood is the housing unit in that was posted january 2	( call SW.listValue ( call SW.filter ( call SW.getProperty ( call SW.singleton en.housing_unit ) ( string ! type ) ) ( string neighborhood ) ( string = ) ( call SW.filter ( call SW.getProperty ( call SW.singleton en.housing_unit ) ( string ! type ) ) ( string posting_date ) ( string = ) ( date 2015 1 2 ) ) ) )	overnight-housing
housing unit smaller than 800 square feet	( call SW.listValue ( call SW.filter ( call SW.getProperty ( call SW.singleton en.housing_unit ) ( string ! type ) ) ( call SW.ensureNumericProperty ( string size ) ) ( string < ) ( call SW.ensureNumericEntity ( number 800 en.square_feet ) ) ) )	overnight-housing
housing unit with a private room and bath	( call SW.listValue ( call SW.filter ( call SW.filter ( call SW.getProperty ( call SW.singleton en.housing_unit ) ( string ! type ) ) ( string has_private_room ) ) ( string has_private_bath ) ) )	overnight-housing
find 800 square feet housing units of the type apartment	( call SW.listValue ( call SW.filter ( call SW.filter ( call SW.getProperty ( call SW.singleton en.housing_unit ) ( string ! type ) ) ( string size ) ( string = ) ( number 800 en.square_feet ) ) ( string housing_type ) ( string = ) en.housing.apartment ) )	overnight-housing
which housing units permit dogs and cats	( call SW.listValue ( call SW.filter ( call SW.filter ( call SW.getProperty ( call SW.singleton en.housing_unit ) ( string ! type ) ) ( string allows_cats ) ) ( string allows_dogs ) ) )	overnight-housing
housing costing more than 1500 dollars per month	( call SW.listValue ( call SW.filter ( call SW.getProperty ( call SW.singleton en.housing_unit ) ( string ! type ) ) ( call SW.ensureNumericProperty ( string rent ) ) ( string > ) ( call SW.ensureNumericEntity ( number 1500 en.dollar ) ) ) )	overnight-housing
housing unit that costs 1500 dollars rent and allows dogs	( call SW.listValue ( call SW.filter ( call SW.filter ( call SW.getProperty ( call SW.singleton en.housing_unit ) ( string ! type ) ) ( string rent ) ( string = ) ( number 1500 en.dollar ) ) ( string allows_dogs ) ) )	overnight-housing
apartments at 800 square feet	( call SW.listValue ( call SW.filter ( call SW.filter ( call SW.getProperty ( call SW.singleton en.housing_unit ) ( string ! type ) ) ( string housing_type ) ( string = ) en.housing.apartment ) ( string size ) ( string = ) ( number 800 en.square_feet ) ) )	overnight-housing
building with two or less kinds of unis	( call SW.listValue ( call SW.countComparative ( call SW.getProperty ( call SW.singleton en.housing_unit ) ( string ! type ) ) ( string housing_type ) ( string <= ) ( number 2 ) ) )	overnight-housing
how  many neighbourhoods are there	( call SW.listValue ( call .size ( call SW.getProperty ( call SW.singleton en.neighborhood ) ( string ! type ) ) ) )	overnight-housing
which neighborhoods have dogfriendly housing	( call SW.listValue ( call SW.filter ( call SW.getProperty ( call SW.singleton en.neighborhood ) ( string ! type ) ) ( call SW.reverse ( string neighborhood ) ) ( string = ) ( call SW.filter ( call SW.getProperty ( call SW.singleton en.housing_unit ) ( string ! type ) ) ( string allows_dogs ) ) ) )	overnight-housing
find housing that is an apartment	( call SW.listValue ( call SW.filter ( call SW.filter ( call SW.getProperty ( call SW.singleton en.housing_unit ) ( string ! type ) ) ( string housing_type ) ( string = ) en.housing.apartment ) ( string housing_type ) ( string = ) en.housing.apartment ) )	overnight-housing
list all apartments in midtown west	( call SW.listValue ( call SW.filter ( call SW.filter ( call SW.getProperty ( call SW.singleton en.housing_unit ) ( string ! type ) ) ( string housing_type ) ( string = ) en.housing.apartment ) ( string neighborhood ) ( string = ) en.neighborhood.midtown_west ) )	overnight-housing
list all housing that have the size of 800 or 1000 square feet	( call SW.listValue ( call SW.concat ( number 800 en.square_feet ) ( number 1000 en.square_feet ) ) )	overnight-housing
either 800 or 1000 square feet	( call SW.listValue ( call SW.concat ( number 800 en.square_feet ) ( number 1000 en.square_feet ) ) )	overnight-housing
apartments with less than 2 units	( call SW.listValue ( call SW.countComparative ( call SW.getProperty ( call SW.singleton en.housing_unit ) ( string ! type ) ) ( string housing_type ) ( string < ) ( number 2 ) ) )	overnight-housing
which housing unit with an area of 800 square feet has the facility of a private room	( call SW.listValue ( call SW.filter ( call SW.filter ( call SW.getProperty ( call SW.singleton en.housing_unit ) ( string ! type ) ) ( string size ) ( string = ) ( number 800 en.square_feet ) ) ( string has_private_room ) ) )	overnight-housing
find cat friendly housing units that charge 1500 dollars as rent	( call SW.listValue ( call SW.filter ( call SW.filter ( call SW.getProperty ( call SW.singleton en.housing_unit ) ( string ! type ) ) ( string allows_cats ) ) ( string rent ) ( string = ) ( number 1500 en.dollar ) ) )	overnight-housing
which housing offers less than two kinds of units	( call SW.listValue ( call SW.countComparative ( call SW.getProperty ( call SW.singleton en.housing_unit ) ( string ! type ) ) ( string housing_type ) ( string < ) ( number 2 ) ) )	overnight-housing
housing that is over 800 square feet or over 1000 square feet	( call SW.listValue ( call SW.filter ( call SW.getProperty ( call SW.singleton en.housing_unit ) ( string ! type ) ) ( call SW.ensureNumericProperty ( string size ) ) ( string > ) ( call SW.ensureNumericEntity ( call SW.concat ( number 800 en.square_feet ) ( number 1000 en.square_feet ) ) ) ) )	overnight-housing
what are housing types found in the neighborhoods of midtown west	( call SW.listValue ( call SW.filter ( call SW.getProperty ( call SW.singleton en.housing ) ( string ! type ) ) ( call SW.reverse ( string housing_type ) ) ( string = ) ( call SW.filter ( call SW.getProperty ( call SW.singleton en.housing_unit ) ( string ! type ) ) ( string neighborhood ) ( string = ) en.neighborhood.midtown_west ) ) )	overnight-housing
apartment with a master bathroom	( call SW.listValue ( call SW.filter ( call SW.getProperty ( call SW.singleton en.housing_unit ) ( string ! type ) ) ( string has_private_bath ) ) )	overnight-housing
what is the housing type of the housing unit with a private room	( call SW.listValue ( call SW.filter ( call SW.getProperty ( call SW.singleton en.housing ) ( string ! type ) ) ( call SW.reverse ( string housing_type ) ) ( string = ) ( call SW.filter ( call SW.getProperty ( call SW.singleton en.housing_unit ) ( string ! type ) ) ( string has_private_room ) ) ) )	overnight-housing
housing that was posted on january 2	( call SW.listValue ( call SW.filter ( call SW.getProperty ( call SW.singleton en.housing_unit ) ( string ! type ) ) ( call SW.ensureNumericProperty ( string posting_date ) ) ( string >= ) ( call SW.ensureNumericEntity ( date 2015 1 2 ) ) ) )	overnight-housing
find 800 square feet housing units that are cat friendly	( call SW.listValue ( call SW.filter ( call SW.filter ( call SW.getProperty ( call SW.singleton en.housing_unit ) ( string ! type ) ) ( string allows_cats ) ) ( string size ) ( string = ) ( number 800 en.square_feet ) ) )	overnight-housing
find housing units around the neighborhoods of 123 sesame street	( call SW.listValue ( call SW.filter ( call SW.getProperty ( call SW.singleton en.housing_unit ) ( string ! type ) ) ( string neighborhood ) ( string = ) ( call SW.getProperty en.housing_unit.123_sesame_street ( string neighborhood ) ) ) )	overnight-housing
what are the rare housing types	( call SW.listValue ( call SW.countSuperlative ( call SW.getProperty ( call SW.singleton en.housing ) ( string ! type ) ) ( string min ) ( call SW.reverse ( string housing_type ) ) ( call SW.getProperty ( call SW.singleton en.housing_unit ) ( string ! type ) ) ) )	overnight-housing
housing unit in midtown west and allows dogs	( call SW.listValue ( call SW.filter ( call SW.filter ( call SW.getProperty ( call SW.singleton en.housing_unit ) ( string ! type ) ) ( string neighborhood ) ( string = ) en.neighborhood.midtown_west ) ( string allows_dogs ) ) )	overnight-housing
find housing units with just one neighborhood	( call SW.listValue ( call SW.countComparative ( call SW.getProperty ( call SW.singleton en.housing_unit ) ( string ! type ) ) ( string neighborhood ) ( string < ) ( number 2 ) ) )	overnight-housing
which housing unit has a monthly rent of more than 1000 dollars	( call SW.listValue ( call SW.filter ( call SW.getProperty ( call SW.singleton en.housing_unit ) ( string ! type ) ) ( call SW.ensureNumericProperty ( string rent ) ) ( string > ) ( call SW.ensureNumericEntity ( number 1500 en.dollar ) ) ) )	overnight-housing
a twohousing unit	( call SW.listValue ( call SW.countComparative ( call SW.getProperty ( call SW.singleton en.housing_unit ) ( string ! type ) ) ( string housing_type ) ( string = ) ( number 2 ) ) )	overnight-housing
housing posted on january 2	( call SW.listValue ( call SW.filter ( call SW.getProperty ( call SW.singleton en.housing ) ( string ! type ) ) ( call SW.reverse ( string housing_type ) ) ( string = ) ( call SW.filter ( call SW.getProperty ( call SW.singleton en.housing_unit ) ( string ! type ) ) ( string posting_date ) ( string = ) ( date 2015 1 2 ) ) ) )	overnight-housing
housing unit that is cheaper than 1500 dollars	( call SW.listValue ( call SW.filter ( call SW.getProperty ( call SW.singleton en.housing_unit ) ( string ! type ) ) ( call SW.ensureNumericProperty ( string rent ) ) ( string < ) ( call SW.ensureNumericEntity ( number 1500 en.dollar ) ) ) )	overnight-housing
find housing units posted before or on the same date as 123 sesame street	( call SW.listValue ( call SW.filter ( call SW.getProperty ( call SW.singleton en.housing_unit ) ( string ! type ) ) ( call SW.ensureNumericProperty ( string posting_date ) ) ( string <= ) ( call SW.ensureNumericEntity ( call SW.getProperty en.housing_unit.123_sesame_street ( string posting_date ) ) ) ) )	overnight-housing
housing units near two neighborhoods	( call SW.listValue ( call SW.countComparative ( call SW.getProperty ( call SW.singleton en.housing_unit ) ( string ! type ) ) ( string neighborhood ) ( string = ) ( number 2 ) ) )	overnight-housing
find housing units with private bath located in the neighborhoods of midtown west	( call SW.listValue ( call SW.filter ( call SW.filter ( call SW.getProperty ( call SW.singleton en.housing_unit ) ( string ! type ) ) ( string has_private_bath ) ) ( string neighborhood ) ( string = ) en.neighborhood.midtown_west ) )	overnight-housing
housing unit with same housing type as that of 123 sesame street	( call SW.listValue ( call SW.filter ( call SW.getProperty ( call SW.singleton en.housing_unit ) ( string ! type ) ) ( string housing_type ) ( string = ) ( call SW.getProperty en.housing_unit.123_sesame_street ( string housing_type ) ) ) )	overnight-housing
800 square feet housing that allows dogs	( call SW.listValue ( call SW.filter ( call SW.filter ( call SW.getProperty ( call SW.singleton en.housing_unit ) ( string ! type ) ) ( string allows_dogs ) ) ( string size ) ( string = ) ( number 800 en.square_feet ) ) )	overnight-housing
how large is the unit at 123 sesame street	( call SW.listValue ( call SW.getProperty en.housing_unit.123_sesame_street ( string size ) ) )	overnight-housing
which 1500monthly rentals are 800 square feet	( call SW.listValue ( call SW.filter ( call SW.filter ( call SW.getProperty ( call SW.singleton en.housing_unit ) ( string ! type ) ) ( string rent ) ( string = ) ( number 1500 en.dollar ) ) ( string size ) ( string = ) ( number 800 en.square_feet ) ) )	overnight-housing
find the largest housing unit	( call SW.listValue ( call SW.superlative ( call SW.getProperty ( call SW.singleton en.housing_unit ) ( string ! type ) ) ( string max ) ( call SW.ensureNumericProperty ( string size ) ) ) )	overnight-housing
cheapest places to rent	( call SW.listValue ( call SW.superlative ( call SW.getProperty ( call SW.singleton en.housing_unit ) ( string ! type ) ) ( string min ) ( call SW.ensureNumericProperty ( string rent ) ) ) )	overnight-housing
which area has a minimum of two housing units	( call SW.listValue ( call SW.countComparative ( call SW.getProperty ( call SW.singleton en.neighborhood ) ( string ! type ) ) ( call SW.reverse ( string neighborhood ) ) ( string >= ) ( number 2 ) ( call SW.getProperty ( call SW.singleton en.housing_unit ) ( string ! type ) ) ) )	overnight-housing
most expensive places to rent	( call SW.listValue ( call SW.superlative ( call SW.getProperty ( call SW.singleton en.housing_unit ) ( string ! type ) ) ( string max ) ( call SW.ensureNumericProperty ( string rent ) ) ) )	overnight-housing
housing that is not 1500month	( call SW.listValue ( call SW.filter ( call SW.getProperty ( call SW.singleton en.housing_unit ) ( string ! type ) ) ( string rent ) ( string ! = ) ( number 1500 en.dollar ) ) )	overnight-housing
housing that was posted on january 2 or february 3	( call SW.listValue ( call SW.filter ( call SW.getProperty ( call SW.singleton en.housing_unit ) ( string ! type ) ) ( call SW.ensureNumericProperty ( string posting_date ) ) ( string >= ) ( call SW.ensureNumericEntity ( call SW.concat ( date 2015 1 2 ) ( date 2015 2 3 ) ) ) ) )	overnight-housing
housing that costs the same as 123 sesame street	( call SW.listValue ( call SW.filter ( call SW.getProperty ( call SW.singleton en.housing_unit ) ( string ! type ) ) ( string rent ) ( string = ) ( call SW.getProperty en.housing_unit.123_sesame_street ( string rent ) ) ) )	overnight-housing
what is the mostused housing type	( call SW.listValue ( call SW.countSuperlative ( call SW.getProperty ( call SW.singleton en.housing ) ( string ! type ) ) ( string max ) ( call SW.reverse ( string housing_type ) ) ( call SW.getProperty ( call SW.singleton en.housing_unit ) ( string ! type ) ) ) )	overnight-housing
show me housing with 800 square feet of space	( call SW.listValue ( call SW.filter ( call SW.getProperty ( call SW.singleton en.housing_unit ) ( string ! type ) ) ( string size ) ( string = ) ( number 800 en.square_feet ) ) )	overnight-housing
which housing units are at least 800 square feet in size	( call SW.listValue ( call SW.filter ( call SW.getProperty ( call SW.singleton en.housing_unit ) ( string ! type ) ) ( call SW.ensureNumericProperty ( string size ) ) ( string >= ) ( call SW.ensureNumericEntity ( number 800 en.square_feet ) ) ) )	overnight-housing
what kind of housing is available for 1500month	( call SW.listValue ( call SW.filter ( call SW.getProperty ( call SW.singleton en.housing ) ( string ! type ) ) ( call SW.reverse ( string housing_type ) ) ( string = ) ( call SW.filter ( call SW.getProperty ( call SW.singleton en.housing_unit ) ( string ! type ) ) ( string rent ) ( string = ) ( number 1500 en.dollar ) ) ) )	overnight-housing
neighborhood with the most housing units	( call SW.listValue ( call SW.countSuperlative ( call SW.getProperty ( call SW.singleton en.neighborhood ) ( string ! type ) ) ( string max ) ( call SW.reverse ( string neighborhood ) ) ( call SW.getProperty ( call SW.singleton en.housing_unit ) ( string ! type ) ) ) )	overnight-housing
what housing unit allowing cats was posted on jan 2	( call SW.listValue ( call SW.filter ( call SW.filter ( call SW.getProperty ( call SW.singleton en.housing_unit ) ( string ! type ) ) ( string posting_date ) ( string = ) ( date 2015 1 2 ) ) ( string allows_cats ) ) )	overnight-housing
which housing unit was posted january 2 that is the same housing type as 123 sesame st	( call SW.listValue ( call SW.filter ( call SW.filter ( call SW.getProperty ( call SW.singleton en.housing_unit ) ( string ! type ) ) ( string posting_date ) ( string = ) ( date 2015 1 2 ) ) ( call SW.reverse ( string housing_type ) ) ( string = ) en.housing_unit.123_sesame_street ) )	overnight-housing
housing that allows cats and is 1500 a month	( call SW.listValue ( call SW.filter ( call SW.filter ( call SW.getProperty ( call SW.singleton en.housing_unit ) ( string ! type ) ) ( string rent ) ( string = ) ( number 1500 en.dollar ) ) ( string allows_cats ) ) )	overnight-housing
what is the house number of the apartment	( call SW.listValue ( call .size ( call SW.getProperty ( call SW.singleton en.housing_unit ) ( string ! type ) ) ) )	overnight-housing
cheapest housing	( call SW.listValue ( call SW.superlative ( call SW.getProperty ( call SW.singleton en.housing_unit ) ( string ! type ) ) ( string min ) ( call SW.ensureNumericProperty ( string rent ) ) ) )	overnight-housing
which housing unit is posted lately	( call SW.listValue ( call SW.superlative ( call SW.getProperty ( call SW.singleton en.housing_unit ) ( string ! type ) ) ( string min ) ( call SW.ensureNumericProperty ( string posting_date ) ) ) )	overnight-housing
housing unit for rent posted on january 2	( call SW.listValue ( call SW.filter ( call SW.getProperty ( call SW.singleton en.housing_unit ) ( string ! type ) ) ( string rent ) ( string = ) ( call SW.filter ( call SW.getProperty ( call SW.singleton en.housing_unit ) ( string ! type ) ) ( string posting_date ) ( string = ) ( date 2015 1 2 ) ) ) )	overnight-housing
housing that isnt in midtown west	( call SW.listValue ( call SW.filter ( call SW.getProperty ( call SW.singleton en.housing_unit ) ( string ! type ) ) ( string neighborhood ) ( string ! = ) en.neighborhood.midtown_west ) )	overnight-housing
apartments that were posted on january 2	( call SW.listValue ( call SW.filter ( call SW.filter ( call SW.getProperty ( call SW.singleton en.housing_unit ) ( string ! type ) ) ( string housing_type ) ( string = ) en.housing.apartment ) ( string posting_date ) ( string = ) ( date 2015 1 2 ) ) )	overnight-housing
which housing unit is available for the least rent	( call SW.listValue ( call SW.superlative ( call SW.getProperty ( call SW.singleton en.housing_unit ) ( string ! type ) ) ( string min ) ( call SW.ensureNumericProperty ( string rent ) ) ) )	overnight-housing
which housing unit has a jan 2nd posting	( call SW.listValue ( call SW.filter ( call SW.filter ( call SW.getProperty ( call SW.singleton en.housing_unit ) ( string ! type ) ) ( string posting_date ) ( string = ) ( date 2015 1 2 ) ) ( string posting_date ) ( string = ) ( date 2015 1 2 ) ) )	overnight-housing
what housing unit posted was posted on jan 2	( call SW.listValue ( call SW.filter ( call SW.filter ( call SW.getProperty ( call SW.singleton en.housing_unit ) ( string ! type ) ) ( string posting_date ) ( string = ) ( date 2015 1 2 ) ) ( call SW.reverse ( string posting_date ) ) ( string = ) en.housing_unit.123_sesame_street ) )	overnight-housing
what housing unit allowing dogs was posted on jan 2	( call SW.listValue ( call SW.filter ( call SW.filter ( call SW.getProperty ( call SW.singleton en.housing_unit ) ( string ! type ) ) ( string posting_date ) ( string = ) ( date 2015 1 2 ) ) ( string allows_dogs ) ) )	overnight-housing
housing that is the same rent as or cheaper than 123 sesame street	( call SW.listValue ( call SW.filter ( call SW.getProperty ( call SW.singleton en.housing_unit ) ( string ! type ) ) ( call SW.ensureNumericProperty ( string rent ) ) ( string <= ) ( call SW.ensureNumericEntity ( call SW.getProperty en.housing_unit.123_sesame_street ( string rent ) ) ) ) )	overnight-housing
housing unit with the smallest posting date	( call SW.listValue ( call SW.superlative ( call SW.getProperty ( call SW.singleton en.housing_unit ) ( string ! type ) ) ( string min ) ( call SW.ensureNumericProperty ( string posting_date ) ) ) )	overnight-housing
apartments with rent below 1500	( call SW.listValue ( call SW.filter ( call SW.getProperty ( call SW.singleton en.housing_unit ) ( string ! type ) ) ( call SW.ensureNumericProperty ( string rent ) ) ( string < ) ( call SW.ensureNumericEntity ( number 1500 en.dollar ) ) ) )	overnight-housing
catfriendly apartments with a private bathroom	( call SW.listValue ( call SW.filter ( call SW.filter ( call SW.getProperty ( call SW.singleton en.housing_unit ) ( string ! type ) ) ( string has_private_bath ) ) ( string allows_cats ) ) )	overnight-housing
what housing costs 1500 dollars and is 800 square feet	( call SW.listValue ( call SW.filter ( call SW.filter ( call SW.getProperty ( call SW.singleton en.housing_unit ) ( string ! type ) ) ( string size ) ( string = ) ( number 800 en.square_feet ) ) ( string rent ) ( string = ) ( number 1500 en.dollar ) ) )	overnight-housing
what 800 square housing allows dogs	( call SW.listValue ( call SW.filter ( call SW.filter ( call SW.getProperty ( call SW.singleton en.housing_unit ) ( string ! type ) ) ( string allows_dogs ) ) ( string size ) ( string = ) ( number 800 en.square_feet ) ) )	overnight-housing
housing type on 123 sesame street	( call SW.listValue ( call SW.getProperty en.housing_unit.123_sesame_street ( string housing_type ) ) )	overnight-housing
smallest available unit	( call SW.listValue ( call SW.superlative ( call SW.getProperty ( call SW.singleton en.housing_unit ) ( string ! type ) ) ( string min ) ( call SW.ensureNumericProperty ( string size ) ) ) )	overnight-housing
housing allowing cats that was posted on january 2	( call SW.listValue ( call SW.filter ( call SW.filter ( call SW.getProperty ( call SW.singleton en.housing_unit ) ( string ! type ) ) ( string posting_date ) ( string = ) ( date 2015 1 2 ) ) ( string allows_cats ) ) )	overnight-housing
which housing unit has a monthly rent of less than 1500 dollars	( call SW.listValue ( call SW.filter ( call SW.getProperty ( call SW.singleton en.housing_unit ) ( string ! type ) ) ( call SW.ensureNumericProperty ( string rent ) ) ( string < ) ( call SW.ensureNumericEntity ( number 1500 en.dollar ) ) ) )	overnight-housing
housing posted the same day or after 123 sesame street	( call SW.listValue ( call SW.filter ( call SW.getProperty ( call SW.singleton en.housing_unit ) ( string ! type ) ) ( call SW.ensureNumericProperty ( string posting_date ) ) ( string >= ) ( call SW.ensureNumericEntity ( call SW.getProperty en.housing_unit.123_sesame_street ( string posting_date ) ) ) ) )	overnight-housing
housing unit posted on january 2 and that is the same size as 123 sesame st	( call SW.listValue ( call SW.filter ( call SW.filter ( call SW.getProperty ( call SW.singleton en.housing_unit ) ( string ! type ) ) ( string posting_date ) ( string = ) ( date 2015 1 2 ) ) ( call SW.reverse ( string size ) ) ( string = ) en.housing_unit.123_sesame_street ) )	overnight-housing
what neighborhood has less than two housing units	( call SW.listValue ( call SW.countComparative ( call SW.getProperty ( call SW.singleton en.neighborhood ) ( string ! type ) ) ( call SW.reverse ( string neighborhood ) ) ( string < ) ( number 2 ) ( call SW.getProperty ( call SW.singleton en.housing_unit ) ( string ! type ) ) ) )	overnight-housing
housing that is smaller than 800 square feet or smaller than 1000 square feet	( call SW.listValue ( call SW.filter ( call SW.getProperty ( call SW.singleton en.housing_unit ) ( string ! type ) ) ( call SW.ensureNumericProperty ( string size ) ) ( string < ) ( call SW.ensureNumericEntity ( call SW.concat ( number 800 en.square_feet ) ( number 1000 en.square_feet ) ) ) ) )	overnight-housing
which housing unit permits dogs and has the facility of a private bath	( call SW.listValue ( call SW.filter ( call SW.filter ( call SW.getProperty ( call SW.singleton en.housing_unit ) ( string ! type ) ) ( string allows_dogs ) ) ( string has_private_bath ) ) )	overnight-housing
what is the neighborhood of housing unit of the apartments	( call SW.listValue ( call SW.filter ( call SW.getProperty ( call SW.singleton en.neighborhood ) ( string ! type ) ) ( call SW.reverse ( string neighborhood ) ) ( string = ) ( call SW.filter ( call SW.getProperty ( call SW.singleton en.housing_unit ) ( string ! type ) ) ( string housing_type ) ( string = ) en.housing.apartment ) ) )	overnight-housing
how many neighborhoods are in the city	( call SW.listValue ( call .size ( call SW.getProperty ( call SW.singleton en.neighborhood ) ( string ! type ) ) ) )	overnight-housing
what housing units are at least 800 or 1000 square feet	( call SW.listValue ( call SW.filter ( call SW.getProperty ( call SW.singleton en.housing_unit ) ( string ! type ) ) ( call SW.ensureNumericProperty ( string size ) ) ( string >= ) ( call SW.ensureNumericEntity ( call SW.concat ( number 800 en.square_feet ) ( number 1000 en.square_feet ) ) ) ) )	overnight-housing
housing of two types	( call SW.listValue ( call SW.countComparative ( call SW.getProperty ( call SW.singleton en.housing ) ( string ! type ) ) ( call SW.reverse ( string housing_type ) ) ( string = ) ( number 2 ) ( call SW.getProperty ( call SW.singleton en.housing_unit ) ( string ! type ) ) ) )	overnight-housing
housing posted the same day as 123 sesame street	( call SW.listValue ( call SW.filter ( call SW.getProperty ( call SW.singleton en.housing_unit ) ( string ! type ) ) ( string posting_date ) ( string = ) ( call SW.getProperty en.housing_unit.123_sesame_street ( string posting_date ) ) ) )	overnight-housing
which housing unit has two types minimum	( call SW.listValue ( call SW.countComparative ( call SW.getProperty ( call SW.singleton en.housing_unit ) ( string ! type ) ) ( string housing_type ) ( string >= ) ( number 2 ) ) )	overnight-housing
find housing units that are same as or lesser than the size of 123 sesame street	( call SW.listValue ( call SW.filter ( call SW.getProperty ( call SW.singleton en.housing_unit ) ( string ! type ) ) ( call SW.ensureNumericProperty ( string size ) ) ( string <= ) ( call SW.ensureNumericEntity ( call SW.getProperty en.housing_unit.123_sesame_street ( string size ) ) ) ) )	overnight-housing
housing apartments that allows cats	( call SW.listValue ( call SW.filter ( call SW.filter ( call SW.getProperty ( call SW.singleton en.housing_unit ) ( string ! type ) ) ( string allows_cats ) ) ( string housing_type ) ( string = ) en.housing.apartment ) )	overnight-housing
what housing unit has two or more neighborhoods	( call SW.listValue ( call SW.countComparative ( call SW.getProperty ( call SW.singleton en.housing_unit ) ( string ! type ) ) ( string neighborhood ) ( string >= ) ( number 2 ) ) )	overnight-housing
what housing units allows dogs	( call SW.listValue ( call SW.filter ( call SW.getProperty ( call SW.singleton en.housing_unit ) ( string ! type ) ) ( string allows_dogs ) ) )	overnight-housing
which housing unit resembles 123 sesame street or 900 mission ave	( call SW.listValue ( call SW.filter ( call SW.getProperty ( call SW.singleton en.housing ) ( string ! type ) ) ( call SW.reverse ( string housing_type ) ) ( string = ) ( call SW.concat en.housing_unit.123_sesame_street en.housing_unit.900_mission_ave ) ) )	overnight-housing
apartments with rent above 1500	( call SW.listValue ( call SW.filter ( call SW.getProperty ( call SW.singleton en.housing_unit ) ( string ! type ) ) ( call SW.ensureNumericProperty ( string rent ) ) ( string > ) ( call SW.ensureNumericEntity ( number 1500 en.dollar ) ) ) )	overnight-housing
housing that is 800 square feet with a private bath	( call SW.listValue ( call SW.filter ( call SW.filter ( call SW.getProperty ( call SW.singleton en.housing_unit ) ( string ! type ) ) ( string size ) ( string = ) ( number 800 en.square_feet ) ) ( string has_private_bath ) ) )	overnight-housing
what is the housing type that allows cats	( call SW.listValue ( call SW.filter ( call SW.getProperty ( call SW.singleton en.housing ) ( string ! type ) ) ( call SW.reverse ( string housing_type ) ) ( string = ) ( call SW.filter ( call SW.getProperty ( call SW.singleton en.housing_unit ) ( string ! type ) ) ( string allows_cats ) ) ) )	overnight-housing
find housing units that are pet friendly	( call SW.listValue ( call SW.filter ( call SW.filter ( call SW.getProperty ( call SW.singleton en.housing_unit ) ( string ! type ) ) ( string allows_dogs ) ) ( string allows_dogs ) ) )	overnight-housing
apartments with the same rent as 123 sesame street	( call SW.listValue ( call SW.filter ( call SW.getProperty ( call SW.singleton en.housing_unit ) ( string ! type ) ) ( call SW.ensureNumericProperty ( string rent ) ) ( string >= ) ( call SW.ensureNumericEntity ( call SW.getProperty en.housing_unit.123_sesame_street ( string rent ) ) ) ) )	overnight-housing
housing type posted january 2	( call SW.listValue ( call SW.filter ( call SW.getProperty ( call SW.singleton en.housing ) ( string ! type ) ) ( call SW.reverse ( string housing_type ) ) ( string = ) ( call SW.filter ( call SW.getProperty ( call SW.singleton en.housing_unit ) ( string ! type ) ) ( string posting_date ) ( string = ) ( date 2015 1 2 ) ) ) )	overnight-housing
apartments with a private room	( call SW.listValue ( call SW.filter ( call SW.getProperty ( call SW.singleton en.housing ) ( string ! type ) ) ( call SW.reverse ( string housing_type ) ) ( string = ) ( call SW.filter ( call SW.getProperty ( call SW.singleton en.housing_unit ) ( string ! type ) ) ( string has_private_room ) ) ) )	overnight-housing
what housing using posted on jan 2 has a private bath	( call SW.listValue ( call SW.filter ( call SW.filter ( call SW.getProperty ( call SW.singleton en.housing_unit ) ( string ! type ) ) ( string has_private_bath ) ) ( string posting_date ) ( string = ) ( date 2015 1 2 ) ) )	overnight-housing
800 square foot apartment in midtown west	( call SW.listValue ( call SW.filter ( call SW.filter ( call SW.getProperty ( call SW.singleton en.housing_unit ) ( string ! type ) ) ( string size ) ( string = ) ( number 800 en.square_feet ) ) ( string neighborhood ) ( string = ) en.neighborhood.midtown_west ) )	overnight-housing
which housing unit is available for a price of less than 1500 dollars	( call SW.listValue ( call SW.filter ( call SW.getProperty ( call SW.singleton en.housing_unit ) ( string ! type ) ) ( string rent ) ( string ! = ) ( number 1500 en.dollar ) ) )	overnight-housing
count of different units	( call SW.listValue ( call .size ( call SW.getProperty ( call SW.singleton en.housing ) ( string ! type ) ) ) )	overnight-housing
housing unit with a posting date at the latest january 2	( call SW.listValue ( call SW.filter ( call SW.getProperty ( call SW.singleton en.housing_unit ) ( string ! type ) ) ( call SW.ensureNumericProperty ( string posting_date ) ) ( string <= ) ( call SW.ensureNumericEntity ( date 2015 1 2 ) ) ) )	overnight-housing
apartment with a private bathroom for rent at 1500	( call SW.listValue ( call SW.filter ( call SW.filter ( call SW.getProperty ( call SW.singleton en.housing_unit ) ( string ! type ) ) ( string rent ) ( string = ) ( number 1500 en.dollar ) ) ( string has_private_bath ) ) )	overnight-housing
housing with private room that was posted on january 2	( call SW.listValue ( call SW.filter ( call SW.filter ( call SW.getProperty ( call SW.singleton en.housing_unit ) ( string ! type ) ) ( string has_private_room ) ) ( string posting_date ) ( string = ) ( date 2015 1 2 ) ) )	overnight-housing
find all housing units posted on january 2	( call SW.listValue ( call SW.filter ( call SW.getProperty ( call SW.singleton en.housing ) ( string ! type ) ) ( call SW.reverse ( string housing_type ) ) ( string = ) ( call SW.filter ( call SW.getProperty ( call SW.singleton en.housing_unit ) ( string ! type ) ) ( string posting_date ) ( string = ) ( date 2015 1 2 ) ) ) )	overnight-housing
housing unit which is an apartment housing type with a private room	( call SW.listValue ( call SW.filter ( call SW.filter ( call SW.getProperty ( call SW.singleton en.housing_unit ) ( string ! type ) ) ( string housing_type ) ( string = ) en.housing.apartment ) ( string has_private_room ) ) )	overnight-housing
housing unit with a post date earlier than january 2	( call SW.listValue ( call SW.filter ( call SW.getProperty ( call SW.singleton en.housing_unit ) ( string ! type ) ) ( call SW.ensureNumericProperty ( string posting_date ) ) ( string < ) ( call SW.ensureNumericEntity ( date 2015 1 2 ) ) ) )	overnight-housing
what housing was posted no earlier than jan 2	( call SW.listValue ( call SW.filter ( call SW.getProperty ( call SW.singleton en.housing_unit ) ( string ! type ) ) ( call SW.ensureNumericProperty ( string posting_date ) ) ( string >= ) ( call SW.ensureNumericEntity ( date 2015 1 2 ) ) ) )	overnight-housing
find 800 square feet sized housing units with a private room	( call SW.listValue ( call SW.filter ( call SW.filter ( call SW.getProperty ( call SW.singleton en.housing_unit ) ( string ! type ) ) ( string has_private_room ) ) ( string size ) ( string = ) ( number 800 en.square_feet ) ) )	overnight-housing
what kind of housing is 123 sesame street	( call SW.listValue ( call SW.getProperty en.housing_unit.123_sesame_street ( string housing_type ) ) )	overnight-housing
what housing is a two unit type	( call SW.listValue ( call SW.countComparative ( call SW.getProperty ( call SW.singleton en.housing ) ( string ! type ) ) ( call SW.reverse ( string housing_type ) ) ( string = ) ( number 2 ) ( call SW.getProperty ( call SW.singleton en.housing_unit ) ( string ! type ) ) ) )	overnight-housing
which housing posted jan 2nd at 123 sesame street	( call SW.listValue ( call SW.filter ( call SW.filter ( call SW.getProperty ( call SW.singleton en.housing_unit ) ( string ! type ) ) ( string posting_date ) ( string = ) ( date 2015 1 2 ) ) ( call SW.reverse ( string posting_date ) ) ( string = ) en.housing_unit.123_sesame_street ) )	overnight-housing
what are the housing units in the area around midtown west	( call SW.listValue ( call SW.filter ( call SW.getProperty ( call SW.singleton en.neighborhood ) ( string ! type ) ) ( call SW.reverse ( string neighborhood ) ) ( string = ) ( call SW.filter ( call SW.getProperty ( call SW.singleton en.housing_unit ) ( string ! type ) ) ( string neighborhood ) ( string = ) en.neighborhood.midtown_west ) ) )	overnight-housing
housing typical of 123 sesame street housing posted on january 2	( call SW.listValue ( call SW.filter ( call SW.filter ( call SW.getProperty ( call SW.singleton en.housing_unit ) ( string ! type ) ) ( string posting_date ) ( string = ) ( date 2015 1 2 ) ) ( call SW.reverse ( string size ) ) ( string = ) en.housing_unit.123_sesame_street ) )	overnight-housing
list all housing us that are at least 800 or 1000 square feet	( call SW.listValue ( call SW.filter ( call SW.getProperty ( call SW.singleton en.housing_unit ) ( string ! type ) ) ( call SW.ensureNumericProperty ( string size ) ) ( string >= ) ( call SW.ensureNumericEntity ( call SW.concat ( number 800 en.square_feet ) ( number 1000 en.square_feet ) ) ) ) )	overnight-housing
neighborhoods with housing that is 1500month	( call SW.listValue ( call SW.filter ( call SW.getProperty ( call SW.singleton en.neighborhood ) ( string ! type ) ) ( call SW.reverse ( string neighborhood ) ) ( string = ) ( call SW.filter ( call SW.getProperty ( call SW.singleton en.housing_unit ) ( string ! type ) ) ( string rent ) ( string = ) ( number 1500 en.dollar ) ) ) )	overnight-housing
housing not in midtown west	( call SW.listValue ( call SW.filter ( call SW.getProperty ( call SW.singleton en.housing_unit ) ( string ! type ) ) ( string neighborhood ) ( string ! = ) en.neighborhood.midtown_west ) )	overnight-housing
what housing units are the same size as those in 123 sesame street	( call SW.listValue ( call SW.filter ( call SW.getProperty ( call SW.singleton en.housing_unit ) ( string ! type ) ) ( call SW.ensureNumericProperty ( string size ) ) ( string >= ) ( call SW.ensureNumericEntity ( call SW.getProperty en.housing_unit.123_sesame_street ( string size ) ) ) ) )	overnight-housing
which neighborhoods have housing with a private bath	( call SW.listValue ( call SW.filter ( call SW.getProperty ( call SW.singleton en.neighborhood ) ( string ! type ) ) ( call SW.reverse ( string neighborhood ) ) ( string = ) ( call SW.filter ( call SW.getProperty ( call SW.singleton en.housing_unit ) ( string ! type ) ) ( string has_private_bath ) ) ) )	overnight-housing
housing with a private room that is 800 square feet total	( call SW.listValue ( call SW.filter ( call SW.filter ( call SW.getProperty ( call SW.singleton en.housing_unit ) ( string ! type ) ) ( string size ) ( string = ) ( number 800 en.square_feet ) ) ( string has_private_room ) ) )	overnight-housing
what is the average rent per month of a housing unit	( call SW.listValue ( call SW.aggregate ( string avg ) ( call SW.getProperty ( call SW.getProperty ( call SW.singleton en.housing_unit ) ( string ! type ) ) ( string rent ) ) ) )	overnight-housing
apartments with a private bath	( call SW.listValue ( call SW.filter ( call SW.filter ( call SW.getProperty ( call SW.singleton en.housing_unit ) ( string ! type ) ) ( string housing_type ) ( string = ) en.housing.apartment ) ( string has_private_bath ) ) )	overnight-housing
which housing has a monthly rent of 1500 dollars	( call SW.listValue ( call SW.filter ( call SW.filter ( call SW.getProperty ( call SW.singleton en.housing_unit ) ( string ! type ) ) ( string rent ) ( string = ) ( number 1500 en.dollar ) ) ( string rent ) ( string = ) ( number 1500 en.dollar ) ) )	overnight-housing
housing that posted on the same day at 123 sesame street	( call SW.listValue ( call SW.filter ( call SW.getProperty ( call SW.singleton en.housing_unit ) ( string ! type ) ) ( call SW.ensureNumericProperty ( string posting_date ) ) ( string >= ) ( call SW.ensureNumericEntity ( call SW.getProperty en.housing_unit.123_sesame_street ( string posting_date ) ) ) ) )	overnight-housing
what is the housing type number	( call SW.listValue ( call .size ( call SW.getProperty ( call SW.singleton en.housing ) ( string ! type ) ) ) )	overnight-housing
housing unit with a private bath and cost 1500 dollars rent	( call SW.listValue ( call SW.filter ( call SW.filter ( call SW.getProperty ( call SW.singleton en.housing_unit ) ( string ! type ) ) ( string has_private_bath ) ) ( string rent ) ( string = ) ( number 1500 en.dollar ) ) )	overnight-housing
apartment housing that was posted on january 2	( call SW.listValue ( call SW.filter ( call SW.filter ( call SW.getProperty ( call SW.singleton en.housing_unit ) ( string ! type ) ) ( string posting_date ) ( string = ) ( date 2015 1 2 ) ) ( string housing_type ) ( string = ) en.housing.apartment ) )	overnight-housing
exclude apartments that are in the same neighborhood as 123 sesame street	( call SW.listValue ( call SW.filter ( call SW.getProperty ( call SW.singleton en.neighborhood ) ( string ! type ) ) ( call SW.reverse ( string neighborhood ) ) ( string ! = ) en.housing_unit.123_sesame_street ) )	overnight-housing
housing with a master bedroom and private bath	( call SW.listValue ( call SW.filter ( call SW.filter ( call SW.getProperty ( call SW.singleton en.housing_unit ) ( string ! type ) ) ( string has_private_bath ) ) ( string has_private_room ) ) )	overnight-housing
which housing unit resembles the size of 123 sesame street	( call SW.listValue ( call SW.filter ( call SW.getProperty ( call SW.singleton en.housing_unit ) ( string ! type ) ) ( call SW.ensureNumericProperty ( string size ) ) ( string <= ) ( call SW.ensureNumericEntity ( call SW.getProperty en.housing_unit.123_sesame_street ( string size ) ) ) ) )	overnight-housing
apartments that are smaller than 123 sesame street	( call SW.listValue ( call SW.filter ( call SW.getProperty ( call SW.singleton en.housing_unit ) ( string ! type ) ) ( call SW.ensureNumericProperty ( string size ) ) ( string < ) ( call SW.ensureNumericEntity ( call SW.getProperty en.housing_unit.123_sesame_street ( string size ) ) ) ) )	overnight-housing
which housing unit has more than two kinds of houses	( call SW.listValue ( call SW.countComparative ( call SW.getProperty ( call SW.singleton en.housing ) ( string ! type ) ) ( call SW.reverse ( string housing_type ) ) ( string > ) ( number 2 ) ( call SW.getProperty ( call SW.singleton en.housing_unit ) ( string ! type ) ) ) )	overnight-housing
posting with at least two types of housing	( call SW.listValue ( call SW.countComparative ( call SW.getProperty ( call SW.singleton en.housing_unit ) ( string ! type ) ) ( string housing_type ) ( string >= ) ( number 2 ) ) )	overnight-housing
neighborhoods medtown west or chelsea	( call SW.listValue ( call SW.concat en.neighborhood.midtown_west en.neighborhood.chelsea ) )	overnight-housing
apartments in the same neighborhood at 123 sesame street	( call SW.listValue ( call SW.filter ( call SW.getProperty ( call SW.singleton en.housing_unit ) ( string ! type ) ) ( string neighborhood ) ( string = ) ( call SW.getProperty en.housing_unit.123_sesame_street ( string neighborhood ) ) ) )	overnight-housing
find housing units in the neighborhoods of midtown west	( call SW.listValue ( call SW.filter ( call SW.filter ( call SW.getProperty ( call SW.singleton en.housing_unit ) ( string ! type ) ) ( string neighborhood ) ( string = ) en.neighborhood.midtown_west ) ( string neighborhood ) ( string = ) en.neighborhood.midtown_west ) )	overnight-housing
housing with no more than two housing units	( call SW.listValue ( call SW.countComparative ( call SW.getProperty ( call SW.singleton en.housing ) ( string ! type ) ) ( call SW.reverse ( string housing_type ) ) ( string <= ) ( number 2 ) ( call SW.getProperty ( call SW.singleton en.housing_unit ) ( string ! type ) ) ) )	overnight-housing
housing apartments in a midtown west neighborhood	( call SW.listValue ( call SW.filter ( call SW.filter ( call SW.getProperty ( call SW.singleton en.housing_unit ) ( string ! type ) ) ( string neighborhood ) ( string = ) en.neighborhood.midtown_west ) ( string housing_type ) ( string = ) en.housing.apartment ) )	overnight-housing
which housing posted after jan 2nd	( call SW.listValue ( call SW.filter ( call SW.getProperty ( call SW.singleton en.housing_unit ) ( string ! type ) ) ( call SW.ensureNumericProperty ( string posting_date ) ) ( string > ) ( call SW.ensureNumericEntity ( date 2015 1 2 ) ) ) )	overnight-housing
housing that was posted on january 2	( call SW.listValue ( call SW.filter ( call SW.getProperty ( call SW.singleton en.housing_unit ) ( string ! type ) ) ( string posting_date ) ( string = ) ( call SW.concat ( date 2015 1 2 ) ( date 2015 2 3 ) ) ) )	overnight-housing
find housing units with maximum size 800 square feet	( call SW.listValue ( call SW.filter ( call SW.getProperty ( call SW.singleton en.housing_unit ) ( string ! type ) ) ( call SW.ensureNumericProperty ( string size ) ) ( string <= ) ( call SW.ensureNumericEntity ( number 800 en.square_feet ) ) ) )	overnight-housing
want a housing type like 123 sesame street	( call SW.listValue ( call SW.filter ( call SW.filter ( call SW.getProperty ( call SW.singleton en.housing ) ( string ! type ) ) ( call SW.reverse ( string housing_type ) ) ( string = ) en.housing_unit.123_sesame_street ) ( call SW.reverse ( string housing_type ) ) ( string = ) en.housing_unit.123_sesame_street ) )	overnight-housing
pet friendly housing with 1500 dollars as rent	( call SW.listValue ( call SW.filter ( call SW.filter ( call SW.getProperty ( call SW.singleton en.housing_unit ) ( string ! type ) ) ( string allows_dogs ) ) ( string rent ) ( string = ) ( number 1500 en.dollar ) ) )	overnight-housing
what is the date of the 123 sesame street posting	( call SW.listValue ( call SW.getProperty en.housing_unit.123_sesame_street ( string posting_date ) ) )	overnight-housing
find a housing unit that is in two neighborhoods	( call SW.listValue ( call SW.countComparative ( call SW.getProperty ( call SW.singleton en.housing_unit ) ( string ! type ) ) ( string neighborhood ) ( string = ) ( number 2 ) ) )	overnight-housing
housing that allows dogs and was posted on january 2	( call SW.listValue ( call SW.filter ( call SW.filter ( call SW.getProperty ( call SW.singleton en.housing_unit ) ( string ! type ) ) ( string allows_dogs ) ) ( string posting_date ) ( string = ) ( date 2015 1 2 ) ) )	overnight-housing
private bath with 800 square feet	( call SW.listValue ( call SW.filter ( call SW.filter ( call SW.getProperty ( call SW.singleton en.housing_unit ) ( string ! type ) ) ( string has_private_bath ) ) ( string size ) ( string = ) ( number 800 en.square_feet ) ) )	overnight-housing
what is the most numerous housing type	( call SW.listValue ( call SW.countSuperlative ( call SW.getProperty ( call SW.singleton en.housing_unit ) ( string ! type ) ) ( string max ) ( string housing_type ) ) )	overnight-housing
what kind of housing is in midtown west	( call SW.listValue ( call SW.filter ( call SW.getProperty ( call SW.singleton en.housing ) ( string ! type ) ) ( call SW.reverse ( string housing_type ) ) ( string = ) ( call SW.filter ( call SW.getProperty ( call SW.singleton en.housing_unit ) ( string ! type ) ) ( string neighborhood ) ( string = ) en.neighborhood.midtown_west ) ) )	overnight-housing
which housing unit permits cats in it	( call SW.listValue ( call SW.filter ( call SW.getProperty ( call SW.singleton en.housing_unit ) ( string ! type ) ) ( string allows_cats ) ) )	overnight-housing
what is the housing type at 123 sesame street	( call SW.listValue ( call SW.filter ( call SW.getProperty ( call SW.singleton en.housing ) ( string ! type ) ) ( call SW.reverse ( string housing_type ) ) ( string = ) en.housing_unit.123_sesame_street ) )	overnight-housing
housing posted before january 2 or february 3	( call SW.listValue ( call SW.filter ( call SW.getProperty ( call SW.singleton en.housing_unit ) ( string ! type ) ) ( call SW.ensureNumericProperty ( string posting_date ) ) ( string < ) ( call SW.ensureNumericEntity ( call SW.concat ( date 2015 1 2 ) ( date 2015 2 3 ) ) ) ) )	overnight-housing
what housing unit has the same rent as the unit posted on jan 2	( call SW.listValue ( call SW.filter ( call SW.getProperty ( call SW.singleton en.housing_unit ) ( string ! type ) ) ( string rent ) ( string = ) ( call SW.filter ( call SW.getProperty ( call SW.singleton en.housing_unit ) ( string ! type ) ) ( string posting_date ) ( string = ) ( date 2015 1 2 ) ) ) )	overnight-housing
800 square feet in midtown west	( call SW.listValue ( call SW.filter ( call SW.filter ( call SW.getProperty ( call SW.singleton en.housing_unit ) ( string ! type ) ) ( string size ) ( string = ) ( number 800 en.square_feet ) ) ( string neighborhood ) ( string = ) en.neighborhood.midtown_west ) )	overnight-housing
what housing unit was posted on jan 2 or feb 3	( call SW.listValue ( call SW.filter ( call SW.getProperty ( call SW.singleton en.housing_unit ) ( string ! type ) ) ( string posting_date ) ( string = ) ( call SW.concat ( date 2015 1 2 ) ( date 2015 2 3 ) ) ) )	overnight-housing
rarest housing type	( call SW.listValue ( call SW.countSuperlative ( call SW.getProperty ( call SW.singleton en.housing ) ( string ! type ) ) ( string min ) ( call SW.reverse ( string housing_type ) ) ( call SW.getProperty ( call SW.singleton en.housing_unit ) ( string ! type ) ) ) )	overnight-housing
what kinds of housing allow cats	( call SW.listValue ( call SW.filter ( call SW.getProperty ( call SW.singleton en.housing ) ( string ! type ) ) ( call SW.reverse ( string housing_type ) ) ( string = ) ( call SW.filter ( call SW.getProperty ( call SW.singleton en.housing_unit ) ( string ! type ) ) ( string allows_cats ) ) ) )	overnight-housing
apartments with a rent below 1500 a month	( call SW.listValue ( call SW.filter ( call SW.getProperty ( call SW.singleton en.housing_unit ) ( string ! type ) ) ( string rent ) ( string ! = ) ( number 1500 en.dollar ) ) )	overnight-housing
apartments with rent between 1500 to 2000 dollars	( call SW.listValue ( call SW.filter ( call SW.getProperty ( call SW.singleton en.housing_unit ) ( string ! type ) ) ( call SW.ensureNumericProperty ( string rent ) ) ( string > ) ( call SW.ensureNumericEntity ( call SW.concat ( number 1500 en.dollar ) ( number 2000 en.dollar ) ) ) ) )	overnight-housing
housing that is at least as expensive as 123 sesame street	( call SW.listValue ( call SW.filter ( call SW.getProperty ( call SW.singleton en.housing_unit ) ( string ! type ) ) ( call SW.ensureNumericProperty ( string rent ) ) ( string >= ) ( call SW.ensureNumericEntity ( call SW.getProperty en.housing_unit.123_sesame_street ( string rent ) ) ) ) )	overnight-housing
housing unit that is not 800 square feet	( call SW.listValue ( call SW.filter ( call SW.getProperty ( call SW.singleton en.housing_unit ) ( string ! type ) ) ( string size ) ( string ! = ) ( number 800 en.square_feet ) ) )	overnight-housing
housing that posted after january 2 or february 3	( call SW.listValue ( call SW.filter ( call SW.getProperty ( call SW.singleton en.housing_unit ) ( string ! type ) ) ( call SW.ensureNumericProperty ( string posting_date ) ) ( string > ) ( call SW.ensureNumericEntity ( call SW.concat ( date 2015 1 2 ) ( date 2015 2 3 ) ) ) ) )	overnight-housing
what housing unit has two housing types	( call SW.listValue ( call SW.countComparative ( call SW.getProperty ( call SW.singleton en.housing_unit ) ( string ! type ) ) ( string housing_type ) ( string = ) ( number 2 ) ) )	overnight-housing
cats permitted in unit	( call SW.listValue ( call SW.filter ( call SW.getProperty ( call SW.singleton en.housing_unit ) ( string ! type ) ) ( string allows_cats ) ) )	overnight-housing
find housing units with the least number of neighborhoods	( call SW.listValue ( call SW.countSuperlative ( call SW.getProperty ( call SW.singleton en.housing_unit ) ( string ! type ) ) ( string min ) ( string neighborhood ) ) )	overnight-housing
show me housing which posted on or before the day 123 sesame street did	( call SW.listValue ( call SW.filter ( call SW.getProperty ( call SW.singleton en.housing_unit ) ( string ! type ) ) ( call SW.ensureNumericProperty ( string posting_date ) ) ( string <= ) ( call SW.ensureNumericEntity ( call SW.getProperty en.housing_unit.123_sesame_street ( string posting_date ) ) ) ) )	overnight-housing
find housing units with size lesser than that of 123 sesame street	( call SW.listValue ( call SW.filter ( call SW.getProperty ( call SW.singleton en.housing_unit ) ( string ! type ) ) ( call SW.ensureNumericProperty ( string size ) ) ( string < ) ( call SW.ensureNumericEntity ( call SW.getProperty en.housing_unit.123_sesame_street ( string size ) ) ) ) )	overnight-housing
name the neighborhood of the housing unit with private bath	( call SW.listValue ( call SW.filter ( call SW.getProperty ( call SW.singleton en.neighborhood ) ( string ! type ) ) ( call SW.reverse ( string neighborhood ) ) ( string = ) ( call SW.filter ( call SW.getProperty ( call SW.singleton en.housing_unit ) ( string ! type ) ) ( string has_private_bath ) ) ) )	overnight-housing
exclude apartments from midtown west	( call SW.listValue ( call SW.filter ( call SW.getProperty ( call SW.singleton en.housing_unit ) ( string ! type ) ) ( string neighborhood ) ( string ! = ) en.neighborhood.midtown_west ) )	overnight-housing
which neighborhood is 123 sesame street in	( call SW.listValue ( call SW.filter ( call SW.getProperty ( call SW.singleton en.neighborhood ) ( string ! type ) ) ( call SW.reverse ( string neighborhood ) ) ( string = ) en.housing_unit.123_sesame_street ) )	overnight-housing
housing that is more than 1500month or more than 2000month	( call SW.listValue ( call SW.filter ( call SW.getProperty ( call SW.singleton en.housing_unit ) ( string ! type ) ) ( call SW.ensureNumericProperty ( string rent ) ) ( string > ) ( call SW.ensureNumericEntity ( call SW.concat ( number 1500 en.dollar ) ( number 2000 en.dollar ) ) ) ) )	overnight-housing
housing types of the most units	( call SW.listValue ( call SW.countSuperlative ( call SW.getProperty ( call SW.singleton en.housing ) ( string ! type ) ) ( string max ) ( call SW.reverse ( string housing_type ) ) ( call SW.getProperty ( call SW.singleton en.housing_unit ) ( string ! type ) ) ) )	overnight-housing
what housing with a private room posted jan 2nd	( call SW.listValue ( call SW.filter ( call SW.filter ( call SW.getProperty ( call SW.singleton en.housing_unit ) ( string ! type ) ) ( string posting_date ) ( string = ) ( date 2015 1 2 ) ) ( string has_private_room ) ) )	overnight-housing
housing unit with a cheaper rent than 123 sesame street	( call SW.listValue ( call SW.filter ( call SW.getProperty ( call SW.singleton en.housing_unit ) ( string ! type ) ) ( call SW.ensureNumericProperty ( string rent ) ) ( string < ) ( call SW.ensureNumericEntity ( call SW.getProperty en.housing_unit.123_sesame_street ( string rent ) ) ) ) )	overnight-housing
neighborhood with apartments	( call SW.listValue ( call SW.filter ( call SW.getProperty ( call SW.singleton en.neighborhood ) ( string ! type ) ) ( call SW.reverse ( string neighborhood ) ) ( string = ) ( call SW.filter ( call SW.getProperty ( call SW.singleton en.housing_unit ) ( string ! type ) ) ( string housing_type ) ( string = ) en.housing.apartment ) ) )	overnight-housing
find housing types other than 123 sesame street	( call SW.listValue ( call SW.filter ( call SW.getProperty ( call SW.singleton en.housing ) ( string ! type ) ) ( call SW.reverse ( string housing_type ) ) ( string ! = ) en.housing_unit.123_sesame_street ) )	overnight-housing
units with larger rent than 123 sesame street	( call SW.listValue ( call SW.filter ( call SW.getProperty ( call SW.singleton en.housing_unit ) ( string ! type ) ) ( call SW.ensureNumericProperty ( string rent ) ) ( string > ) ( call SW.ensureNumericEntity ( call SW.getProperty en.housing_unit.123_sesame_street ( string rent ) ) ) ) )	overnight-housing
what type of housing is 123 sesame street	( call SW.listValue ( call SW.filter ( call SW.getProperty ( call SW.singleton en.housing ) ( string ! type ) ) ( call SW.reverse ( string housing_type ) ) ( string = ) en.housing_unit.123_sesame_street ) )	overnight-housing
apartments with rent between 1500 and 2000	( call SW.listValue ( call SW.filter ( call SW.getProperty ( call SW.singleton en.housing_unit ) ( string ! type ) ) ( call SW.ensureNumericProperty ( string rent ) ) ( string < ) ( call SW.ensureNumericEntity ( call SW.concat ( number 1500 en.dollar ) ( number 2000 en.dollar ) ) ) ) )	overnight-housing
show me housing in midtown west or chelsea	( call SW.listValue ( call SW.filter ( call SW.getProperty ( call SW.singleton en.housing_unit ) ( string ! type ) ) ( string neighborhood ) ( string = ) ( call SW.concat en.neighborhood.midtown_west en.neighborhood.chelsea ) ) )	overnight-housing
800 square foot apartment with a private bath	( call SW.listValue ( call SW.filter ( call SW.filter ( call SW.getProperty ( call SW.singleton en.housing_unit ) ( string ! type ) ) ( string has_private_bath ) ) ( string size ) ( string = ) ( number 800 en.square_feet ) ) )	overnight-housing
