housing that is 1500month and includes a private room	( call SW.listValue ( call SW.filter ( call SW.filter ( call SW.getProperty ( call SW.singleton en.housing_unit ) ( string ! type ) ) ( string rent ) ( string = ) ( number 1500 en.dollar ) ) ( string has_private_room ) ) )	overnight-housing
which housing unit permits cats and had a private bath in it	( call SW.listValue ( call SW.filter ( call SW.filter ( call SW.getProperty ( call SW.singleton en.housing_unit ) ( string ! type ) ) ( string allows_cats ) ) ( string has_private_bath ) ) )	overnight-housing
condominium or apartment housing	( call SW.listValue ( call SW.concat en.housing.apartment en.housing.condo ) )	overnight-housing
which housing unit has  the variety of houses	( call SW.listValue ( call SW.countSuperlative ( call SW.getProperty ( call SW.singleton en.housing_unit ) ( string ! type ) ) ( string max ) ( string housing_type ) ) )	overnight-housing
housing unit with size of either 800 or 1000 square feet	( call SW.listValue ( call SW.filter ( call SW.getProperty ( call SW.singleton en.housing_unit ) ( string ! type ) ) ( string size ) ( string = ) ( call SW.concat ( number 800 en.square_feet ) ( number 1000 en.square_feet ) ) ) )	overnight-housing
what housing is priced at 1500 or 2000 dollars	( call SW.listValue ( call SW.filter ( call SW.getProperty ( call SW.singleton en.housing_unit ) ( string ! type ) ) ( call SW.ensureNumericProperty ( string rent ) ) ( string <= ) ( call SW.ensureNumericEntity ( call SW.concat ( number 1500 en.dollar ) ( number 2000 en.dollar ) ) ) ) )	overnight-housing
which housing unit with an area of 800 square permits dogs	( call SW.listValue ( call SW.filter ( call SW.filter ( call SW.getProperty ( call SW.singleton en.housing_unit ) ( string ! type ) ) ( string size ) ( string = ) ( number 800 en.square_feet ) ) ( string allows_dogs ) ) )	overnight-housing
housing unit posted on january 2 and that is the same size as 123 sesame st	( call SW.listValue ( call SW.filter ( call SW.filter ( call SW.getProperty ( call SW.singleton en.housing_unit ) ( string ! type ) ) ( string posting_date ) ( string = ) ( date 2015 1 2 ) ) ( call SW.reverse ( string size ) ) ( string = ) en.housing_unit.123_sesame_street ) )	overnight-housing
housing posted january 2nd that includes a private room	( call SW.listValue ( call SW.filter ( call SW.filter ( call SW.getProperty ( call SW.singleton en.housing_unit ) ( string ! type ) ) ( string posting_date ) ( string = ) ( date 2015 1 2 ) ) ( string has_private_room ) ) )	overnight-housing
looking for a quiet neighborhood	( call SW.listValue ( call SW.countSuperlative ( call SW.getProperty ( call SW.singleton en.neighborhood ) ( string ! type ) ) ( string min ) ( call SW.reverse ( string neighborhood ) ) ( call SW.getProperty ( call SW.singleton en.housing_unit ) ( string ! type ) ) ) )	overnight-housing
find all housing units posted on january 2	( call SW.listValue ( call SW.filter ( call SW.getProperty ( call SW.singleton en.housing ) ( string ! type ) ) ( call SW.reverse ( string housing_type ) ) ( string = ) ( call SW.filter ( call SW.getProperty ( call SW.singleton en.housing_unit ) ( string ! type ) ) ( string posting_date ) ( string = ) ( date 2015 1 2 ) ) ) )	overnight-housing
which housing type allows pets	( call SW.listValue ( call SW.filter ( call SW.getProperty ( call SW.singleton en.housing ) ( string ! type ) ) ( call SW.reverse ( string housing_type ) ) ( string = ) ( call SW.filter ( call SW.getProperty ( call SW.singleton en.housing_unit ) ( string ! type ) ) ( string allows_dogs ) ) ) )	overnight-housing
housing that is at least 800 square feet or at least 1000 square feet	( call SW.listValue ( call SW.filter ( call SW.getProperty ( call SW.singleton en.housing_unit ) ( string ! type ) ) ( call SW.ensureNumericProperty ( string size ) ) ( string >= ) ( call SW.ensureNumericEntity ( call SW.concat ( number 800 en.square_feet ) ( number 1000 en.square_feet ) ) ) ) )	overnight-housing
housing in midtown west neighborhood posted on january 2	( call SW.listValue ( call SW.filter ( call SW.filter ( call SW.getProperty ( call SW.singleton en.housing_unit ) ( string ! type ) ) ( string neighborhood ) ( string = ) en.neighborhood.midtown_west ) ( string posting_date ) ( string = ) ( date 2015 1 2 ) ) )	overnight-housing
housing that is 800 square feet or less	( call SW.listValue ( call SW.filter ( call SW.getProperty ( call SW.singleton en.housing_unit ) ( string ! type ) ) ( call SW.ensureNumericProperty ( string size ) ) ( string <= ) ( call SW.ensureNumericEntity ( number 800 en.square_feet ) ) ) )	overnight-housing
which housing units in the neighbourhood permits dogs inside it	( call SW.listValue ( call SW.filter ( call SW.getProperty ( call SW.singleton en.neighborhood ) ( string ! type ) ) ( call SW.reverse ( string neighborhood ) ) ( string = ) ( call SW.filter ( call SW.getProperty ( call SW.singleton en.housing_unit ) ( string ! type ) ) ( string allows_dogs ) ) ) )	overnight-housing
what kind of housing has two housing types	( call SW.listValue ( call SW.countComparative ( call SW.getProperty ( call SW.singleton en.housing_unit ) ( string ! type ) ) ( string housing_type ) ( string >= ) ( number 2 ) ) )	overnight-housing
smallest apartments	( call SW.listValue ( call SW.superlative ( call SW.getProperty ( call SW.singleton en.housing_unit ) ( string ! type ) ) ( string min ) ( call SW.ensureNumericProperty ( string size ) ) ) )	overnight-housing
january 2 to february 3	( call SW.listValue ( call SW.concat ( date 2015 1 2 ) ( date 2015 2 3 ) ) )	overnight-housing
which area has more than two housing units	( call SW.listValue ( call SW.countComparative ( call SW.getProperty ( call SW.singleton en.neighborhood ) ( string ! type ) ) ( call SW.reverse ( string neighborhood ) ) ( string > ) ( number 2 ) ( call SW.getProperty ( call SW.singleton en.housing_unit ) ( string ! type ) ) ) )	overnight-housing
exclude apartments from midtown west	( call SW.listValue ( call SW.filter ( call SW.getProperty ( call SW.singleton en.housing_unit ) ( string ! type ) ) ( string neighborhood ) ( string ! = ) en.neighborhood.midtown_west ) )	overnight-housing
what neighborhood has less than two housing units	( call SW.listValue ( call SW.countComparative ( call SW.getProperty ( call SW.singleton en.neighborhood ) ( string ! type ) ) ( call SW.reverse ( string neighborhood ) ) ( string < ) ( number 2 ) ( call SW.getProperty ( call SW.singleton en.housing_unit ) ( string ! type ) ) ) )	overnight-housing
what housing unit allowing dogs was posted on jan 2	( call SW.listValue ( call SW.filter ( call SW.filter ( call SW.getProperty ( call SW.singleton en.housing_unit ) ( string ! type ) ) ( string posting_date ) ( string = ) ( date 2015 1 2 ) ) ( string allows_dogs ) ) )	overnight-housing
dogfriendly housing	( call SW.listValue ( call SW.filter ( call SW.filter ( call SW.getProperty ( call SW.singleton en.housing_unit ) ( string ! type ) ) ( string allows_dogs ) ) ( string allows_dogs ) ) )	overnight-housing
list all apartments in midtown west	( call SW.listValue ( call SW.filter ( call SW.filter ( call SW.getProperty ( call SW.singleton en.housing_unit ) ( string ! type ) ) ( string housing_type ) ( string = ) en.housing.apartment ) ( string neighborhood ) ( string = ) en.neighborhood.midtown_west ) )	overnight-housing
area around 123sesame street	( call SW.listValue ( call SW.getProperty en.housing_unit.123_sesame_street ( string neighborhood ) ) )	overnight-housing
apartment or condo	( call SW.listValue ( call SW.filter ( call SW.getProperty ( call SW.singleton en.housing_unit ) ( string ! type ) ) ( string housing_type ) ( string = ) ( call SW.concat en.housing.apartment en.housing.condo ) ) )	overnight-housing
what kind of housing is the housing unit posted on jan 2	( call SW.listValue ( call SW.filter ( call SW.getProperty ( call SW.singleton en.housing ) ( string ! type ) ) ( call SW.reverse ( string housing_type ) ) ( string = ) ( call SW.filter ( call SW.getProperty ( call SW.singleton en.housing_unit ) ( string ! type ) ) ( string posting_date ) ( string = ) ( date 2015 1 2 ) ) ) )	overnight-housing
what is the housing type at 123 sesame street	( call SW.listValue ( call SW.filter ( call SW.getProperty ( call SW.singleton en.housing ) ( string ! type ) ) ( call SW.reverse ( string housing_type ) ) ( string = ) en.housing_unit.123_sesame_street ) )	overnight-housing
show me housing which posted on or before the day 123 sesame street did	( call SW.listValue ( call SW.filter ( call SW.getProperty ( call SW.singleton en.housing_unit ) ( string ! type ) ) ( call SW.ensureNumericProperty ( string posting_date ) ) ( string <= ) ( call SW.ensureNumericEntity ( call SW.getProperty en.housing_unit.123_sesame_street ( string posting_date ) ) ) ) )	overnight-housing
what kind of housing is 123 sesame street	( call SW.listValue ( call SW.getProperty en.housing_unit.123_sesame_street ( string housing_type ) ) )	overnight-housing
find 800 square feet sized housing units	( call SW.listValue ( call SW.filter ( call SW.getProperty ( call SW.singleton en.housing_unit ) ( string ! type ) ) ( string size ) ( string = ) ( number 800 en.square_feet ) ) )	overnight-housing
find housing units that are pet friendly	( call SW.listValue ( call SW.filter ( call SW.filter ( call SW.getProperty ( call SW.singleton en.housing_unit ) ( string ! type ) ) ( string allows_dogs ) ) ( string allows_dogs ) ) )	overnight-housing
apartment in a quiet neighborhood	( call SW.listValue ( call SW.countSuperlative ( call SW.getProperty ( call SW.singleton en.housing_unit ) ( string ! type ) ) ( string min ) ( string neighborhood ) ) )	overnight-housing
which housing units are at least 800 square feet in size	( call SW.listValue ( call SW.filter ( call SW.getProperty ( call SW.singleton en.housing_unit ) ( string ! type ) ) ( call SW.ensureNumericProperty ( string size ) ) ( string >= ) ( call SW.ensureNumericEntity ( number 800 en.square_feet ) ) ) )	overnight-housing
apartments in the midtown west neighborhood	( call SW.listValue ( call SW.filter ( call SW.filter ( call SW.getProperty ( call SW.singleton en.housing_unit ) ( string ! type ) ) ( string housing_type ) ( string = ) en.housing.apartment ) ( string neighborhood ) ( string = ) en.neighborhood.midtown_west ) )	overnight-housing
housing unit that is not 800 square feet	( call SW.listValue ( call SW.filter ( call SW.getProperty ( call SW.singleton en.housing_unit ) ( string ! type ) ) ( string size ) ( string ! = ) ( number 800 en.square_feet ) ) )	overnight-housing
which housing unit in the midtown west area has a private room	( call SW.listValue ( call SW.filter ( call SW.filter ( call SW.getProperty ( call SW.singleton en.housing_unit ) ( string ! type ) ) ( string has_private_room ) ) ( string neighborhood ) ( string = ) en.neighborhood.midtown_west ) )	overnight-housing
aparartment or condo units	( call SW.listValue ( call SW.filter ( call SW.getProperty ( call SW.singleton en.housing_unit ) ( string ! type ) ) ( string housing_type ) ( string = ) ( call SW.concat en.housing.apartment en.housing.condo ) ) )	overnight-housing
apartments in midtown west with a private room	( call SW.listValue ( call SW.filter ( call SW.filter ( call SW.getProperty ( call SW.singleton en.housing_unit ) ( string ! type ) ) ( string has_private_room ) ) ( string neighborhood ) ( string = ) en.neighborhood.midtown_west ) )	overnight-housing
how large is 123 sesame street	( call SW.listValue ( call SW.getProperty en.housing_unit.123_sesame_street ( string size ) ) )	overnight-housing
housing unit which is an apartment housing type with a private room	( call SW.listValue ( call SW.filter ( call SW.filter ( call SW.getProperty ( call SW.singleton en.housing_unit ) ( string ! type ) ) ( string housing_type ) ( string = ) en.housing.apartment ) ( string has_private_room ) ) )	overnight-housing
housing unit bigger than 800 square feet	( call SW.listValue ( call SW.filter ( call SW.getProperty ( call SW.singleton en.housing_unit ) ( string ! type ) ) ( call SW.ensureNumericProperty ( string size ) ) ( string >= ) ( call SW.ensureNumericEntity ( number 800 en.square_feet ) ) ) )	overnight-housing
housing like 123 sesame street that was posted on january 2	( call SW.listValue ( call SW.filter ( call SW.filter ( call SW.getProperty ( call SW.singleton en.housing_unit ) ( string ! type ) ) ( string posting_date ) ( string = ) ( date 2015 1 2 ) ) ( call SW.reverse ( string size ) ) ( string = ) en.housing_unit.123_sesame_street ) )	overnight-housing
housing found in the most neighborhoods	( call SW.listValue ( call SW.countSuperlative ( call SW.getProperty ( call SW.singleton en.housing_unit ) ( string ! type ) ) ( string max ) ( string neighborhood ) ) )	overnight-housing
housing that allows dogs and was posted on january 2	( call SW.listValue ( call SW.filter ( call SW.filter ( call SW.getProperty ( call SW.singleton en.housing_unit ) ( string ! type ) ) ( string posting_date ) ( string = ) ( date 2015 1 2 ) ) ( string allows_dogs ) ) )	overnight-housing
what housing unit contains a private room and allows cats	( call SW.listValue ( call SW.filter ( call SW.filter ( call SW.getProperty ( call SW.singleton en.housing_unit ) ( string ! type ) ) ( string allows_cats ) ) ( string has_private_room ) ) )	overnight-housing
what is the kind of housing available in 123 sesamre street	( call SW.listValue ( call SW.filter ( call SW.getProperty ( call SW.singleton en.housing ) ( string ! type ) ) ( call SW.reverse ( string housing_type ) ) ( string = ) en.housing_unit.123_sesame_street ) )	overnight-housing
what housing unit has two or more housing types	( call SW.listValue ( call SW.countComparative ( call SW.getProperty ( call SW.singleton en.housing_unit ) ( string ! type ) ) ( string housing_type ) ( string > ) ( number 2 ) ) )	overnight-housing
apartments posted on january 2	( call SW.listValue ( call SW.filter ( call SW.getProperty ( call SW.singleton en.housing_unit ) ( string ! type ) ) ( call SW.ensureNumericProperty ( string posting_date ) ) ( string <= ) ( call SW.ensureNumericEntity ( date 2015 1 2 ) ) ) )	overnight-housing
rent between 1500 and 2000 dollars	( call SW.listValue ( call SW.concat ( number 1500 en.dollar ) ( number 2000 en.dollar ) ) )	overnight-housing
housing that was posted on february 3	( call SW.listValue ( call SW.filter ( call SW.getProperty ( call SW.singleton en.housing_unit ) ( string ! type ) ) ( call SW.ensureNumericProperty ( string posting_date ) ) ( string >= ) ( call SW.ensureNumericEntity ( call SW.concat ( date 2015 1 2 ) ( date 2015 2 3 ) ) ) ) )	overnight-housing
neighborhoods with the least housing units	( call SW.listValue ( call SW.countSuperlative ( call SW.getProperty ( call SW.singleton en.neighborhood ) ( string ! type ) ) ( string min ) ( call SW.reverse ( string neighborhood ) ) ( call SW.getProperty ( call SW.singleton en.housing_unit ) ( string ! type ) ) ) )	overnight-housing
what housing is the same type as the housing posted on january 2	( call SW.listValue ( call SW.filter ( call SW.getProperty ( call SW.singleton en.housing ) ( string ! type ) ) ( call SW.reverse ( string housing_type ) ) ( string = ) ( call SW.filter ( call SW.getProperty ( call SW.singleton en.housing_unit ) ( string ! type ) ) ( string posting_date ) ( string = ) ( date 2015 1 2 ) ) ) )	overnight-housing
a housing unit with a private bath that posted on january 2	( call SW.listValue ( call SW.filter ( call SW.filter ( call SW.getProperty ( call SW.singleton en.housing_unit ) ( string ! type ) ) ( string has_private_bath ) ) ( string posting_date ) ( string = ) ( date 2015 1 2 ) ) )	overnight-housing
condomonium or flat	( call SW.listValue ( call SW.concat en.housing.apartment en.housing.condo ) )	overnight-housing
find housing units in the same size of 123 sesame street	( call SW.listValue ( call SW.filter ( call SW.getProperty ( call SW.singleton en.housing_unit ) ( string ! type ) ) ( string size ) ( string = ) ( call SW.getProperty en.housing_unit.123_sesame_street ( string size ) ) ) )	overnight-housing
housing the same size as 123 sesame street	( call SW.listValue ( call SW.filter ( call SW.getProperty ( call SW.singleton en.housing_unit ) ( string ! type ) ) ( call SW.ensureNumericProperty ( string size ) ) ( string <= ) ( call SW.ensureNumericEntity ( call SW.getProperty en.housing_unit.123_sesame_street ( string size ) ) ) ) )	overnight-housing
which housing unit has an area of 800 square feet	( call SW.listValue ( call SW.filter ( call SW.filter ( call SW.getProperty ( call SW.singleton en.housing_unit ) ( string ! type ) ) ( string size ) ( string = ) ( number 800 en.square_feet ) ) ( string size ) ( string = ) ( number 800 en.square_feet ) ) )	overnight-housing
housing that is not 1500month	( call SW.listValue ( call SW.filter ( call SW.getProperty ( call SW.singleton en.housing_unit ) ( string ! type ) ) ( string rent ) ( string ! = ) ( number 1500 en.dollar ) ) )	overnight-housing
housing unit that is an aprtment	( call SW.listValue ( call SW.filter ( call SW.filter ( call SW.getProperty ( call SW.singleton en.housing_unit ) ( string ! type ) ) ( string housing_type ) ( string = ) en.housing.apartment ) ( string housing_type ) ( string = ) en.housing.apartment ) )	overnight-housing
housing posted on january 2	( call SW.listValue ( call SW.filter ( call SW.getProperty ( call SW.singleton en.housing ) ( string ! type ) ) ( call SW.reverse ( string housing_type ) ) ( string = ) ( call SW.filter ( call SW.getProperty ( call SW.singleton en.housing_unit ) ( string ! type ) ) ( string posting_date ) ( string = ) ( date 2015 1 2 ) ) ) )	overnight-housing
which housing unit permits cats in it	( call SW.listValue ( call SW.filter ( call SW.getProperty ( call SW.singleton en.housing_unit ) ( string ! type ) ) ( string allows_cats ) ) )	overnight-housing
find housing units with 1500 dollars as rent and is near midtown west	( call SW.listValue ( call SW.filter ( call SW.filter ( call SW.getProperty ( call SW.singleton en.housing_unit ) ( string ! type ) ) ( string rent ) ( string = ) ( number 1500 en.dollar ) ) ( string neighborhood ) ( string = ) en.neighborhood.midtown_west ) )	overnight-housing
cats allowed in midtown west	( call SW.listValue ( call SW.filter ( call SW.filter ( call SW.getProperty ( call SW.singleton en.housing_unit ) ( string ! type ) ) ( string neighborhood ) ( string = ) en.neighborhood.midtown_west ) ( string allows_cats ) ) )	overnight-housing
housing unit with the smallest posting date	( call SW.listValue ( call SW.superlative ( call SW.getProperty ( call SW.singleton en.housing_unit ) ( string ! type ) ) ( string min ) ( call SW.ensureNumericProperty ( string posting_date ) ) ) )	overnight-housing
show housing types for three or more units	( call SW.listValue ( call SW.countComparative ( call SW.getProperty ( call SW.singleton en.housing ) ( string ! type ) ) ( call SW.reverse ( string housing_type ) ) ( string > ) ( number 2 ) ( call SW.getProperty ( call SW.singleton en.housing_unit ) ( string ! type ) ) ) )	overnight-housing
housing not posted on january 2	( call SW.listValue ( call SW.filter ( call SW.getProperty ( call SW.singleton en.housing_unit ) ( string ! type ) ) ( string posting_date ) ( string ! = ) ( date 2015 1 2 ) ) )	overnight-housing
private bath with 800 square feet	( call SW.listValue ( call SW.filter ( call SW.filter ( call SW.getProperty ( call SW.singleton en.housing_unit ) ( string ! type ) ) ( string has_private_bath ) ) ( string size ) ( string = ) ( number 800 en.square_feet ) ) )	overnight-housing
which housing unit is more expensive than 123 sesame street	( call SW.listValue ( call SW.filter ( call SW.getProperty ( call SW.singleton en.housing_unit ) ( string ! type ) ) ( call SW.ensureNumericProperty ( string rent ) ) ( string > ) ( call SW.ensureNumericEntity ( call SW.getProperty en.housing_unit.123_sesame_street ( string rent ) ) ) ) )	overnight-housing
what is the neighborhood of 123 sesame street called as	( call SW.listValue ( call SW.filter ( call SW.filter ( call SW.getProperty ( call SW.singleton en.neighborhood ) ( string ! type ) ) ( call SW.reverse ( string neighborhood ) ) ( string = ) en.housing_unit.123_sesame_street ) ( call SW.reverse ( string neighborhood ) ) ( string = ) en.housing_unit.123_sesame_street ) )	overnight-housing
housing costing more than 1500 dollars per month	( call SW.listValue ( call SW.filter ( call SW.getProperty ( call SW.singleton en.housing_unit ) ( string ! type ) ) ( call SW.ensureNumericProperty ( string rent ) ) ( string > ) ( call SW.ensureNumericEntity ( number 1500 en.dollar ) ) ) )	overnight-housing
units posted before january 2nd	( call SW.listValue ( call SW.filter ( call SW.getProperty ( call SW.singleton en.housing_unit ) ( string ! type ) ) ( call SW.ensureNumericProperty ( string posting_date ) ) ( string < ) ( call SW.ensureNumericEntity ( date 2015 1 2 ) ) ) )	overnight-housing
neighborhood that has two housing	( call SW.listValue ( call SW.countComparative ( call SW.getProperty ( call SW.singleton en.neighborhood ) ( string ! type ) ) ( call SW.reverse ( string neighborhood ) ) ( string = ) ( number 2 ) ( call SW.getProperty ( call SW.singleton en.housing_unit ) ( string ! type ) ) ) )	overnight-housing
housing unit with a posting date bigger than the date of 123 sesame street	( call SW.listValue ( call SW.filter ( call SW.getProperty ( call SW.singleton en.housing_unit ) ( string ! type ) ) ( call SW.ensureNumericProperty ( string posting_date ) ) ( string > ) ( call SW.ensureNumericEntity ( call SW.getProperty en.housing_unit.123_sesame_street ( string posting_date ) ) ) ) )	overnight-housing
