take out restaurant in midtown west	( call SW.listValue ( call SW.filter ( call SW.filter ( call SW.getProperty ( call SW.singleton en.restaurant ) ( string ! type ) ) ( string takeout ) ) ( string neighborhood ) ( string = ) en.neighborhood.midtown_west ) )	overnight-restaurants
which restaurants accept reservation and have outdoor seating	( call SW.listValue ( call SW.filter ( call SW.filter ( call SW.getProperty ( call SW.singleton en.restaurant ) ( string ! type ) ) ( string reserve ) ) ( string outdoor ) ) )	overnight-restaurants
restaurants that deliver and are open for lunch	( call SW.listValue ( call SW.filter ( call SW.filter ( call SW.getProperty ( call SW.singleton en.restaurant ) ( string ! type ) ) ( string meals ) ( string = ) en.food.lunch ) ( string delivery ) ) )	overnight-restaurants
hotel that offers lunch and has outdoor seating facilities	( call SW.listValue ( call SW.filter ( call SW.filter ( call SW.getProperty ( call SW.singleton en.restaurant ) ( string ! type ) ) ( string outdoor ) ) ( string meals ) ( string = ) en.food.lunch ) )	overnight-restaurants
list all restaurants that areworse than 3 or 5 star rated restaurants	( call SW.listValue ( call SW.filter ( call SW.getProperty ( call SW.singleton en.restaurant ) ( string ! type ) ) ( call SW.ensureNumericProperty ( string star_rating ) ) ( string < ) ( call SW.ensureNumericEntity ( call SW.concat ( number 3 en.star ) ( number 5 en.star ) ) ) ) )	overnight-restaurants
what is a good kids restaurant	( call SW.listValue ( call SW.filter ( call SW.getProperty ( call SW.singleton en.restaurant ) ( string ! type ) ) ( string kids ) ) )	overnight-restaurants
hotel that serves the minimum number of meals	( call SW.listValue ( call SW.countSuperlative ( call SW.getProperty ( call SW.singleton en.restaurant ) ( string ! type ) ) ( string min ) ( string meals ) ( call SW.getProperty ( call SW.singleton en.food ) ( string ! type ) ) ) )	overnight-restaurants
cuisine unlike thai cafe	( call SW.listValue ( call SW.filter ( call SW.getProperty ( call SW.singleton en.cuisine ) ( string ! type ) ) ( call SW.reverse ( string cuisine ) ) ( string ! = ) en.restaurant.thai_cafe ) )	overnight-restaurants
restaurants in midtown west rated 3 stars	( call SW.listValue ( call SW.filter ( call SW.filter ( call SW.getProperty ( call SW.singleton en.restaurant ) ( string ! type ) ) ( string star_rating ) ( string = ) ( number 3 en.star ) ) ( string neighborhood ) ( string = ) en.neighborhood.midtown_west ) )	overnight-restaurants
restaurant whose star rating is at least star rating of thai cafe	( call SW.listValue ( call SW.filter ( call SW.getProperty ( call SW.singleton en.restaurant ) ( string ! type ) ) ( call SW.ensureNumericProperty ( string star_rating ) ) ( string >= ) ( call SW.ensureNumericEntity ( call SW.getProperty en.restaurant.thai_cafe ( string star_rating ) ) ) ) )	overnight-restaurants
restaurants open for lunch	( call SW.listValue ( call SW.filter ( call SW.getProperty ( call SW.singleton en.restaurant ) ( string ! type ) ) ( string meals ) ( string = ) en.food.lunch ) )	overnight-restaurants
restaurants that can be booked in advance and that offers delivery services	( call SW.listValue ( call SW.filter ( call SW.filter ( call SW.getProperty ( call SW.singleton en.restaurant ) ( string ! type ) ) ( string delivery ) ) ( string reserve ) ) )	overnight-restaurants
three star restaurants that accept credit cards	( call SW.listValue ( call SW.filter ( call SW.filter ( call SW.getProperty ( call SW.singleton en.restaurant ) ( string ! type ) ) ( string star_rating ) ( string = ) ( number 3 en.star ) ) ( string credit ) ) )	overnight-restaurants
what neighborhood has a restaurant that contains outdoor seating	( call SW.listValue ( call SW.filter ( call SW.getProperty ( call SW.singleton en.neighborhood ) ( string ! type ) ) ( call SW.reverse ( string neighborhood ) ) ( string = ) ( call SW.filter ( call SW.getProperty ( call SW.singleton en.restaurant ) ( string ! type ) ) ( string outdoor ) ) ) )	overnight-restaurants
a good thai resturant with room for groups	( call SW.listValue ( call SW.filter ( call SW.filter ( call SW.getProperty ( call SW.singleton en.restaurant ) ( string ! type ) ) ( string cuisine ) ( string = ) en.cuisine.thai ) ( string groups ) ) )	overnight-restaurants
which restaurant not only serves lunch but has delivery	( call SW.listValue ( call SW.filter ( call SW.filter ( call SW.getProperty ( call SW.singleton en.restaurant ) ( string ! type ) ) ( string meals ) ( string = ) en.food.lunch ) ( string delivery ) ) )	overnight-restaurants
this restaurant had the largest rating in price	( call SW.listValue ( call SW.superlative ( call SW.getProperty ( call SW.singleton en.restaurant ) ( string ! type ) ) ( string max ) ( call SW.ensureNumericProperty ( string price_rating ) ) ) )	overnight-restaurants
restaurants that take credit cards with a price rating of 2	( call SW.listValue ( call SW.filter ( call SW.filter ( call SW.getProperty ( call SW.singleton en.restaurant ) ( string ! type ) ) ( string credit ) ) ( string price_rating ) ( string = ) ( number 2 en.dollar_sign ) ) )	overnight-restaurants
restaurant that has the  take out facility and has outdoor seating	( call SW.listValue ( call SW.filter ( call SW.filter ( call SW.getProperty ( call SW.singleton en.restaurant ) ( string ! type ) ) ( string outdoor ) ) ( string takeout ) ) )	overnight-restaurants
restaurant that serves at most two meal	( call SW.listValue ( call SW.countComparative ( call SW.getProperty ( call SW.singleton en.restaurant ) ( string ! type ) ) ( string meals ) ( string <= ) ( number 2 ) ( call SW.getProperty ( call SW.singleton en.food ) ( string ! type ) ) ) )	overnight-restaurants
restaurant that serves lunch and that has takeout	( call SW.listValue ( call SW.filter ( call SW.filter ( call SW.getProperty ( call SW.singleton en.restaurant ) ( string ! type ) ) ( string meals ) ( string = ) en.food.lunch ) ( string takeout ) ) )	overnight-restaurants
list all restaurants that serves less than two meals	( call SW.listValue ( call SW.countComparative ( call SW.getProperty ( call SW.singleton en.restaurant ) ( string ! type ) ) ( string meals ) ( string < ) ( number 2 ) ( call SW.getProperty ( call SW.singleton en.food ) ( string ! type ) ) ) )	overnight-restaurants
what is the cuisine of restaurants that serve lunch	( call SW.listValue ( call SW.filter ( call SW.getProperty ( call SW.singleton en.cuisine ) ( string ! type ) ) ( call SW.reverse ( string cuisine ) ) ( string = ) ( call SW.filter ( call SW.getProperty ( call SW.singleton en.restaurant ) ( string ! type ) ) ( string meals ) ( string = ) en.food.lunch ) ) )	overnight-restaurants
what restaurant offers outdoor seating	( call SW.listValue ( call SW.filter ( call SW.filter ( call SW.getProperty ( call SW.singleton en.restaurant ) ( string ! type ) ) ( string outdoor ) ) ( string outdoor ) ) )	overnight-restaurants
which restaurant is the most highly rated	( call SW.listValue ( call SW.superlative ( call SW.getProperty ( call SW.singleton en.restaurant ) ( string ! type ) ) ( string max ) ( call SW.ensureNumericProperty ( string star_rating ) ) ) )	overnight-restaurants
what restaurants serve lunch and offer takeout	( call SW.listValue ( call SW.filter ( call SW.filter ( call SW.getProperty ( call SW.singleton en.restaurant ) ( string ! type ) ) ( string takeout ) ) ( string meals ) ( string = ) en.food.lunch ) )	overnight-restaurants
restaurants with 2 price rating that is groupfriendly	( call SW.listValue ( call SW.filter ( call SW.filter ( call SW.getProperty ( call SW.singleton en.restaurant ) ( string ! type ) ) ( string groups ) ) ( string price_rating ) ( string = ) ( number 2 en.dollar_sign ) ) )	overnight-restaurants
which restaurant in midtown west has outdoor seating available	( call SW.listValue ( call SW.filter ( call SW.filter ( call SW.getProperty ( call SW.singleton en.restaurant ) ( string ! type ) ) ( string outdoor ) ) ( string neighborhood ) ( string = ) en.neighborhood.midtown_west ) )	overnight-restaurants
what 2 dollar signs restaurant has outdoor seating	( call SW.listValue ( call SW.filter ( call SW.filter ( call SW.getProperty ( call SW.singleton en.restaurant ) ( string ! type ) ) ( string price_rating ) ( string = ) ( number 2 en.dollar_sign ) ) ( string outdoor ) ) )	overnight-restaurants
which restaurant has the lowest star rating	( call SW.listValue ( call SW.superlative ( call SW.getProperty ( call SW.singleton en.restaurant ) ( string ! type ) ) ( string min ) ( call SW.ensureNumericProperty ( string star_rating ) ) ) )	overnight-restaurants
which restaurant chain is found in the fewest neighborhoods	( call SW.listValue ( call SW.countSuperlative ( call SW.getProperty ( call SW.singleton en.restaurant ) ( string ! type ) ) ( string min ) ( string neighborhood ) ) )	overnight-restaurants
restaurants with waiters that have a price rating of 2	( call SW.listValue ( call SW.filter ( call SW.filter ( call SW.getProperty ( call SW.singleton en.restaurant ) ( string ! type ) ) ( string price_rating ) ( string = ) ( number 2 en.dollar_sign ) ) ( string waiter ) ) )	overnight-restaurants
what is a meal served by the thai cafe	( call SW.listValue ( call SW.filter ( call SW.getProperty ( call SW.singleton en.food ) ( string ! type ) ) ( call SW.reverse ( string meals ) ) ( string = ) en.restaurant.thai_cafe ) )	overnight-restaurants
what restaurant has 3 stars and has a 2 menu	( call SW.listValue ( call SW.filter ( call SW.filter ( call SW.getProperty ( call SW.singleton en.restaurant ) ( string ! type ) ) ( string star_rating ) ( string = ) ( number 3 en.star ) ) ( string price_rating ) ( string = ) ( number 2 en.dollar_sign ) ) )	overnight-restaurants
what are the cuisines of all the midtown west restaurants	( call SW.listValue ( call SW.filter ( call SW.getProperty ( call SW.singleton en.cuisine ) ( string ! type ) ) ( call SW.reverse ( string cuisine ) ) ( string = ) ( call SW.filter ( call SW.getProperty ( call SW.singleton en.restaurant ) ( string ! type ) ) ( string neighborhood ) ( string = ) en.neighborhood.midtown_west ) ) )	overnight-restaurants
list all restaurants that is cheaper than 2 dollar signs	( call SW.listValue ( call SW.filter ( call SW.getProperty ( call SW.singleton en.restaurant ) ( string ! type ) ) ( call SW.ensureNumericProperty ( string price_rating ) ) ( string <= ) ( call SW.ensureNumericEntity ( number 2 en.dollar_sign ) ) ) )	overnight-restaurants
restaurants with a 2 dollar sign rating that take credit cards	( call SW.listValue ( call SW.filter ( call SW.filter ( call SW.getProperty ( call SW.singleton en.restaurant ) ( string ! type ) ) ( string credit ) ) ( string price_rating ) ( string = ) ( number 2 en.dollar_sign ) ) )	overnight-restaurants
which restaurant accepts kids and offers takeout	( call SW.listValue ( call SW.filter ( call SW.filter ( call SW.getProperty ( call SW.singleton en.restaurant ) ( string ! type ) ) ( string kids ) ) ( string takeout ) ) )	overnight-restaurants
what meals do credit card taking restaurants serve	( call SW.listValue ( call SW.filter ( call SW.getProperty ( call SW.singleton en.food ) ( string ! type ) ) ( call SW.reverse ( string meals ) ) ( string = ) ( call SW.filter ( call SW.getProperty ( call SW.singleton en.restaurant ) ( string ! type ) ) ( string credit ) ) ) )	overnight-restaurants
restaurants in midtown west that have takeout	( call SW.listValue ( call SW.filter ( call SW.filter ( call SW.getProperty ( call SW.singleton en.restaurant ) ( string ! type ) ) ( string neighborhood ) ( string = ) en.neighborhood.midtown_west ) ( string takeout ) ) )	overnight-restaurants
which neighborhoods have restaurants that serve lunch	( call SW.listValue ( call SW.filter ( call SW.getProperty ( call SW.singleton en.neighborhood ) ( string ! type ) ) ( call SW.reverse ( string neighborhood ) ) ( string = ) ( call SW.filter ( call SW.getProperty ( call SW.singleton en.restaurant ) ( string ! type ) ) ( string meals ) ( string = ) en.food.lunch ) ) )	overnight-restaurants
find a 3 star restaurant that is good for groups	( call SW.listValue ( call SW.filter ( call SW.filter ( call SW.getProperty ( call SW.singleton en.restaurant ) ( string ! type ) ) ( string groups ) ) ( string star_rating ) ( string = ) ( number 3 en.star ) ) )	overnight-restaurants
which restaurant has waiters and a star rating of three stars	( call SW.listValue ( call SW.filter ( call SW.filter ( call SW.getProperty ( call SW.singleton en.restaurant ) ( string ! type ) ) ( string waiter ) ) ( string star_rating ) ( string = ) ( number 3 en.star ) ) )	overnight-restaurants
what 2 dollar signs offers lunch	( call SW.listValue ( call SW.filter ( call SW.filter ( call SW.getProperty ( call SW.singleton en.restaurant ) ( string ! type ) ) ( string price_rating ) ( string = ) ( number 2 en.dollar_sign ) ) ( string meals ) ( string = ) en.food.lunch ) )	overnight-restaurants
thai restaurants that have takeout	( call SW.listValue ( call SW.filter ( call SW.filter ( call SW.getProperty ( call SW.singleton en.restaurant ) ( string ! type ) ) ( string cuisine ) ( string = ) en.cuisine.thai ) ( string takeout ) ) )	overnight-restaurants
what is a meal served in a thai restaurant	( call SW.listValue ( call SW.filter ( call SW.getProperty ( call SW.singleton en.food ) ( string ! type ) ) ( call SW.reverse ( string meals ) ) ( string = ) ( call SW.filter ( call SW.getProperty ( call SW.singleton en.restaurant ) ( string ! type ) ) ( string cuisine ) ( string = ) en.cuisine.thai ) ) )	overnight-restaurants
restaurant that has at least 3 star rating	( call SW.listValue ( call SW.filter ( call SW.getProperty ( call SW.singleton en.restaurant ) ( string ! type ) ) ( call SW.ensureNumericProperty ( string star_rating ) ) ( string >= ) ( call SW.ensureNumericEntity ( number 3 en.star ) ) ) )	overnight-restaurants
hotel that has waiter service  and take out facilities	( call SW.listValue ( call SW.filter ( call SW.filter ( call SW.getProperty ( call SW.singleton en.restaurant ) ( string ! type ) ) ( string waiter ) ) ( string takeout ) ) )	overnight-restaurants
what neighborhood has restaurants that accept credit cards	( call SW.listValue ( call SW.filter ( call SW.getProperty ( call SW.singleton en.neighborhood ) ( string ! type ) ) ( call SW.reverse ( string neighborhood ) ) ( string = ) ( call SW.filter ( call SW.getProperty ( call SW.singleton en.restaurant ) ( string ! type ) ) ( string credit ) ) ) )	overnight-restaurants
what meal is served by fewer than two restaurants	( call SW.listValue ( call SW.countComparative ( call SW.getProperty ( call SW.singleton en.food ) ( string ! type ) ) ( call SW.reverse ( string meals ) ) ( string < ) ( number 2 ) ( call SW.getProperty ( call SW.singleton en.restaurant ) ( string ! type ) ) ) )	overnight-restaurants
which restaurants serve lunch and have an outdoor dining area	( call SW.listValue ( call SW.filter ( call SW.filter ( call SW.getProperty ( call SW.singleton en.restaurant ) ( string ! type ) ) ( string outdoor ) ) ( string meals ) ( string = ) en.food.lunch ) )	overnight-restaurants
restaurant serving lunch that can deliver	( call SW.listValue ( call SW.filter ( call SW.filter ( call SW.getProperty ( call SW.singleton en.restaurant ) ( string ! type ) ) ( string delivery ) ) ( string meals ) ( string = ) en.food.lunch ) )	overnight-restaurants
which restaurants serve less than two meals	( call SW.listValue ( call SW.countComparative ( call SW.getProperty ( call SW.singleton en.restaurant ) ( string ! type ) ) ( string meals ) ( string < ) ( number 2 ) ( call SW.getProperty ( call SW.singleton en.food ) ( string ! type ) ) ) )	overnight-restaurants
a thai restaurant with medium pricing	( call SW.listValue ( call SW.filter ( call SW.getProperty ( call SW.singleton en.cuisine ) ( string ! type ) ) ( call SW.reverse ( string cuisine ) ) ( string = ) ( call SW.filter ( call SW.getProperty ( call SW.singleton en.restaurant ) ( string ! type ) ) ( string price_rating ) ( string = ) ( number 2 en.dollar_sign ) ) ) )	overnight-restaurants
which restaurant has a price rating no higher than thai cafe	( call SW.listValue ( call SW.filter ( call SW.getProperty ( call SW.singleton en.restaurant ) ( string ! type ) ) ( call SW.ensureNumericProperty ( string price_rating ) ) ( string <= ) ( call SW.ensureNumericEntity ( call SW.getProperty en.restaurant.thai_cafe ( string price_rating ) ) ) ) )	overnight-restaurants
what 2 dollar sign restaurant contains takeout	( call SW.listValue ( call SW.filter ( call SW.filter ( call SW.getProperty ( call SW.singleton en.restaurant ) ( string ! type ) ) ( string takeout ) ) ( string price_rating ) ( string = ) ( number 2 en.dollar_sign ) ) )	overnight-restaurants
restaurant that has the least number of cuisine	( call SW.listValue ( call SW.countSuperlative ( call SW.getProperty ( call SW.singleton en.restaurant ) ( string ! type ) ) ( string min ) ( string cuisine ) ) )	overnight-restaurants
area that has the minimum number of restaurants	( call SW.listValue ( call SW.countSuperlative ( call SW.getProperty ( call SW.singleton en.neighborhood ) ( string ! type ) ) ( string min ) ( call SW.reverse ( string neighborhood ) ) ( call SW.getProperty ( call SW.singleton en.restaurant ) ( string ! type ) ) ) )	overnight-restaurants
what is a meal served at a restaurant that has waiters	( call SW.listValue ( call SW.filter ( call SW.getProperty ( call SW.singleton en.food ) ( string ! type ) ) ( call SW.reverse ( string meals ) ) ( string = ) ( call SW.filter ( call SW.getProperty ( call SW.singleton en.restaurant ) ( string ! type ) ) ( string waiter ) ) ) )	overnight-restaurants
restaurants in midtown west that have takeout	( call SW.listValue ( call SW.filter ( call SW.filter ( call SW.getProperty ( call SW.singleton en.restaurant ) ( string ! type ) ) ( string neighborhood ) ( string = ) en.neighborhood.midtown_west ) ( string takeout ) ) )	overnight-restaurants
thai restaurants rated 3 stars	( call SW.listValue ( call SW.filter ( call SW.filter ( call SW.getProperty ( call SW.singleton en.restaurant ) ( string ! type ) ) ( string star_rating ) ( string = ) ( number 3 en.star ) ) ( string cuisine ) ( string = ) en.cuisine.thai ) )	overnight-restaurants
what neighborhood contains the most restaurants that offer reservations	( call SW.listValue ( call SW.filter ( call SW.getProperty ( call SW.singleton en.neighborhood ) ( string ! type ) ) ( call SW.reverse ( string neighborhood ) ) ( string = ) ( call SW.filter ( call SW.getProperty ( call SW.singleton en.restaurant ) ( string ! type ) ) ( string reserve ) ) ) )	overnight-restaurants
restaurant with no more than two cuisines	( call SW.listValue ( call SW.countComparative ( call SW.getProperty ( call SW.singleton en.restaurant ) ( string ! type ) ) ( string cuisine ) ( string <= ) ( number 2 ) ) )	overnight-restaurants
restaurants that accept credit cards and offer takeout	( call SW.listValue ( call SW.filter ( call SW.filter ( call SW.getProperty ( call SW.singleton en.restaurant ) ( string ! type ) ) ( string takeout ) ) ( string credit ) ) )	overnight-restaurants
cuisine that is like thai cafe or pizzeria juno	( call SW.listValue ( call SW.filter ( call SW.getProperty ( call SW.singleton en.cuisine ) ( string ! type ) ) ( call SW.reverse ( string cuisine ) ) ( string = ) ( call SW.concat en.restaurant.thai_cafe en.restaurant.pizzeria_juno ) ) )	overnight-restaurants
what restaurant doesnt have a 2 dollar sign	( call SW.listValue ( call SW.filter ( call SW.getProperty ( call SW.singleton en.restaurant ) ( string ! type ) ) ( string price_rating ) ( string ! = ) ( number 2 en.dollar_sign ) ) )	overnight-restaurants
restaurants with 2 price rating that accept credit cards	( call SW.listValue ( call SW.filter ( call SW.filter ( call SW.getProperty ( call SW.singleton en.restaurant ) ( string ! type ) ) ( string price_rating ) ( string = ) ( number 2 en.dollar_sign ) ) ( string credit ) ) )	overnight-restaurants
what neighborhoods have restaurants that deliver	( call SW.listValue ( call SW.filter ( call SW.getProperty ( call SW.singleton en.neighborhood ) ( string ! type ) ) ( call SW.reverse ( string neighborhood ) ) ( string = ) ( call SW.filter ( call SW.getProperty ( call SW.singleton en.restaurant ) ( string ! type ) ) ( string delivery ) ) ) )	overnight-restaurants
list all restaurants that have the same or better price rating than thai cafe	( call SW.listValue ( call SW.filter ( call SW.getProperty ( call SW.singleton en.restaurant ) ( string ! type ) ) ( call SW.ensureNumericProperty ( string price_rating ) ) ( string >= ) ( call SW.ensureNumericEntity ( call SW.getProperty en.restaurant.thai_cafe ( string price_rating ) ) ) ) )	overnight-restaurants
what restaurant serves a meal similar to that found at the thai cafe	( call SW.listValue ( call SW.filter ( call SW.getProperty ( call SW.singleton en.restaurant ) ( string ! type ) ) ( string meals ) ( string = ) ( call SW.filter ( call SW.getProperty ( call SW.singleton en.food ) ( string ! type ) ) ( call SW.reverse ( string meals ) ) ( string = ) en.restaurant.thai_cafe ) ) )	overnight-restaurants
what restaurant offers takeout and is good for kids	( call SW.listValue ( call SW.filter ( call SW.filter ( call SW.getProperty ( call SW.singleton en.restaurant ) ( string ! type ) ) ( string kids ) ) ( string takeout ) ) )	overnight-restaurants
what restaurants offer outdoor seating and takes reservations	( call SW.listValue ( call SW.filter ( call SW.filter ( call SW.getProperty ( call SW.singleton en.restaurant ) ( string ! type ) ) ( string reserve ) ) ( string outdoor ) ) )	overnight-restaurants
what places serve food that is not thai	( call SW.listValue ( call SW.filter ( call SW.getProperty ( call SW.singleton en.cuisine ) ( string ! type ) ) ( call SW.reverse ( string cuisine ) ) ( string ! = ) en.restaurant.thai_cafe ) )	overnight-restaurants
what cuisines are offered by restaurants that offer takeout	( call SW.listValue ( call SW.filter ( call SW.getProperty ( call SW.singleton en.cuisine ) ( string ! type ) ) ( call SW.reverse ( string cuisine ) ) ( string = ) ( call SW.filter ( call SW.getProperty ( call SW.singleton en.restaurant ) ( string ! type ) ) ( string takeout ) ) ) )	overnight-restaurants
neighborhood that is neighborhood of thai cafe	( call SW.listValue ( call SW.filter ( call SW.getProperty ( call SW.singleton en.neighborhood ) ( string ! type ) ) ( call SW.reverse ( string neighborhood ) ) ( string = ) en.restaurant.thai_cafe ) )	overnight-restaurants
restaurants in the midtown west neighborhood with outdoor seating	( call SW.listValue ( call SW.filter ( call SW.filter ( call SW.getProperty ( call SW.singleton en.restaurant ) ( string ! type ) ) ( string neighborhood ) ( string = ) en.neighborhood.midtown_west ) ( string outdoor ) ) )	overnight-restaurants
restaurant that has delivery and that takes credit cards	( call SW.listValue ( call SW.filter ( call SW.filter ( call SW.getProperty ( call SW.singleton en.restaurant ) ( string ! type ) ) ( string delivery ) ) ( string credit ) ) )	overnight-restaurants
restaurant whose cuisine is thai and that has outdoor seating	( call SW.listValue ( call SW.filter ( call SW.filter ( call SW.getProperty ( call SW.singleton en.restaurant ) ( string ! type ) ) ( string cuisine ) ( string = ) en.cuisine.thai ) ( string outdoor ) ) )	overnight-restaurants
restaurants that have at least two cuisines	( call SW.listValue ( call SW.countComparative ( call SW.getProperty ( call SW.singleton en.restaurant ) ( string ! type ) ) ( string cuisine ) ( string > ) ( number 2 ) ) )	overnight-restaurants
which restaurant is good for group dining	( call SW.listValue ( call SW.filter ( call SW.getProperty ( call SW.singleton en.cuisine ) ( string ! type ) ) ( call SW.reverse ( string cuisine ) ) ( string = ) ( call SW.filter ( call SW.getProperty ( call SW.singleton en.restaurant ) ( string ! type ) ) ( string groups ) ) ) )	overnight-restaurants
what cuisine type is most common	( call SW.listValue ( call SW.countSuperlative ( call SW.getProperty ( call SW.singleton en.food ) ( string ! type ) ) ( string max ) ( call SW.reverse ( string meals ) ) ( call SW.getProperty ( call SW.singleton en.restaurant ) ( string ! type ) ) ) )	overnight-restaurants
which restaurants are good for groups and have outdoor seating	( call SW.listValue ( call SW.filter ( call SW.filter ( call SW.getProperty ( call SW.singleton en.restaurant ) ( string ! type ) ) ( string groups ) ) ( string outdoor ) ) )	overnight-restaurants
what neighborhood is thai cafe or pizzeria juno in	( call SW.listValue ( call SW.filter ( call SW.getProperty ( call SW.singleton en.neighborhood ) ( string ! type ) ) ( call SW.reverse ( string neighborhood ) ) ( string = ) ( call SW.concat en.restaurant.thai_cafe en.restaurant.pizzeria_juno ) ) )	overnight-restaurants
what is the cuisine of the restaurant with waiter service	( call SW.listValue ( call SW.filter ( call SW.getProperty ( call SW.singleton en.cuisine ) ( string ! type ) ) ( call SW.reverse ( string cuisine ) ) ( string = ) ( call SW.filter ( call SW.getProperty ( call SW.singleton en.restaurant ) ( string ! type ) ) ( string waiter ) ) ) )	overnight-restaurants
what is a meal that the thai cafe or pizzeria juno serves	( call SW.listValue ( call SW.filter ( call SW.getProperty ( call SW.singleton en.food ) ( string ! type ) ) ( call SW.reverse ( string meals ) ) ( string = ) ( call SW.concat en.restaurant.thai_cafe en.restaurant.pizzeria_juno ) ) )	overnight-restaurants
restaurants with price ratings less than 2 dollar signs	( call SW.listValue ( call SW.filter ( call SW.getProperty ( call SW.singleton en.restaurant ) ( string ! type ) ) ( call SW.ensureNumericProperty ( string price_rating ) ) ( string < ) ( call SW.ensureNumericEntity ( call SW.concat ( number 2 en.dollar_sign ) ( number 3 en.dollar_sign ) ) ) ) )	overnight-restaurants
which restaurant offers the most variety of cuisine	( call SW.listValue ( call SW.countSuperlative ( call SW.getProperty ( call SW.singleton en.restaurant ) ( string ! type ) ) ( string max ) ( string cuisine ) ) )	overnight-restaurants
hotel which has a price rating of 2 dollar signs or 3 dollar signs	( call SW.listValue ( call SW.filter ( call SW.getProperty ( call SW.singleton en.restaurant ) ( string ! type ) ) ( string price_rating ) ( string = ) ( call SW.concat ( number 2 en.dollar_sign ) ( number 3 en.dollar_sign ) ) ) )	overnight-restaurants
which restaurants are rated the same or below thai cafe	( call SW.listValue ( call SW.filter ( call SW.getProperty ( call SW.singleton en.restaurant ) ( string ! type ) ) ( call SW.ensureNumericProperty ( string star_rating ) ) ( string <= ) ( call SW.ensureNumericEntity ( call SW.getProperty en.restaurant.thai_cafe ( string star_rating ) ) ) ) )	overnight-restaurants
a reservation thai restaurant	( call SW.listValue ( call SW.filter ( call SW.filter ( call SW.getProperty ( call SW.singleton en.restaurant ) ( string ! type ) ) ( string cuisine ) ( string = ) en.cuisine.thai ) ( string reserve ) ) )	overnight-restaurants
what is a meal served by a restaurant that accommodates groups	( call SW.listValue ( call SW.filter ( call SW.getProperty ( call SW.singleton en.food ) ( string ! type ) ) ( call SW.reverse ( string meals ) ) ( string = ) ( call SW.filter ( call SW.getProperty ( call SW.singleton en.restaurant ) ( string ! type ) ) ( string groups ) ) ) )	overnight-restaurants
what is a meal from a restaurant that is good for kids	( call SW.listValue ( call SW.filter ( call SW.getProperty ( call SW.singleton en.food ) ( string ! type ) ) ( call SW.reverse ( string meals ) ) ( string = ) ( call SW.filter ( call SW.getProperty ( call SW.singleton en.restaurant ) ( string ! type ) ) ( string kids ) ) ) )	overnight-restaurants
what restaurant serves lunch and offers takeout	( call SW.listValue ( call SW.filter ( call SW.filter ( call SW.getProperty ( call SW.singleton en.restaurant ) ( string ! type ) ) ( string meals ) ( string = ) en.food.lunch ) ( string takeout ) ) )	overnight-restaurants
a three star restaurant thats mid priced	( call SW.listValue ( call SW.filter ( call SW.filter ( call SW.getProperty ( call SW.singleton en.restaurant ) ( string ! type ) ) ( string star_rating ) ( string = ) ( number 3 en.star ) ) ( string price_rating ) ( string = ) ( number 2 en.dollar_sign ) ) )	overnight-restaurants
a thai or italian restaurant	( call SW.listValue ( call SW.filter ( call SW.getProperty ( call SW.singleton en.restaurant ) ( string ! type ) ) ( string cuisine ) ( string = ) ( call SW.concat en.cuisine.thai en.cuisine.italian ) ) )	overnight-restaurants
what neighborhood has restaurants that serve lunch	( call SW.listValue ( call SW.filter ( call SW.getProperty ( call SW.singleton en.neighborhood ) ( string ! type ) ) ( call SW.reverse ( string neighborhood ) ) ( string = ) ( call SW.filter ( call SW.getProperty ( call SW.singleton en.restaurant ) ( string ! type ) ) ( string meals ) ( string = ) en.food.lunch ) ) )	overnight-restaurants
cuisine that is cuisine of restaurant whose price rating is 2 dollar signs	( call SW.listValue ( call SW.filter ( call SW.getProperty ( call SW.singleton en.cuisine ) ( string ! type ) ) ( call SW.reverse ( string cuisine ) ) ( string = ) ( call SW.filter ( call SW.getProperty ( call SW.singleton en.restaurant ) ( string ! type ) ) ( string price_rating ) ( string = ) ( number 2 en.dollar_sign ) ) ) )	overnight-restaurants
restaurants with 5 star and lower price ratings	( call SW.listValue ( call SW.filter ( call SW.getProperty ( call SW.singleton en.restaurant ) ( string ! type ) ) ( call SW.ensureNumericProperty ( string star_rating ) ) ( string <= ) ( call SW.ensureNumericEntity ( call SW.concat ( number 3 en.star ) ( number 5 en.star ) ) ) ) )	overnight-restaurants
restaurant with lunch menu	( call SW.listValue ( call SW.filter ( call SW.getProperty ( call SW.singleton en.food ) ( string ! type ) ) ( call SW.reverse ( string meals ) ) ( string = ) ( call SW.filter ( call SW.getProperty ( call SW.singleton en.restaurant ) ( string ! type ) ) ( string meals ) ( string = ) en.food.lunch ) ) )	overnight-restaurants
the restaurant serves lunch as well as thai food	( call SW.listValue ( call SW.filter ( call SW.filter ( call SW.getProperty ( call SW.singleton en.restaurant ) ( string ! type ) ) ( string cuisine ) ( string = ) en.cuisine.thai ) ( string meals ) ( string = ) en.food.lunch ) )	overnight-restaurants
meal served by a restaurant that delivers	( call SW.listValue ( call SW.filter ( call SW.getProperty ( call SW.singleton en.food ) ( string ! type ) ) ( call SW.reverse ( string meals ) ) ( string = ) ( call SW.filter ( call SW.getProperty ( call SW.singleton en.restaurant ) ( string ! type ) ) ( string delivery ) ) ) )	overnight-restaurants
restaurants that have waiters and are good for groups	( call SW.listValue ( call SW.filter ( call SW.filter ( call SW.getProperty ( call SW.singleton en.restaurant ) ( string ! type ) ) ( string waiter ) ) ( string groups ) ) )	overnight-restaurants
a reservation restaurant that is kid friendly	( call SW.listValue ( call SW.filter ( call SW.filter ( call SW.getProperty ( call SW.singleton en.restaurant ) ( string ! type ) ) ( string reserve ) ) ( string kids ) ) )	overnight-restaurants
which restaurants serve at least two meals	( call SW.listValue ( call SW.countComparative ( call SW.getProperty ( call SW.singleton en.restaurant ) ( string ! type ) ) ( string meals ) ( string >= ) ( number 2 ) ( call SW.getProperty ( call SW.singleton en.food ) ( string ! type ) ) ) )	overnight-restaurants
restaurants that offer takeout and accept reservations	( call SW.listValue ( call SW.filter ( call SW.filter ( call SW.getProperty ( call SW.singleton en.restaurant ) ( string ! type ) ) ( string reserve ) ) ( string takeout ) ) )	overnight-restaurants
restaurants that are in the neighborhood of midtown west	( call SW.listValue ( call SW.filter ( call SW.getProperty ( call SW.singleton en.neighborhood ) ( string ! type ) ) ( call SW.reverse ( string neighborhood ) ) ( string = ) ( call SW.filter ( call SW.getProperty ( call SW.singleton en.restaurant ) ( string ! type ) ) ( string neighborhood ) ( string = ) en.neighborhood.midtown_west ) ) )	overnight-restaurants
restaurants that has a larger price rating than thai cafe	( call SW.listValue ( call SW.filter ( call SW.getProperty ( call SW.singleton en.restaurant ) ( string ! type ) ) ( call SW.ensureNumericProperty ( string price_rating ) ) ( string > ) ( call SW.ensureNumericEntity ( call SW.getProperty en.restaurant.thai_cafe ( string price_rating ) ) ) ) )	overnight-restaurants
list all restaurants that have a price rating of 2 dollar signs or 3 dollar signs	( call SW.listValue ( call SW.filter ( call SW.getProperty ( call SW.singleton en.restaurant ) ( string ! type ) ) ( string price_rating ) ( string = ) ( call SW.concat ( number 2 en.dollar_sign ) ( number 3 en.dollar_sign ) ) ) )	overnight-restaurants
restaurants location	( call SW.listValue ( call SW.countComparative ( call SW.getProperty ( call SW.singleton en.restaurant ) ( string ! type ) ) ( string neighborhood ) ( string > ) ( number 2 ) ) )	overnight-restaurants
what 2 dollar sign restaurant takes credit card	( call SW.listValue ( call SW.filter ( call SW.filter ( call SW.getProperty ( call SW.singleton en.restaurant ) ( string ! type ) ) ( string price_rating ) ( string = ) ( number 2 en.dollar_sign ) ) ( string credit ) ) )	overnight-restaurants
a delivery restaurant with medium pricing	( call SW.listValue ( call SW.filter ( call SW.filter ( call SW.getProperty ( call SW.singleton en.restaurant ) ( string ! type ) ) ( string price_rating ) ( string = ) ( number 2 en.dollar_sign ) ) ( string delivery ) ) )	overnight-restaurants
what is a meal that the thai cafe does not serve	( call SW.listValue ( call SW.filter ( call SW.getProperty ( call SW.singleton en.food ) ( string ! type ) ) ( call SW.reverse ( string meals ) ) ( string ! = ) en.restaurant.thai_cafe ) )	overnight-restaurants
what 3 star restaurant offers lunch	( call SW.listValue ( call SW.filter ( call SW.filter ( call SW.getProperty ( call SW.singleton en.restaurant ) ( string ! type ) ) ( string star_rating ) ( string = ) ( number 3 en.star ) ) ( string meals ) ( string = ) en.food.lunch ) )	overnight-restaurants
restaurant that is around mid town west that offers lunch	( call SW.listValue ( call SW.filter ( call SW.filter ( call SW.getProperty ( call SW.singleton en.restaurant ) ( string ! type ) ) ( string neighborhood ) ( string = ) en.neighborhood.midtown_west ) ( string meals ) ( string = ) en.food.lunch ) )	overnight-restaurants
restaurants where you can sit outside	( call SW.listValue ( call SW.filter ( call SW.getProperty ( call SW.singleton en.restaurant ) ( string ! type ) ) ( string outdoor ) ) )	overnight-restaurants
what restaurant has less than a 2 dollar price rating	( call SW.listValue ( call SW.filter ( call SW.getProperty ( call SW.singleton en.restaurant ) ( string ! type ) ) ( call SW.ensureNumericProperty ( string price_rating ) ) ( string < ) ( call SW.ensureNumericEntity ( number 2 en.dollar_sign ) ) ) )	overnight-restaurants
what is a meal served by a restaurant that accepts credit cards	( call SW.listValue ( call SW.filter ( call SW.getProperty ( call SW.singleton en.food ) ( string ! type ) ) ( call SW.reverse ( string meals ) ) ( string = ) ( call SW.filter ( call SW.getProperty ( call SW.singleton en.restaurant ) ( string ! type ) ) ( string credit ) ) ) )	overnight-restaurants
restaurants that have waiters and are good for kids	( call SW.listValue ( call SW.filter ( call SW.filter ( call SW.getProperty ( call SW.singleton en.restaurant ) ( string ! type ) ) ( string waiter ) ) ( string kids ) ) )	overnight-restaurants
what kind of cuisine is thai cafe	( call SW.listValue ( call SW.getProperty en.restaurant.thai_cafe ( string cuisine ) ) )	overnight-restaurants
restaurant that has delivery and that has outdoor seating	( call SW.listValue ( call SW.filter ( call SW.filter ( call SW.getProperty ( call SW.singleton en.restaurant ) ( string ! type ) ) ( string delivery ) ) ( string outdoor ) ) )	overnight-restaurants
what restaurant in midtown west has a rating of two dollar signs	( call SW.listValue ( call SW.filter ( call SW.filter ( call SW.getProperty ( call SW.singleton en.restaurant ) ( string ! type ) ) ( string neighborhood ) ( string = ) en.neighborhood.midtown_west ) ( string price_rating ) ( string = ) ( number 2 en.dollar_sign ) ) )	overnight-restaurants
what is the neighborhood with the most restaurants that are good for kids	( call SW.listValue ( call SW.filter ( call SW.getProperty ( call SW.singleton en.neighborhood ) ( string ! type ) ) ( call SW.reverse ( string neighborhood ) ) ( string = ) ( call SW.filter ( call SW.getProperty ( call SW.singleton en.restaurant ) ( string ! type ) ) ( string kids ) ) ) )	overnight-restaurants
what 3 star restaurant is good for kids	( call SW.listValue ( call SW.filter ( call SW.filter ( call SW.getProperty ( call SW.singleton en.restaurant ) ( string ! type ) ) ( string kids ) ) ( string star_rating ) ( string = ) ( number 3 en.star ) ) )	overnight-restaurants
which restaurants are in the price rating level of two dollar signs	( call SW.listValue ( call SW.filter ( call SW.getProperty ( call SW.singleton en.restaurant ) ( string ! type ) ) ( string price_rating ) ( string = ) ( number 2 en.dollar_sign ) ) )	overnight-restaurants
what is the nature of the cuisine of thai cafe	( call SW.listValue ( call SW.getProperty en.restaurant.thai_cafe ( string cuisine ) ) )	overnight-restaurants
restaurants with similar food to thai cafe or pizzeria juno	( call SW.listValue ( call SW.filter ( call SW.getProperty ( call SW.singleton en.cuisine ) ( string ! type ) ) ( call SW.reverse ( string cuisine ) ) ( string = ) ( call SW.concat en.restaurant.thai_cafe en.restaurant.pizzeria_juno ) ) )	overnight-restaurants
which cuisines match that of the thai cafe	( call SW.listValue ( call SW.filter ( call SW.filter ( call SW.getProperty ( call SW.singleton en.cuisine ) ( string ! type ) ) ( call SW.reverse ( string cuisine ) ) ( string = ) en.restaurant.thai_cafe ) ( call SW.reverse ( string cuisine ) ) ( string = ) en.restaurant.thai_cafe ) )	overnight-restaurants
what is the price rating of thai cafe	( call SW.listValue ( call SW.getProperty en.restaurant.thai_cafe ( string price_rating ) ) )	overnight-restaurants
what restaurant is in the least number of neighborhoods	( call SW.listValue ( call SW.countSuperlative ( call SW.getProperty ( call SW.singleton en.restaurant ) ( string ! type ) ) ( string min ) ( string neighborhood ) ) )	overnight-restaurants
what restaurants have outdoor seating that take credit cards	( call SW.listValue ( call SW.filter ( call SW.filter ( call SW.getProperty ( call SW.singleton en.restaurant ) ( string ! type ) ) ( string credit ) ) ( string outdoor ) ) )	overnight-restaurants
what restaurant offers reservations and serves lunch	( call SW.listValue ( call SW.filter ( call SW.filter ( call SW.getProperty ( call SW.singleton en.restaurant ) ( string ! type ) ) ( string meals ) ( string = ) en.food.lunch ) ( string reserve ) ) )	overnight-restaurants
what good kids restaurant is in the midtown west area	( call SW.listValue ( call SW.filter ( call SW.filter ( call SW.getProperty ( call SW.singleton en.restaurant ) ( string ! type ) ) ( string kids ) ) ( string neighborhood ) ( string = ) en.neighborhood.midtown_west ) )	overnight-restaurants
a three star restaurant that serves lunch	( call SW.listValue ( call SW.filter ( call SW.filter ( call SW.getProperty ( call SW.singleton en.restaurant ) ( string ! type ) ) ( string meals ) ( string = ) en.food.lunch ) ( string star_rating ) ( string = ) ( number 3 en.star ) ) )	overnight-restaurants
which restaurants have price ratings above or below two dollar signs	( call SW.listValue ( call SW.filter ( call SW.getProperty ( call SW.singleton en.restaurant ) ( string ! type ) ) ( string price_rating ) ( string ! = ) ( number 2 en.dollar_sign ) ) )	overnight-restaurants
restaurants that can be booked in advance	( call SW.listValue ( call SW.filter ( call SW.getProperty ( call SW.singleton en.cuisine ) ( string ! type ) ) ( call SW.reverse ( string cuisine ) ) ( string = ) ( call SW.filter ( call SW.getProperty ( call SW.singleton en.restaurant ) ( string ! type ) ) ( string reserve ) ) ) )	overnight-restaurants
thai restaurants rated 2 dollar signs	( call SW.listValue ( call SW.filter ( call SW.filter ( call SW.getProperty ( call SW.singleton en.restaurant ) ( string ! type ) ) ( string price_rating ) ( string = ) ( number 2 en.dollar_sign ) ) ( string cuisine ) ( string = ) en.cuisine.thai ) )	overnight-restaurants
a restaurant rated 2 dollar signs for lunch	( call SW.listValue ( call SW.filter ( call SW.filter ( call SW.getProperty ( call SW.singleton en.restaurant ) ( string ! type ) ) ( string price_rating ) ( string = ) ( number 2 en.dollar_sign ) ) ( string meals ) ( string = ) en.food.lunch ) )	overnight-restaurants
which restaurants take reservations and accept credit cards	( call SW.listValue ( call SW.filter ( call SW.filter ( call SW.getProperty ( call SW.singleton en.restaurant ) ( string ! type ) ) ( string reserve ) ) ( string credit ) ) )	overnight-restaurants
restaurants rated 3 stars in midtown west	( call SW.listValue ( call SW.filter ( call SW.filter ( call SW.getProperty ( call SW.singleton en.restaurant ) ( string ! type ) ) ( string neighborhood ) ( string = ) en.neighborhood.midtown_west ) ( string star_rating ) ( string = ) ( number 3 en.star ) ) )	overnight-restaurants
what thai restaurants offer a waiter service	( call SW.listValue ( call SW.filter ( call SW.filter ( call SW.getProperty ( call SW.singleton en.restaurant ) ( string ! type ) ) ( string waiter ) ) ( string cuisine ) ( string = ) en.cuisine.thai ) )	overnight-restaurants
restaurant that is good for groups and that has delivery	( call SW.listValue ( call SW.filter ( call SW.filter ( call SW.getProperty ( call SW.singleton en.restaurant ) ( string ! type ) ) ( string groups ) ) ( string delivery ) ) )	overnight-restaurants
what is the eighborhood  of the takeout restaurant	( call SW.listValue ( call SW.filter ( call SW.getProperty ( call SW.singleton en.neighborhood ) ( string ! type ) ) ( call SW.reverse ( string neighborhood ) ) ( string = ) ( call SW.filter ( call SW.getProperty ( call SW.singleton en.restaurant ) ( string ! type ) ) ( string takeout ) ) ) )	overnight-restaurants
what neighborhood are the restaurants that are in midtown west	( call SW.listValue ( call SW.filter ( call SW.getProperty ( call SW.singleton en.neighborhood ) ( string ! type ) ) ( call SW.reverse ( string neighborhood ) ) ( string = ) ( call SW.filter ( call SW.getProperty ( call SW.singleton en.restaurant ) ( string ! type ) ) ( string neighborhood ) ( string = ) en.neighborhood.midtown_west ) ) )	overnight-restaurants
which restaurant s cuisine has 3 star rating	( call SW.listValue ( call SW.filter ( call SW.getProperty ( call SW.singleton en.cuisine ) ( string ! type ) ) ( call SW.reverse ( string cuisine ) ) ( string = ) ( call SW.filter ( call SW.getProperty ( call SW.singleton en.restaurant ) ( string ! type ) ) ( string star_rating ) ( string = ) ( number 3 en.star ) ) ) )	overnight-restaurants
list all restaurants that are at least 3 stars	( call SW.listValue ( call SW.filter ( call SW.getProperty ( call SW.singleton en.restaurant ) ( string ! type ) ) ( call SW.ensureNumericProperty ( string star_rating ) ) ( string <= ) ( call SW.ensureNumericEntity ( number 3 en.star ) ) ) )	overnight-restaurants
restaurant in midtown west that is good for groups	( call SW.listValue ( call SW.filter ( call SW.filter ( call SW.getProperty ( call SW.singleton en.restaurant ) ( string ! type ) ) ( string groups ) ) ( string neighborhood ) ( string = ) en.neighborhood.midtown_west ) )	overnight-restaurants
restaurant whose price rating is 2 dollar signs and whose star rating is 3 stars	( call SW.listValue ( call SW.filter ( call SW.filter ( call SW.getProperty ( call SW.singleton en.restaurant ) ( string ! type ) ) ( string price_rating ) ( string = ) ( number 2 en.dollar_sign ) ) ( string star_rating ) ( string = ) ( number 3 en.star ) ) )	overnight-restaurants
what midtown west restaurant takes credit cards	( call SW.listValue ( call SW.filter ( call SW.filter ( call SW.getProperty ( call SW.singleton en.restaurant ) ( string ! type ) ) ( string neighborhood ) ( string = ) en.neighborhood.midtown_west ) ( string credit ) ) )	overnight-restaurants
neighborhood of thai cafe	( call SW.listValue ( call SW.getProperty en.restaurant.thai_cafe ( string neighborhood ) ) )	overnight-restaurants
name a hotel which has a three star rating and good for group dining	( call SW.listValue ( call SW.filter ( call SW.filter ( call SW.getProperty ( call SW.singleton en.restaurant ) ( string ! type ) ) ( string star_rating ) ( string = ) ( number 3 en.star ) ) ( string groups ) ) )	overnight-restaurants
what restaurant is kid friendly and takes reservations	( call SW.listValue ( call SW.filter ( call SW.filter ( call SW.getProperty ( call SW.singleton en.restaurant ) ( string ! type ) ) ( string kids ) ) ( string reserve ) ) )	overnight-restaurants
cuisine in at least 2 restaurants	( call SW.listValue ( call SW.countComparative ( call SW.getProperty ( call SW.singleton en.cuisine ) ( string ! type ) ) ( call SW.reverse ( string cuisine ) ) ( string > ) ( number 2 ) ( call SW.getProperty ( call SW.singleton en.restaurant ) ( string ! type ) ) ) )	overnight-restaurants
restaurants that serve the same type of food as thai cafe	( call SW.listValue ( call SW.filter ( call SW.getProperty ( call SW.singleton en.restaurant ) ( string ! type ) ) ( string cuisine ) ( string = ) ( call SW.filter ( call SW.getProperty ( call SW.singleton en.cuisine ) ( string ! type ) ) ( call SW.reverse ( string cuisine ) ) ( string = ) en.restaurant.thai_cafe ) ) )	overnight-restaurants
thai restaurant with waiters	( call SW.listValue ( call SW.filter ( call SW.filter ( call SW.getProperty ( call SW.singleton en.restaurant ) ( string ! type ) ) ( string cuisine ) ( string = ) en.cuisine.thai ) ( string waiter ) ) )	overnight-restaurants
what is the cuisine of restaurants that have waiters	( call SW.listValue ( call SW.filter ( call SW.getProperty ( call SW.singleton en.cuisine ) ( string ! type ) ) ( call SW.reverse ( string cuisine ) ) ( string = ) ( call SW.filter ( call SW.getProperty ( call SW.singleton en.restaurant ) ( string ! type ) ) ( string waiter ) ) ) )	overnight-restaurants
list all restaurants that have takeout and delivery	( call SW.listValue ( call SW.filter ( call SW.filter ( call SW.getProperty ( call SW.singleton en.restaurant ) ( string ! type ) ) ( string takeout ) ) ( string delivery ) ) )	overnight-restaurants
which neighborhoods is thai cafe not in	( call SW.listValue ( call SW.filter ( call SW.getProperty ( call SW.singleton en.neighborhood ) ( string ! type ) ) ( call SW.reverse ( string neighborhood ) ) ( string ! = ) en.restaurant.thai_cafe ) )	overnight-restaurants
thai cafe with least price rating	( call SW.listValue ( call SW.filter ( call SW.getProperty ( call SW.singleton en.restaurant ) ( string ! type ) ) ( call SW.ensureNumericProperty ( string price_rating ) ) ( string >= ) ( call SW.ensureNumericEntity ( call SW.getProperty en.restaurant.thai_cafe ( string price_rating ) ) ) ) )	overnight-restaurants
which restaurant has waiter and takeout service	( call SW.listValue ( call SW.filter ( call SW.filter ( call SW.getProperty ( call SW.singleton en.restaurant ) ( string ! type ) ) ( string takeout ) ) ( string waiter ) ) )	overnight-restaurants
restaurants in midtown west with outdoor dining areas	( call SW.listValue ( call SW.filter ( call SW.filter ( call SW.getProperty ( call SW.singleton en.restaurant ) ( string ! type ) ) ( string outdoor ) ) ( string neighborhood ) ( string = ) en.neighborhood.midtown_west ) )	overnight-restaurants
restaurants with 2 stars or less	( call SW.listValue ( call SW.filter ( call SW.getProperty ( call SW.singleton en.restaurant ) ( string ! type ) ) ( call SW.ensureNumericProperty ( string star_rating ) ) ( string < ) ( call SW.ensureNumericEntity ( number 3 en.star ) ) ) )	overnight-restaurants
what restaurants have a price rating of two dollar signs and also accept credit cards	( call SW.listValue ( call SW.filter ( call SW.filter ( call SW.getProperty ( call SW.singleton en.restaurant ) ( string ! type ) ) ( string price_rating ) ( string = ) ( number 2 en.dollar_sign ) ) ( string credit ) ) )	overnight-restaurants
hotel that can be booked in advance which has a price rating of 2 dollar signs	( call SW.listValue ( call SW.filter ( call SW.filter ( call SW.getProperty ( call SW.singleton en.restaurant ) ( string ! type ) ) ( string reserve ) ) ( string price_rating ) ( string = ) ( number 2 en.dollar_sign ) ) )	overnight-restaurants
restaurants that offer credit cards and takeout	( call SW.listValue ( call SW.filter ( call SW.filter ( call SW.getProperty ( call SW.singleton en.restaurant ) ( string ! type ) ) ( string credit ) ) ( string takeout ) ) )	overnight-restaurants
what restaurant offers outdoor seating and takeout	( call SW.listValue ( call SW.filter ( call SW.filter ( call SW.getProperty ( call SW.singleton en.restaurant ) ( string ! type ) ) ( string takeout ) ) ( string outdoor ) ) )	overnight-restaurants
what 2 dollar signs restaurant takes reservations	( call SW.listValue ( call SW.filter ( call SW.filter ( call SW.getProperty ( call SW.singleton en.restaurant ) ( string ! type ) ) ( string reserve ) ) ( string price_rating ) ( string = ) ( number 2 en.dollar_sign ) ) )	overnight-restaurants
restaurants in the midtown west neighborhood that have a 2 dollar sign price rating	( call SW.listValue ( call SW.filter ( call SW.filter ( call SW.getProperty ( call SW.singleton en.restaurant ) ( string ! type ) ) ( string neighborhood ) ( string = ) en.neighborhood.midtown_west ) ( string price_rating ) ( string = ) ( number 2 en.dollar_sign ) ) )	overnight-restaurants
restaurants that are good for children	( call SW.listValue ( call SW.filter ( call SW.filter ( call SW.getProperty ( call SW.singleton en.restaurant ) ( string ! type ) ) ( string kids ) ) ( string kids ) ) )	overnight-restaurants
neighborhood that is neighborhood of the most number of restaurant	( call SW.listValue ( call SW.countSuperlative ( call SW.getProperty ( call SW.singleton en.neighborhood ) ( string ! type ) ) ( string max ) ( call SW.reverse ( string neighborhood ) ) ( call SW.getProperty ( call SW.singleton en.restaurant ) ( string ! type ) ) ) )	overnight-restaurants
restaurants that have outdoor seating	( call SW.listValue ( call SW.filter ( call SW.getProperty ( call SW.singleton en.food ) ( string ! type ) ) ( call SW.reverse ( string meals ) ) ( string = ) ( call SW.filter ( call SW.getProperty ( call SW.singleton en.restaurant ) ( string ! type ) ) ( string outdoor ) ) ) )	overnight-restaurants
which hotel is entertaining for kids	( call SW.listValue ( call SW.filter ( call SW.getProperty ( call SW.singleton en.restaurant ) ( string ! type ) ) ( string kids ) ) )	overnight-restaurants
what neighborhoods have restaurants that accept reservations	( call SW.listValue ( call SW.filter ( call SW.getProperty ( call SW.singleton en.neighborhood ) ( string ! type ) ) ( call SW.reverse ( string neighborhood ) ) ( string = ) ( call SW.filter ( call SW.getProperty ( call SW.singleton en.restaurant ) ( string ! type ) ) ( string reserve ) ) ) )	overnight-restaurants
family friendly restaurants with price rating of two	( call SW.listValue ( call SW.filter ( call SW.filter ( call SW.getProperty ( call SW.singleton en.restaurant ) ( string ! type ) ) ( string price_rating ) ( string = ) ( number 2 en.dollar_sign ) ) ( string kids ) ) )	overnight-restaurants
what are the types of cuisine available in the midtown west neighborhood	( call SW.listValue ( call SW.filter ( call SW.getProperty ( call SW.singleton en.cuisine ) ( string ! type ) ) ( call SW.reverse ( string cuisine ) ) ( string = ) ( call SW.filter ( call SW.getProperty ( call SW.singleton en.restaurant ) ( string ! type ) ) ( string neighborhood ) ( string = ) en.neighborhood.midtown_west ) ) )	overnight-restaurants
restaurant that serves lunch	( call SW.listValue ( call SW.filter ( call SW.getProperty ( call SW.singleton en.restaurant ) ( string ! type ) ) ( string meals ) ( string = ) en.food.lunch ) )	overnight-restaurants
what kind of meals are served by restaurants that take reservations	( call SW.listValue ( call SW.filter ( call SW.getProperty ( call SW.singleton en.food ) ( string ! type ) ) ( call SW.reverse ( string meals ) ) ( string = ) ( call SW.filter ( call SW.getProperty ( call SW.singleton en.restaurant ) ( string ! type ) ) ( string reserve ) ) ) )	overnight-restaurants
restaurant whose price rating is smaller than 2 dollar signs	( call SW.listValue ( call SW.filter ( call SW.getProperty ( call SW.singleton en.restaurant ) ( string ! type ) ) ( call SW.ensureNumericProperty ( string price_rating ) ) ( string < ) ( call SW.ensureNumericEntity ( number 2 en.dollar_sign ) ) ) )	overnight-restaurants
hotel in midtown west that can be booked in advance	( call SW.listValue ( call SW.filter ( call SW.filter ( call SW.getProperty ( call SW.singleton en.restaurant ) ( string ! type ) ) ( string reserve ) ) ( string neighborhood ) ( string = ) en.neighborhood.midtown_west ) )	overnight-restaurants
restaurant whose cuisine is thai and whose cuisine is thai	( call SW.listValue ( call SW.filter ( call SW.filter ( call SW.getProperty ( call SW.singleton en.restaurant ) ( string ! type ) ) ( string cuisine ) ( string = ) en.cuisine.thai ) ( string cuisine ) ( string = ) en.cuisine.thai ) )	overnight-restaurants
restaurant that serves lunch and whose star rating is 3 stars	( call SW.listValue ( call SW.filter ( call SW.filter ( call SW.getProperty ( call SW.singleton en.restaurant ) ( string ! type ) ) ( string meals ) ( string = ) en.food.lunch ) ( string star_rating ) ( string = ) ( number 3 en.star ) ) )	overnight-restaurants
which 3star restaurant has takeout service	( call SW.listValue ( call SW.filter ( call SW.filter ( call SW.getProperty ( call SW.singleton en.restaurant ) ( string ! type ) ) ( string star_rating ) ( string = ) ( number 3 en.star ) ) ( string takeout ) ) )	overnight-restaurants
which restaurant accepts credit cards	( call SW.listValue ( call SW.filter ( call SW.filter ( call SW.getProperty ( call SW.singleton en.restaurant ) ( string ! type ) ) ( string credit ) ) ( string credit ) ) )	overnight-restaurants
restaurants for two	( call SW.listValue ( call SW.countComparative ( call SW.getProperty ( call SW.singleton en.restaurant ) ( string ! type ) ) ( string meals ) ( string = ) ( number 2 ) ( call SW.getProperty ( call SW.singleton en.food ) ( string ! type ) ) ) )	overnight-restaurants
restaurant that has delivery and that is good for groups	( call SW.listValue ( call SW.filter ( call SW.filter ( call SW.getProperty ( call SW.singleton en.restaurant ) ( string ! type ) ) ( string delivery ) ) ( string groups ) ) )	overnight-restaurants
restaurants that are good for groups and offer takeout	( call SW.listValue ( call SW.filter ( call SW.filter ( call SW.getProperty ( call SW.singleton en.restaurant ) ( string ! type ) ) ( string takeout ) ) ( string groups ) ) )	overnight-restaurants
restaurants with waiter service and outdoor seating	( call SW.listValue ( call SW.filter ( call SW.filter ( call SW.getProperty ( call SW.singleton en.restaurant ) ( string ! type ) ) ( string waiter ) ) ( string outdoor ) ) )	overnight-restaurants
which restaurant is good for a group and also has waiters	( call SW.listValue ( call SW.filter ( call SW.filter ( call SW.getProperty ( call SW.singleton en.restaurant ) ( string ! type ) ) ( string groups ) ) ( string waiter ) ) )	overnight-restaurants
what are some restaurants rated 2 dollar signs or more	( call SW.listValue ( call SW.filter ( call SW.getProperty ( call SW.singleton en.restaurant ) ( string ! type ) ) ( call SW.ensureNumericProperty ( string price_rating ) ) ( string >= ) ( call SW.ensureNumericEntity ( number 2 en.dollar_sign ) ) ) )	overnight-restaurants
find a good kids restaurant that serves lunch	( call SW.listValue ( call SW.filter ( call SW.filter ( call SW.getProperty ( call SW.singleton en.restaurant ) ( string ! type ) ) ( string meals ) ( string = ) en.food.lunch ) ( string kids ) ) )	overnight-restaurants
restaurant whose price rating is 2 dollar signs or 3 dollar signs	( call SW.listValue ( call SW.filter ( call SW.getProperty ( call SW.singleton en.restaurant ) ( string ! type ) ) ( string price_rating ) ( string = ) ( call SW.concat ( number 2 en.dollar_sign ) ( number 3 en.dollar_sign ) ) ) )	overnight-restaurants
a group friendly restaurant that is medium priced	( call SW.listValue ( call SW.filter ( call SW.filter ( call SW.getProperty ( call SW.singleton en.restaurant ) ( string ! type ) ) ( string price_rating ) ( string = ) ( number 2 en.dollar_sign ) ) ( string groups ) ) )	overnight-restaurants
restaurants with similar food to thai cafe	( call SW.listValue ( call SW.getProperty en.restaurant.thai_cafe ( string cuisine ) ) )	overnight-restaurants
hotel which has a 3 star rating	( call SW.listValue ( call SW.filter ( call SW.getProperty ( call SW.singleton en.restaurant ) ( string ! type ) ) ( string star_rating ) ( string = ) ( number 3 en.star ) ) )	overnight-restaurants
list all restaurants offering takeout	( call SW.listValue ( call SW.filter ( call SW.getProperty ( call SW.singleton en.restaurant ) ( string ! type ) ) ( string takeout ) ) )	overnight-restaurants
what is the price rating of the thai cafe	( call SW.listValue ( call SW.getProperty en.restaurant.thai_cafe ( string price_rating ) ) )	overnight-restaurants
restaurant in the area of midtown west that is good for group dining	( call SW.listValue ( call SW.filter ( call SW.filter ( call SW.getProperty ( call SW.singleton en.restaurant ) ( string ! type ) ) ( string neighborhood ) ( string = ) en.neighborhood.midtown_west ) ( string groups ) ) )	overnight-restaurants
neighbourhood restaurant that offers outdoor seating facilities	( call SW.listValue ( call SW.filter ( call SW.getProperty ( call SW.singleton en.neighborhood ) ( string ! type ) ) ( call SW.reverse ( string neighborhood ) ) ( string = ) ( call SW.filter ( call SW.getProperty ( call SW.singleton en.restaurant ) ( string ! type ) ) ( string outdoor ) ) ) )	overnight-restaurants
restaurant with outdoor dining area that serves lunch	( call SW.listValue ( call SW.filter ( call SW.filter ( call SW.getProperty ( call SW.singleton en.restaurant ) ( string ! type ) ) ( string meals ) ( string = ) en.food.lunch ) ( string outdoor ) ) )	overnight-restaurants
what restaurant offers outdoor seating and delivery	( call SW.listValue ( call SW.filter ( call SW.filter ( call SW.getProperty ( call SW.singleton en.restaurant ) ( string ! type ) ) ( string delivery ) ) ( string outdoor ) ) )	overnight-restaurants
what 3 star restaurants deliver	( call SW.listValue ( call SW.filter ( call SW.filter ( call SW.getProperty ( call SW.singleton en.restaurant ) ( string ! type ) ) ( string star_rating ) ( string = ) ( number 3 en.star ) ) ( string delivery ) ) )	overnight-restaurants
restaurant that serves unique meals	( call SW.listValue ( call SW.countComparative ( call SW.getProperty ( call SW.singleton en.food ) ( string ! type ) ) ( call SW.reverse ( string meals ) ) ( string < ) ( number 2 ) ( call SW.getProperty ( call SW.singleton en.restaurant ) ( string ! type ) ) ) )	overnight-restaurants
restaurants that accept credit cards	( call SW.listValue ( call SW.filter ( call SW.getProperty ( call SW.singleton en.restaurant ) ( string ! type ) ) ( string credit ) ) )	overnight-restaurants
restaurants that can be booked in advance and accepts credit cards	( call SW.listValue ( call SW.filter ( call SW.filter ( call SW.getProperty ( call SW.singleton en.restaurant ) ( string ! type ) ) ( string reserve ) ) ( string credit ) ) )	overnight-restaurants
restaurant that has outdoor seating	( call SW.listValue ( call SW.filter ( call SW.getProperty ( call SW.singleton en.food ) ( string ! type ) ) ( call SW.reverse ( string meals ) ) ( string = ) ( call SW.filter ( call SW.getProperty ( call SW.singleton en.restaurant ) ( string ! type ) ) ( string outdoor ) ) ) )	overnight-restaurants
which thai restaurants take credit cards	( call SW.listValue ( call SW.filter ( call SW.filter ( call SW.getProperty ( call SW.singleton en.restaurant ) ( string ! type ) ) ( string cuisine ) ( string = ) en.cuisine.thai ) ( string credit ) ) )	overnight-restaurants
restaurants rated 3 stars	( call SW.listValue ( call SW.filter ( call SW.getProperty ( call SW.singleton en.restaurant ) ( string ! type ) ) ( string star_rating ) ( string = ) ( number 3 en.star ) ) )	overnight-restaurants
a midtown west resturant that takes reservations	( call SW.listValue ( call SW.filter ( call SW.filter ( call SW.getProperty ( call SW.singleton en.restaurant ) ( string ! type ) ) ( string reserve ) ) ( string neighborhood ) ( string = ) en.neighborhood.midtown_west ) )	overnight-restaurants
restaurants that accept credit cards and have waiters	( call SW.listValue ( call SW.filter ( call SW.filter ( call SW.getProperty ( call SW.singleton en.restaurant ) ( string ! type ) ) ( string waiter ) ) ( string credit ) ) )	overnight-restaurants
hotel which has a price rating of more than 2dollar or 3 dollar signs	( call SW.listValue ( call SW.filter ( call SW.getProperty ( call SW.singleton en.restaurant ) ( string ! type ) ) ( call SW.ensureNumericProperty ( string price_rating ) ) ( string > ) ( call SW.ensureNumericEntity ( call SW.concat ( number 2 en.dollar_sign ) ( number 3 en.dollar_sign ) ) ) ) )	overnight-restaurants
neighborhood that is neighborhood of restaurant that is good for groups	( call SW.listValue ( call SW.filter ( call SW.getProperty ( call SW.singleton en.neighborhood ) ( string ! type ) ) ( call SW.reverse ( string neighborhood ) ) ( string = ) ( call SW.filter ( call SW.getProperty ( call SW.singleton en.restaurant ) ( string ! type ) ) ( string groups ) ) ) )	overnight-restaurants
cuisine that is cuisine of restaurant whose cuisine is thai	( call SW.listValue ( call SW.filter ( call SW.getProperty ( call SW.singleton en.cuisine ) ( string ! type ) ) ( call SW.reverse ( string cuisine ) ) ( string = ) ( call SW.filter ( call SW.getProperty ( call SW.singleton en.restaurant ) ( string ! type ) ) ( string cuisine ) ( string = ) en.cuisine.thai ) ) )	overnight-restaurants
what neighborhood is the thai cafe in	( call SW.listValue ( call SW.filter ( call SW.getProperty ( call SW.singleton en.neighborhood ) ( string ! type ) ) ( call SW.reverse ( string neighborhood ) ) ( string = ) en.restaurant.thai_cafe ) )	overnight-restaurants
restaurants rated less than 3 stars	( call SW.listValue ( call SW.filter ( call SW.getProperty ( call SW.singleton en.restaurant ) ( string ! type ) ) ( call SW.ensureNumericProperty ( string star_rating ) ) ( string < ) ( call SW.ensureNumericEntity ( number 3 en.star ) ) ) )	overnight-restaurants
what restaurant offers lunch and delivery	( call SW.listValue ( call SW.filter ( call SW.filter ( call SW.getProperty ( call SW.singleton en.restaurant ) ( string ! type ) ) ( string meals ) ( string = ) en.food.lunch ) ( string delivery ) ) )	overnight-restaurants
what restaurants serve the same cuisine as thai cafe	( call SW.listValue ( call SW.filter ( call SW.getProperty ( call SW.singleton en.restaurant ) ( string ! type ) ) ( string cuisine ) ( string = ) ( call SW.filter ( call SW.getProperty ( call SW.singleton en.cuisine ) ( string ! type ) ) ( call SW.reverse ( string cuisine ) ) ( string = ) en.restaurant.thai_cafe ) ) )	overnight-restaurants
what restaurant offers outdoor seating and takes reservations	( call SW.listValue ( call SW.filter ( call SW.filter ( call SW.getProperty ( call SW.singleton en.restaurant ) ( string ! type ) ) ( string outdoor ) ) ( string reserve ) ) )	overnight-restaurants
what neighborhoods have kidfriendly restaurants	( call SW.listValue ( call SW.filter ( call SW.getProperty ( call SW.singleton en.neighborhood ) ( string ! type ) ) ( call SW.reverse ( string neighborhood ) ) ( string = ) ( call SW.filter ( call SW.getProperty ( call SW.singleton en.restaurant ) ( string ! type ) ) ( string kids ) ) ) )	overnight-restaurants
what restaurant has delivery	( call SW.listValue ( call SW.filter ( call SW.filter ( call SW.getProperty ( call SW.singleton en.restaurant ) ( string ! type ) ) ( string delivery ) ) ( string delivery ) ) )	overnight-restaurants
what is the price rating	( call SW.listValue ( call SW.aggregate ( string sum ) ( call SW.getProperty ( call SW.getProperty ( call SW.singleton en.restaurant ) ( string ! type ) ) ( string price_rating ) ) ) )	overnight-restaurants
restaurant that is good for kids and that takes reservations	( call SW.listValue ( call SW.filter ( call SW.filter ( call SW.getProperty ( call SW.singleton en.restaurant ) ( string ! type ) ) ( string kids ) ) ( string reserve ) ) )	overnight-restaurants
restaurant that has outdoor seating and that has outdoor seating	( call SW.listValue ( call SW.filter ( call SW.filter ( call SW.getProperty ( call SW.singleton en.restaurant ) ( string ! type ) ) ( string outdoor ) ) ( string outdoor ) ) )	overnight-restaurants
which threestar rated restaurant has outdoor seating	( call SW.listValue ( call SW.filter ( call SW.filter ( call SW.getProperty ( call SW.singleton en.restaurant ) ( string ! type ) ) ( string outdoor ) ) ( string star_rating ) ( string = ) ( number 3 en.star ) ) )	overnight-restaurants
what is the most expensive restaurant	( call SW.listValue ( call SW.superlative ( call SW.getProperty ( call SW.singleton en.restaurant ) ( string ! type ) ) ( string max ) ( call SW.ensureNumericProperty ( string price_rating ) ) ) )	overnight-restaurants
which restaurant that welcomes kids offers lunch	( call SW.listValue ( call SW.filter ( call SW.filter ( call SW.getProperty ( call SW.singleton en.restaurant ) ( string ! type ) ) ( string meals ) ( string = ) en.food.lunch ) ( string kids ) ) )	overnight-restaurants
what is the priuce rating of thai cafe	( call SW.listValue ( call SW.getProperty en.restaurant.thai_cafe ( string price_rating ) ) )	overnight-restaurants
restaurants with waiter service and takeout	( call SW.listValue ( call SW.filter ( call SW.filter ( call SW.getProperty ( call SW.singleton en.restaurant ) ( string ! type ) ) ( string waiter ) ) ( string takeout ) ) )	overnight-restaurants
restaurants which take reservations and are rated 2 dollar signs	( call SW.listValue ( call SW.filter ( call SW.filter ( call SW.getProperty ( call SW.singleton en.restaurant ) ( string ! type ) ) ( string price_rating ) ( string = ) ( number 2 en.dollar_sign ) ) ( string reserve ) ) )	overnight-restaurants
restaurants with takeout and waiter service	( call SW.listValue ( call SW.filter ( call SW.filter ( call SW.getProperty ( call SW.singleton en.restaurant ) ( string ! type ) ) ( string takeout ) ) ( string waiter ) ) )	overnight-restaurants
what restaurant serves two different types of cuisines	( call SW.listValue ( call SW.countComparative ( call SW.getProperty ( call SW.singleton en.restaurant ) ( string ! type ) ) ( string cuisine ) ( string = ) ( number 2 ) ) )	overnight-restaurants
neighborhood with restaurants that serve lunch	( call SW.listValue ( call SW.filter ( call SW.getProperty ( call SW.singleton en.neighborhood ) ( string ! type ) ) ( call SW.reverse ( string neighborhood ) ) ( string = ) ( call SW.filter ( call SW.getProperty ( call SW.singleton en.restaurant ) ( string ! type ) ) ( string meals ) ( string = ) en.food.lunch ) ) )	overnight-restaurants
a restaurant in a kid friendly neighborhood	( call SW.listValue ( call SW.filter ( call SW.getProperty ( call SW.singleton en.neighborhood ) ( string ! type ) ) ( call SW.reverse ( string neighborhood ) ) ( string = ) ( call SW.filter ( call SW.getProperty ( call SW.singleton en.restaurant ) ( string ! type ) ) ( string kids ) ) ) )	overnight-restaurants
restaurant that takes credit cards and whose star rating is 3 stars	( call SW.listValue ( call SW.filter ( call SW.filter ( call SW.getProperty ( call SW.singleton en.restaurant ) ( string ! type ) ) ( string credit ) ) ( string star_rating ) ( string = ) ( number 3 en.star ) ) )	overnight-restaurants
what restaurant has the lowest star rating	( call SW.listValue ( call SW.superlative ( call SW.getProperty ( call SW.singleton en.restaurant ) ( string ! type ) ) ( string min ) ( call SW.ensureNumericProperty ( string star_rating ) ) ) )	overnight-restaurants
restaurants in midtown west with outdoor seating	( call SW.listValue ( call SW.filter ( call SW.filter ( call SW.getProperty ( call SW.singleton en.restaurant ) ( string ! type ) ) ( string neighborhood ) ( string = ) en.neighborhood.midtown_west ) ( string outdoor ) ) )	overnight-restaurants
groupfriendly restaurants that accept reservations	( call SW.listValue ( call SW.filter ( call SW.filter ( call SW.getProperty ( call SW.singleton en.restaurant ) ( string ! type ) ) ( string reserve ) ) ( string groups ) ) )	overnight-restaurants
restaurants with dollar ratings less than 2	( call SW.listValue ( call SW.filter ( call SW.getProperty ( call SW.singleton en.restaurant ) ( string ! type ) ) ( call SW.ensureNumericProperty ( string price_rating ) ) ( string < ) ( call SW.ensureNumericEntity ( number 2 en.dollar_sign ) ) ) )	overnight-restaurants
what meal does the restaurant with a 2 dollar price rating serve	( call SW.listValue ( call SW.filter ( call SW.getProperty ( call SW.singleton en.food ) ( string ! type ) ) ( call SW.reverse ( string meals ) ) ( string = ) ( call SW.filter ( call SW.getProperty ( call SW.singleton en.restaurant ) ( string ! type ) ) ( string price_rating ) ( string = ) ( number 2 en.dollar_sign ) ) ) )	overnight-restaurants
which 3 star restaurants have waiters	( call SW.listValue ( call SW.filter ( call SW.filter ( call SW.getProperty ( call SW.singleton en.restaurant ) ( string ! type ) ) ( string star_rating ) ( string = ) ( number 3 en.star ) ) ( string waiter ) ) )	overnight-restaurants
what same meals do all the other restaurants serve	( call SW.listValue ( call SW.countSuperlative ( call SW.getProperty ( call SW.singleton en.food ) ( string ! type ) ) ( string max ) ( call SW.reverse ( string meals ) ) ( call SW.getProperty ( call SW.singleton en.restaurant ) ( string ! type ) ) ) )	overnight-restaurants
restaurant that has outdoor seating and that has waiter service	( call SW.listValue ( call SW.filter ( call SW.filter ( call SW.getProperty ( call SW.singleton en.restaurant ) ( string ! type ) ) ( string outdoor ) ) ( string waiter ) ) )	overnight-restaurants
thai cafe or pizzeria juno	( call SW.listValue ( call SW.concat en.restaurant.thai_cafe en.restaurant.pizzeria_juno ) )	overnight-restaurants
restaurant whose neighborhood is midtown west and that has outdoor seating	( call SW.listValue ( call SW.filter ( call SW.filter ( call SW.getProperty ( call SW.singleton en.restaurant ) ( string ! type ) ) ( string neighborhood ) ( string = ) en.neighborhood.midtown_west ) ( string outdoor ) ) )	overnight-restaurants
delivery is avaiable	( call SW.listValue ( call SW.filter ( call SW.getProperty ( call SW.singleton en.restaurant ) ( string ! type ) ) ( string delivery ) ) )	overnight-restaurants
find a 3 or fewer star restaurant	( call SW.listValue ( call SW.filter ( call SW.getProperty ( call SW.singleton en.restaurant ) ( string ! type ) ) ( call SW.ensureNumericProperty ( string star_rating ) ) ( string <= ) ( call SW.ensureNumericEntity ( number 3 en.star ) ) ) )	overnight-restaurants
what midtown west restaurant offers outdoor seating	( call SW.listValue ( call SW.filter ( call SW.filter ( call SW.getProperty ( call SW.singleton en.restaurant ) ( string ! type ) ) ( string neighborhood ) ( string = ) en.neighborhood.midtown_west ) ( string outdoor ) ) )	overnight-restaurants
which restaurants are rated 3 or 5 stars	( call SW.listValue ( call SW.filter ( call SW.getProperty ( call SW.singleton en.restaurant ) ( string ! type ) ) ( string star_rating ) ( string = ) ( call SW.concat ( number 3 en.star ) ( number 5 en.star ) ) ) )	overnight-restaurants
neighborhood that is neighborhood of thai cafe or pizzeria juno	( call SW.listValue ( call SW.filter ( call SW.getProperty ( call SW.singleton en.neighborhood ) ( string ! type ) ) ( call SW.reverse ( string neighborhood ) ) ( string = ) ( call SW.concat en.restaurant.thai_cafe en.restaurant.pizzeria_juno ) ) )	overnight-restaurants
what restaurant can i get lunch at that has waiter service	( call SW.listValue ( call SW.filter ( call SW.filter ( call SW.getProperty ( call SW.singleton en.restaurant ) ( string ! type ) ) ( string meals ) ( string = ) en.food.lunch ) ( string waiter ) ) )	overnight-restaurants
what restaurant has reservations and takeout	( call SW.listValue ( call SW.filter ( call SW.filter ( call SW.getProperty ( call SW.singleton en.restaurant ) ( string ! type ) ) ( string takeout ) ) ( string reserve ) ) )	overnight-restaurants
what restaurant delivers and has waiter service	( call SW.listValue ( call SW.filter ( call SW.filter ( call SW.getProperty ( call SW.singleton en.restaurant ) ( string ! type ) ) ( string delivery ) ) ( string waiter ) ) )	overnight-restaurants
what restaurant offers reservations and is good for kids	( call SW.listValue ( call SW.filter ( call SW.filter ( call SW.getProperty ( call SW.singleton en.restaurant ) ( string ! type ) ) ( string kids ) ) ( string reserve ) ) )	overnight-restaurants
what cuisine has the least amount of restaurants	( call SW.listValue ( call SW.countSuperlative ( call SW.getProperty ( call SW.singleton en.cuisine ) ( string ! type ) ) ( string min ) ( call SW.reverse ( string cuisine ) ) ( call SW.getProperty ( call SW.singleton en.restaurant ) ( string ! type ) ) ) )	overnight-restaurants
restaurants with a 3 or 5 star rating	( call SW.listValue ( call SW.filter ( call SW.getProperty ( call SW.singleton en.restaurant ) ( string ! type ) ) ( string star_rating ) ( string = ) ( call SW.concat ( number 3 en.star ) ( number 5 en.star ) ) ) )	overnight-restaurants
what restaurant has two meals	( call SW.listValue ( call SW.countComparative ( call SW.getProperty ( call SW.singleton en.restaurant ) ( string ! type ) ) ( string meals ) ( string = ) ( number 2 ) ( call SW.getProperty ( call SW.singleton en.food ) ( string ! type ) ) ) )	overnight-restaurants
hotels that have a minimum  price rating of 2 dollar signs	( call SW.listValue ( call SW.filter ( call SW.getProperty ( call SW.singleton en.restaurant ) ( string ! type ) ) ( call SW.ensureNumericProperty ( string price_rating ) ) ( string >= ) ( call SW.ensureNumericEntity ( call SW.concat ( number 2 en.dollar_sign ) ( number 3 en.dollar_sign ) ) ) ) )	overnight-restaurants
hotel which has a higher star rating than thai cafe	( call SW.listValue ( call SW.filter ( call SW.getProperty ( call SW.singleton en.restaurant ) ( string ! type ) ) ( call SW.ensureNumericProperty ( string star_rating ) ) ( string > ) ( call SW.ensureNumericEntity ( call SW.getProperty en.restaurant.thai_cafe ( string star_rating ) ) ) ) )	overnight-restaurants
which restaurants with 3 stars takes reservations	( call SW.listValue ( call SW.filter ( call SW.filter ( call SW.getProperty ( call SW.singleton en.restaurant ) ( string ! type ) ) ( string star_rating ) ( string = ) ( number 3 en.star ) ) ( string reserve ) ) )	overnight-restaurants
what cuisine does the thai cafe not have	( call SW.listValue ( call SW.filter ( call SW.getProperty ( call SW.singleton en.cuisine ) ( string ! type ) ) ( call SW.reverse ( string cuisine ) ) ( string ! = ) en.restaurant.thai_cafe ) )	overnight-restaurants
price rating of thai cafe	( call SW.listValue ( call SW.getProperty en.restaurant.thai_cafe ( string price_rating ) ) )	overnight-restaurants
restaurant that is cheaper than thai cafe	( call SW.listValue ( call SW.filter ( call SW.getProperty ( call SW.singleton en.restaurant ) ( string ! type ) ) ( call SW.ensureNumericProperty ( string price_rating ) ) ( string < ) ( call SW.ensureNumericEntity ( call SW.getProperty en.restaurant.thai_cafe ( string price_rating ) ) ) ) )	overnight-restaurants
restaurant that takes reservations and that is good for kids	( call SW.listValue ( call SW.filter ( call SW.filter ( call SW.getProperty ( call SW.singleton en.restaurant ) ( string ! type ) ) ( string reserve ) ) ( string kids ) ) )	overnight-restaurants
what is the star rating of the thai cafe	( call SW.listValue ( call SW.getProperty en.restaurant.thai_cafe ( string star_rating ) ) )	overnight-restaurants
which threestar rated restaurants are amenable to kids	( call SW.listValue ( call SW.filter ( call SW.filter ( call SW.getProperty ( call SW.singleton en.restaurant ) ( string ! type ) ) ( string kids ) ) ( string star_rating ) ( string = ) ( number 3 en.star ) ) )	overnight-restaurants
restaurant in the midtown west neighborhood	( call SW.listValue ( call SW.filter ( call SW.filter ( call SW.getProperty ( call SW.singleton en.restaurant ) ( string ! type ) ) ( string neighborhood ) ( string = ) en.neighborhood.midtown_west ) ( string neighborhood ) ( string = ) en.neighborhood.midtown_west ) )	overnight-restaurants
restaurant whose price rating is larger than 2 dollar signs or 3 dollar signs	( call SW.listValue ( call SW.filter ( call SW.getProperty ( call SW.singleton en.restaurant ) ( string ! type ) ) ( call SW.ensureNumericProperty ( string price_rating ) ) ( string > ) ( call SW.ensureNumericEntity ( call SW.concat ( number 2 en.dollar_sign ) ( number 3 en.dollar_sign ) ) ) ) )	overnight-restaurants
