which hotel offers delivery services	( call SW.listValue ( call SW.filter ( call SW.filter ( call SW.getProperty ( call SW.singleton en.restaurant ) ( string ! type ) ) ( string delivery ) ) ( string delivery ) ) )	overnight-restaurants
what cuisines are offered by restaurants accepting reservations	( call SW.listValue ( call SW.filter ( call SW.getProperty ( call SW.singleton en.cuisine ) ( string ! type ) ) ( call SW.reverse ( string cuisine ) ) ( string = ) ( call SW.filter ( call SW.getProperty ( call SW.singleton en.restaurant ) ( string ! type ) ) ( string reserve ) ) ) )	overnight-restaurants
family friendly restaurants in midtown west	( call SW.listValue ( call SW.filter ( call SW.filter ( call SW.getProperty ( call SW.singleton en.restaurant ) ( string ! type ) ) ( string kids ) ) ( string neighborhood ) ( string = ) en.neighborhood.midtown_west ) )	overnight-restaurants
what restaurants take credit cards and deliver	( call SW.listValue ( call SW.filter ( call SW.filter ( call SW.getProperty ( call SW.singleton en.restaurant ) ( string ! type ) ) ( string credit ) ) ( string delivery ) ) )	overnight-restaurants
what restaurants serve lunch and offer takeout	( call SW.listValue ( call SW.filter ( call SW.filter ( call SW.getProperty ( call SW.singleton en.restaurant ) ( string ! type ) ) ( string takeout ) ) ( string meals ) ( string = ) en.food.lunch ) )	overnight-restaurants
meals that few restaurants serve	( call SW.listValue ( call SW.countSuperlative ( call SW.getProperty ( call SW.singleton en.food ) ( string ! type ) ) ( string min ) ( call SW.reverse ( string meals ) ) ( call SW.getProperty ( call SW.singleton en.restaurant ) ( string ! type ) ) ) )	overnight-restaurants
restaurant not in the midtown west area	( call SW.listValue ( call SW.filter ( call SW.getProperty ( call SW.singleton en.restaurant ) ( string ! type ) ) ( string neighborhood ) ( string ! = ) en.neighborhood.midtown_west ) )	overnight-restaurants
what restaurants take credit cards and have outdoor settings	( call SW.listValue ( call SW.filter ( call SW.filter ( call SW.getProperty ( call SW.singleton en.restaurant ) ( string ! type ) ) ( string outdoor ) ) ( string credit ) ) )	overnight-restaurants
restaurant that has delivery services	( call SW.listValue ( call SW.filter ( call SW.getProperty ( call SW.singleton en.food ) ( string ! type ) ) ( call SW.reverse ( string meals ) ) ( string = ) ( call SW.filter ( call SW.getProperty ( call SW.singleton en.restaurant ) ( string ! type ) ) ( string delivery ) ) ) )	overnight-restaurants
restaurants in midtown west that deliver	( call SW.listValue ( call SW.filter ( call SW.filter ( call SW.getProperty ( call SW.singleton en.restaurant ) ( string ! type ) ) ( string delivery ) ) ( string neighborhood ) ( string = ) en.neighborhood.midtown_west ) )	overnight-restaurants
what is a meal served by a restaurant in midtown west	( call SW.listValue ( call SW.filter ( call SW.getProperty ( call SW.singleton en.food ) ( string ! type ) ) ( call SW.reverse ( string meals ) ) ( string = ) ( call SW.filter ( call SW.getProperty ( call SW.singleton en.restaurant ) ( string ! type ) ) ( string neighborhood ) ( string = ) en.neighborhood.midtown_west ) ) )	overnight-restaurants
chelsea or midtown west	( call SW.listValue ( call SW.concat en.neighborhood.midtown_west en.neighborhood.chelsea ) )	overnight-restaurants
restaurant that has outdoor seating and that has outdoor seating	( call SW.listValue ( call SW.filter ( call SW.filter ( call SW.getProperty ( call SW.singleton en.restaurant ) ( string ! type ) ) ( string outdoor ) ) ( string outdoor ) ) )	overnight-restaurants
what is the star rating of the thai cafe	( call SW.listValue ( call SW.getProperty en.restaurant.thai_cafe ( string star_rating ) ) )	overnight-restaurants
what neighborhood contains at least two restaurants	( call SW.listValue ( call SW.countComparative ( call SW.getProperty ( call SW.singleton en.neighborhood ) ( string ! type ) ) ( call SW.reverse ( string neighborhood ) ) ( string >= ) ( number 2 ) ( call SW.getProperty ( call SW.singleton en.restaurant ) ( string ! type ) ) ) )	overnight-restaurants
the 3 star restaurant is good for kids	( call SW.listValue ( call SW.filter ( call SW.filter ( call SW.getProperty ( call SW.singleton en.restaurant ) ( string ! type ) ) ( string kids ) ) ( string star_rating ) ( string = ) ( number 3 en.star ) ) )	overnight-restaurants
a thai restaurant for kids	( call SW.listValue ( call SW.filter ( call SW.filter ( call SW.getProperty ( call SW.singleton en.restaurant ) ( string ! type ) ) ( string cuisine ) ( string = ) en.cuisine.thai ) ( string kids ) ) )	overnight-restaurants
restaurant serving lunch that can deliver	( call SW.listValue ( call SW.filter ( call SW.filter ( call SW.getProperty ( call SW.singleton en.restaurant ) ( string ! type ) ) ( string delivery ) ) ( string meals ) ( string = ) en.food.lunch ) )	overnight-restaurants
which restaurant in midtown west has a 3star rating	( call SW.listValue ( call SW.filter ( call SW.filter ( call SW.getProperty ( call SW.singleton en.restaurant ) ( string ! type ) ) ( string star_rating ) ( string = ) ( number 3 en.star ) ) ( string neighborhood ) ( string = ) en.neighborhood.midtown_west ) )	overnight-restaurants
restaurant whose star rating is at most 3 stars or 5 stars	( call SW.listValue ( call SW.filter ( call SW.getProperty ( call SW.singleton en.restaurant ) ( string ! type ) ) ( call SW.ensureNumericProperty ( string star_rating ) ) ( string <= ) ( call SW.ensureNumericEntity ( call SW.concat ( number 3 en.star ) ( number 5 en.star ) ) ) ) )	overnight-restaurants
list all 3 star restaurants	( call SW.listValue ( call SW.filter ( call SW.filter ( call SW.getProperty ( call SW.singleton en.restaurant ) ( string ! type ) ) ( string star_rating ) ( string = ) ( number 3 en.star ) ) ( string star_rating ) ( string = ) ( number 3 en.star ) ) )	overnight-restaurants
what is the cuisine of thai cafe	( call SW.listValue ( call SW.getProperty en.restaurant.thai_cafe ( string cuisine ) ) )	overnight-restaurants
restaurant that has outdoor seating and that is good for groups	( call SW.listValue ( call SW.filter ( call SW.filter ( call SW.getProperty ( call SW.singleton en.restaurant ) ( string ! type ) ) ( string outdoor ) ) ( string groups ) ) )	overnight-restaurants
what cuisine has the least amount of restaurants	( call SW.listValue ( call SW.countSuperlative ( call SW.getProperty ( call SW.singleton en.cuisine ) ( string ! type ) ) ( string min ) ( call SW.reverse ( string cuisine ) ) ( call SW.getProperty ( call SW.singleton en.restaurant ) ( string ! type ) ) ) )	overnight-restaurants
restaurants with the same or higher star rating as thai cafe	( call SW.listValue ( call SW.filter ( call SW.getProperty ( call SW.singleton en.restaurant ) ( string ! type ) ) ( call SW.ensureNumericProperty ( string star_rating ) ) ( string >= ) ( call SW.ensureNumericEntity ( call SW.getProperty en.restaurant.thai_cafe ( string star_rating ) ) ) ) )	overnight-restaurants
what restaurants have a rating better than 3 or 5 stars	( call SW.listValue ( call SW.filter ( call SW.getProperty ( call SW.singleton en.restaurant ) ( string ! type ) ) ( call SW.ensureNumericProperty ( string star_rating ) ) ( string > ) ( call SW.ensureNumericEntity ( call SW.concat ( number 3 en.star ) ( number 5 en.star ) ) ) ) )	overnight-restaurants
restaurants that cheaper than thai cafe	( call SW.listValue ( call SW.filter ( call SW.getProperty ( call SW.singleton en.restaurant ) ( string ! type ) ) ( call SW.ensureNumericProperty ( string price_rating ) ) ( string < ) ( call SW.ensureNumericEntity ( call SW.getProperty en.restaurant.thai_cafe ( string price_rating ) ) ) ) )	overnight-restaurants
restaurant with no more than two cuisines	( call SW.listValue ( call SW.countComparative ( call SW.getProperty ( call SW.singleton en.restaurant ) ( string ! type ) ) ( string cuisine ) ( string <= ) ( number 2 ) ) )	overnight-restaurants
restaurants in the 2 or 3 dollar sign price range	( call SW.listValue ( call SW.filter ( call SW.getProperty ( call SW.singleton en.restaurant ) ( string ! type ) ) ( string price_rating ) ( string = ) ( call SW.concat ( number 2 en.dollar_sign ) ( number 3 en.dollar_sign ) ) ) )	overnight-restaurants
which neighborhood resturants have takeout	( call SW.listValue ( call SW.filter ( call SW.getProperty ( call SW.singleton en.neighborhood ) ( string ! type ) ) ( call SW.reverse ( string neighborhood ) ) ( string = ) ( call SW.filter ( call SW.getProperty ( call SW.singleton en.restaurant ) ( string ! type ) ) ( string takeout ) ) ) )	overnight-restaurants
restaurant with takeout in midtown west	( call SW.listValue ( call SW.filter ( call SW.filter ( call SW.getProperty ( call SW.singleton en.restaurant ) ( string ! type ) ) ( string takeout ) ) ( string neighborhood ) ( string = ) en.neighborhood.midtown_west ) )	overnight-restaurants
restaurants that serves meal	( call SW.listValue ( call SW.countComparative ( call SW.getProperty ( call SW.singleton en.food ) ( string ! type ) ) ( call SW.reverse ( string meals ) ) ( string <= ) ( number 2 ) ( call SW.getProperty ( call SW.singleton en.restaurant ) ( string ! type ) ) ) )	overnight-restaurants
find a thai restaurant in the midtown west area	( call SW.listValue ( call SW.filter ( call SW.filter ( call SW.getProperty ( call SW.singleton en.restaurant ) ( string ! type ) ) ( string neighborhood ) ( string = ) en.neighborhood.midtown_west ) ( string cuisine ) ( string = ) en.cuisine.thai ) )	overnight-restaurants
which restaurants serve lunch and have an outdoor dining area	( call SW.listValue ( call SW.filter ( call SW.filter ( call SW.getProperty ( call SW.singleton en.restaurant ) ( string ! type ) ) ( string outdoor ) ) ( string meals ) ( string = ) en.food.lunch ) )	overnight-restaurants
what are the hotels found in midtown west or chelsea	( call SW.listValue ( call SW.filter ( call SW.getProperty ( call SW.singleton en.restaurant ) ( string ! type ) ) ( string neighborhood ) ( string = ) ( call SW.concat en.neighborhood.midtown_west en.neighborhood.chelsea ) ) )	overnight-restaurants
restaurant that has the largest price rating	( call SW.listValue ( call SW.superlative ( call SW.getProperty ( call SW.singleton en.restaurant ) ( string ! type ) ) ( string max ) ( call SW.ensureNumericProperty ( string price_rating ) ) ) )	overnight-restaurants
restaurants with delivery rated 2 dollar signs	( call SW.listValue ( call SW.filter ( call SW.filter ( call SW.getProperty ( call SW.singleton en.restaurant ) ( string ! type ) ) ( string price_rating ) ( string = ) ( number 2 en.dollar_sign ) ) ( string delivery ) ) )	overnight-restaurants
what restaurant takes reservations and offers takeout	( call SW.listValue ( call SW.filter ( call SW.filter ( call SW.getProperty ( call SW.singleton en.restaurant ) ( string ! type ) ) ( string takeout ) ) ( string reserve ) ) )	overnight-restaurants
a restaurant with thai cuisine	( call SW.listValue ( call SW.filter ( call SW.filter ( call SW.getProperty ( call SW.singleton en.restaurant ) ( string ! type ) ) ( string cuisine ) ( string = ) en.cuisine.thai ) ( string cuisine ) ( string = ) en.cuisine.thai ) )	overnight-restaurants
what thai restaurants are kid friendly	( call SW.listValue ( call SW.filter ( call SW.filter ( call SW.getProperty ( call SW.singleton en.restaurant ) ( string ! type ) ) ( string cuisine ) ( string = ) en.cuisine.thai ) ( string kids ) ) )	overnight-restaurants
what meal does the 3 star restaurant serve	( call SW.listValue ( call SW.filter ( call SW.getProperty ( call SW.singleton en.food ) ( string ! type ) ) ( call SW.reverse ( string meals ) ) ( string = ) ( call SW.filter ( call SW.getProperty ( call SW.singleton en.restaurant ) ( string ! type ) ) ( string star_rating ) ( string = ) ( number 3 en.star ) ) ) )	overnight-restaurants
what thai restaurant offers delivery	( call SW.listValue ( call SW.filter ( call SW.filter ( call SW.getProperty ( call SW.singleton en.restaurant ) ( string ! type ) ) ( string delivery ) ) ( string cuisine ) ( string = ) en.cuisine.thai ) )	overnight-restaurants
what meal does the waiter serve at the restaurant	( call SW.listValue ( call SW.filter ( call SW.getProperty ( call SW.singleton en.food ) ( string ! type ) ) ( call SW.reverse ( string meals ) ) ( string = ) ( call SW.filter ( call SW.getProperty ( call SW.singleton en.restaurant ) ( string ! type ) ) ( string waiter ) ) ) )	overnight-restaurants
restaurants with 2 stars or less	( call SW.listValue ( call SW.filter ( call SW.getProperty ( call SW.singleton en.restaurant ) ( string ! type ) ) ( call SW.ensureNumericProperty ( string star_rating ) ) ( string < ) ( call SW.ensureNumericEntity ( number 3 en.star ) ) ) )	overnight-restaurants
what 3 star restaurants deliver	( call SW.listValue ( call SW.filter ( call SW.filter ( call SW.getProperty ( call SW.singleton en.restaurant ) ( string ! type ) ) ( string star_rating ) ( string = ) ( number 3 en.star ) ) ( string delivery ) ) )	overnight-restaurants
what restaurant can i eat lunch outdoors at	( call SW.listValue ( call SW.filter ( call SW.filter ( call SW.getProperty ( call SW.singleton en.restaurant ) ( string ! type ) ) ( string meals ) ( string = ) en.food.lunch ) ( string outdoor ) ) )	overnight-restaurants
list all restaurants in midtown west or chelsea	( call SW.listValue ( call SW.filter ( call SW.getProperty ( call SW.singleton en.restaurant ) ( string ! type ) ) ( string neighborhood ) ( string = ) ( call SW.concat en.neighborhood.midtown_west en.neighborhood.chelsea ) ) )	overnight-restaurants
which hotel has outdoor seating facilities and offers delivery services	( call SW.listValue ( call SW.filter ( call SW.filter ( call SW.getProperty ( call SW.singleton en.restaurant ) ( string ! type ) ) ( string delivery ) ) ( string outdoor ) ) )	overnight-restaurants
what restaurants serve the same cuisine as thai cafe	( call SW.listValue ( call SW.filter ( call SW.getProperty ( call SW.singleton en.restaurant ) ( string ! type ) ) ( string cuisine ) ( string = ) ( call SW.filter ( call SW.getProperty ( call SW.singleton en.cuisine ) ( string ! type ) ) ( call SW.reverse ( string cuisine ) ) ( string = ) en.restaurant.thai_cafe ) ) )	overnight-restaurants
list all restaurants that are either thai or italian	( call SW.listValue ( call SW.concat en.cuisine.thai en.cuisine.italian ) )	overnight-restaurants
name a restaurant that does not offer  thai food	( call SW.listValue ( call SW.filter ( call SW.getProperty ( call SW.singleton en.restaurant ) ( string ! type ) ) ( string cuisine ) ( string ! = ) en.cuisine.thai ) )	overnight-restaurants
at least 3 star restaurants	( call SW.listValue ( call SW.filter ( call SW.getProperty ( call SW.singleton en.restaurant ) ( string ! type ) ) ( call SW.ensureNumericProperty ( string star_rating ) ) ( string >= ) ( call SW.ensureNumericEntity ( number 3 en.star ) ) ) )	overnight-restaurants
list all restaurants that have takeout and delivery	( call SW.listValue ( call SW.filter ( call SW.filter ( call SW.getProperty ( call SW.singleton en.restaurant ) ( string ! type ) ) ( string takeout ) ) ( string delivery ) ) )	overnight-restaurants
restaurants that offer takeout	( call SW.listValue ( call SW.filter ( call SW.getProperty ( call SW.singleton en.food ) ( string ! type ) ) ( call SW.reverse ( string meals ) ) ( string = ) ( call SW.filter ( call SW.getProperty ( call SW.singleton en.restaurant ) ( string ! type ) ) ( string takeout ) ) ) )	overnight-restaurants
list all restaurants that have at least 3 star or 5 star ratings	( call SW.listValue ( call SW.filter ( call SW.getProperty ( call SW.singleton en.restaurant ) ( string ! type ) ) ( string star_rating ) ( string = ) ( call SW.concat ( number 3 en.star ) ( number 5 en.star ) ) ) )	overnight-restaurants
what neighborhood contains two restaurants	( call SW.listValue ( call SW.countComparative ( call SW.getProperty ( call SW.singleton en.neighborhood ) ( string ! type ) ) ( call SW.reverse ( string neighborhood ) ) ( string = ) ( number 2 ) ( call SW.getProperty ( call SW.singleton en.restaurant ) ( string ! type ) ) ) )	overnight-restaurants
which restaurants in midtown west deliver	( call SW.listValue ( call SW.filter ( call SW.filter ( call SW.getProperty ( call SW.singleton en.restaurant ) ( string ! type ) ) ( string neighborhood ) ( string = ) en.neighborhood.midtown_west ) ( string delivery ) ) )	overnight-restaurants
which resturants take reservations	( call SW.listValue ( call SW.filter ( call SW.getProperty ( call SW.singleton en.restaurant ) ( string ! type ) ) ( string reserve ) ) )	overnight-restaurants
what is the cuisine of restaurants that serve lunch	( call SW.listValue ( call SW.filter ( call SW.getProperty ( call SW.singleton en.cuisine ) ( string ! type ) ) ( call SW.reverse ( string cuisine ) ) ( string = ) ( call SW.filter ( call SW.getProperty ( call SW.singleton en.restaurant ) ( string ! type ) ) ( string meals ) ( string = ) en.food.lunch ) ) )	overnight-restaurants
hotel that can be booked in advance which has a price rating of 2 dollar signs	( call SW.listValue ( call SW.filter ( call SW.filter ( call SW.getProperty ( call SW.singleton en.restaurant ) ( string ! type ) ) ( string reserve ) ) ( string price_rating ) ( string = ) ( number 2 en.dollar_sign ) ) )	overnight-restaurants
which restaurants have outdoor seating and are group friendly	( call SW.listValue ( call SW.filter ( call SW.filter ( call SW.getProperty ( call SW.singleton en.restaurant ) ( string ! type ) ) ( string groups ) ) ( string outdoor ) ) )	overnight-restaurants
what is the price rating of thai cafe	( call SW.listValue ( call SW.getProperty en.restaurant.thai_cafe ( string price_rating ) ) )	overnight-restaurants
list all thai restaurants in midtown west	( call SW.listValue ( call SW.filter ( call SW.filter ( call SW.getProperty ( call SW.singleton en.restaurant ) ( string ! type ) ) ( string cuisine ) ( string = ) en.cuisine.thai ) ( string neighborhood ) ( string = ) en.neighborhood.midtown_west ) )	overnight-restaurants
what restaurant serves lunch to groups	( call SW.listValue ( call SW.filter ( call SW.filter ( call SW.getProperty ( call SW.singleton en.restaurant ) ( string ! type ) ) ( string meals ) ( string = ) en.food.lunch ) ( string groups ) ) )	overnight-restaurants
which resturants have a price less than or equal to thai cafe	( call SW.listValue ( call SW.filter ( call SW.getProperty ( call SW.singleton en.restaurant ) ( string ! type ) ) ( call SW.ensureNumericProperty ( string price_rating ) ) ( string <= ) ( call SW.ensureNumericEntity ( call SW.getProperty en.restaurant.thai_cafe ( string price_rating ) ) ) ) )	overnight-restaurants
what cuisines are offered by 3 star restaurants	( call SW.listValue ( call SW.filter ( call SW.getProperty ( call SW.singleton en.cuisine ) ( string ! type ) ) ( call SW.reverse ( string cuisine ) ) ( string = ) ( call SW.filter ( call SW.getProperty ( call SW.singleton en.restaurant ) ( string ! type ) ) ( string star_rating ) ( string = ) ( number 3 en.star ) ) ) )	overnight-restaurants
find a thai or italian restaurant	( call SW.listValue ( call SW.filter ( call SW.getProperty ( call SW.singleton en.restaurant ) ( string ! type ) ) ( string cuisine ) ( string = ) ( call SW.concat en.cuisine.thai en.cuisine.italian ) ) )	overnight-restaurants
moderately priced restaurants that have outdoor seating	( call SW.listValue ( call SW.filter ( call SW.filter ( call SW.getProperty ( call SW.singleton en.restaurant ) ( string ! type ) ) ( string price_rating ) ( string = ) ( number 2 en.dollar_sign ) ) ( string outdoor ) ) )	overnight-restaurants
what restaurant has more than two cuisines	( call SW.listValue ( call SW.countComparative ( call SW.getProperty ( call SW.singleton en.restaurant ) ( string ! type ) ) ( string cuisine ) ( string >= ) ( number 2 ) ) )	overnight-restaurants
what kind of cuisine is thai cafe	( call SW.listValue ( call SW.getProperty en.restaurant.thai_cafe ( string cuisine ) ) )	overnight-restaurants
restaurant that has waiter service and that takes reservations	( call SW.listValue ( call SW.filter ( call SW.filter ( call SW.getProperty ( call SW.singleton en.restaurant ) ( string ! type ) ) ( string waiter ) ) ( string reserve ) ) )	overnight-restaurants
which 3 star restaurants have outdoor seating	( call SW.listValue ( call SW.filter ( call SW.filter ( call SW.getProperty ( call SW.singleton en.restaurant ) ( string ! type ) ) ( string outdoor ) ) ( string star_rating ) ( string = ) ( number 3 en.star ) ) )	overnight-restaurants
restaurants with takeout that are good for large parties	( call SW.listValue ( call SW.filter ( call SW.filter ( call SW.getProperty ( call SW.singleton en.restaurant ) ( string ! type ) ) ( string groups ) ) ( string takeout ) ) )	overnight-restaurants
what restaurant with a price rating of two dollar signs is a good place for a group	( call SW.listValue ( call SW.filter ( call SW.filter ( call SW.getProperty ( call SW.singleton en.restaurant ) ( string ! type ) ) ( string groups ) ) ( string price_rating ) ( string = ) ( number 2 en.dollar_sign ) ) )	overnight-restaurants
which restaurant offers lunch	( call SW.listValue ( call SW.filter ( call SW.getProperty ( call SW.singleton en.restaurant ) ( string ! type ) ) ( string meals ) ( string = ) en.food.lunch ) )	overnight-restaurants
what meal can you get at either the thai cafe or at pizzeria juno	( call SW.listValue ( call SW.filter ( call SW.getProperty ( call SW.singleton en.food ) ( string ! type ) ) ( call SW.reverse ( string meals ) ) ( string = ) ( call SW.concat en.restaurant.thai_cafe en.restaurant.pizzeria_juno ) ) )	overnight-restaurants
what restaurant is in over two neighborhoods	( call SW.listValue ( call SW.countComparative ( call SW.getProperty ( call SW.singleton en.restaurant ) ( string ! type ) ) ( string neighborhood ) ( string > ) ( number 2 ) ) )	overnight-restaurants
a reservation restaurant that is kid friendly	( call SW.listValue ( call SW.filter ( call SW.filter ( call SW.getProperty ( call SW.singleton en.restaurant ) ( string ! type ) ) ( string reserve ) ) ( string kids ) ) )	overnight-restaurants
restaurants that deliver and are open for lunch	( call SW.listValue ( call SW.filter ( call SW.filter ( call SW.getProperty ( call SW.singleton en.restaurant ) ( string ! type ) ) ( string meals ) ( string = ) en.food.lunch ) ( string delivery ) ) )	overnight-restaurants
restaurant that is around mid town west that offers lunch	( call SW.listValue ( call SW.filter ( call SW.filter ( call SW.getProperty ( call SW.singleton en.restaurant ) ( string ! type ) ) ( string neighborhood ) ( string = ) en.neighborhood.midtown_west ) ( string meals ) ( string = ) en.food.lunch ) )	overnight-restaurants
meal served by a restaurant that delivers	( call SW.listValue ( call SW.filter ( call SW.getProperty ( call SW.singleton en.food ) ( string ! type ) ) ( call SW.reverse ( string meals ) ) ( string = ) ( call SW.filter ( call SW.getProperty ( call SW.singleton en.restaurant ) ( string ! type ) ) ( string delivery ) ) ) )	overnight-restaurants
which restaurants have a price rating of 2 to3 dollar signs	( call SW.listValue ( call SW.filter ( call SW.getProperty ( call SW.singleton en.restaurant ) ( string ! type ) ) ( call SW.ensureNumericProperty ( string price_rating ) ) ( string >= ) ( call SW.ensureNumericEntity ( call SW.concat ( number 2 en.dollar_sign ) ( number 3 en.dollar_sign ) ) ) ) )	overnight-restaurants
neighborhood that is neighborhood of restaurant that serves lunch	( call SW.listValue ( call SW.filter ( call SW.getProperty ( call SW.singleton en.neighborhood ) ( string ! type ) ) ( call SW.reverse ( string neighborhood ) ) ( string = ) ( call SW.filter ( call SW.getProperty ( call SW.singleton en.restaurant ) ( string ! type ) ) ( string meals ) ( string = ) en.food.lunch ) ) )	overnight-restaurants
what restaurant serves meals and accepts credit cards	( call SW.listValue ( call SW.filter ( call SW.getProperty ( call SW.singleton en.food ) ( string ! type ) ) ( call SW.reverse ( string meals ) ) ( string = ) ( call SW.filter ( call SW.getProperty ( call SW.singleton en.restaurant ) ( string ! type ) ) ( string credit ) ) ) )	overnight-restaurants
restaurant that takes reservations and that takes credit cards	( call SW.listValue ( call SW.filter ( call SW.filter ( call SW.getProperty ( call SW.singleton en.restaurant ) ( string ! type ) ) ( string reserve ) ) ( string credit ) ) )	overnight-restaurants
what resturant has a price rating smaller than two dollar signs	( call SW.listValue ( call SW.filter ( call SW.getProperty ( call SW.singleton en.restaurant ) ( string ! type ) ) ( call SW.ensureNumericProperty ( string price_rating ) ) ( string < ) ( call SW.ensureNumericEntity ( number 2 en.dollar_sign ) ) ) )	overnight-restaurants
which restaurants are rated under 3 stars	( call SW.listValue ( call SW.filter ( call SW.getProperty ( call SW.singleton en.restaurant ) ( string ! type ) ) ( call SW.ensureNumericProperty ( string star_rating ) ) ( string <= ) ( call SW.ensureNumericEntity ( call SW.concat ( number 3 en.star ) ( number 5 en.star ) ) ) ) )	overnight-restaurants
3 star restaurants that offer takeout	( call SW.listValue ( call SW.filter ( call SW.filter ( call SW.getProperty ( call SW.singleton en.restaurant ) ( string ! type ) ) ( string takeout ) ) ( string star_rating ) ( string = ) ( number 3 en.star ) ) )	overnight-restaurants
average star rating of restaurant	( call SW.listValue ( call SW.aggregate ( string avg ) ( call SW.getProperty ( call SW.getProperty ( call SW.singleton en.restaurant ) ( string ! type ) ) ( string star_rating ) ) ) )	overnight-restaurants
what 2 dollar signs restaurant offers lunch	( call SW.listValue ( call SW.filter ( call SW.filter ( call SW.getProperty ( call SW.singleton en.restaurant ) ( string ! type ) ) ( string meals ) ( string = ) en.food.lunch ) ( string price_rating ) ( string = ) ( number 2 en.dollar_sign ) ) )	overnight-restaurants
restaurants with waiters and outdoor dining areas	( call SW.listValue ( call SW.filter ( call SW.filter ( call SW.getProperty ( call SW.singleton en.restaurant ) ( string ! type ) ) ( string waiter ) ) ( string outdoor ) ) )	overnight-restaurants
what is a meal that a restaurant that is open for lunch serves	( call SW.listValue ( call SW.filter ( call SW.getProperty ( call SW.singleton en.food ) ( string ! type ) ) ( call SW.reverse ( string meals ) ) ( string = ) ( call SW.filter ( call SW.getProperty ( call SW.singleton en.restaurant ) ( string ! type ) ) ( string meals ) ( string = ) en.food.lunch ) ) )	overnight-restaurants
which restaurant takes reservations and is suitable for groups	( call SW.listValue ( call SW.filter ( call SW.filter ( call SW.getProperty ( call SW.singleton en.restaurant ) ( string ! type ) ) ( string reserve ) ) ( string groups ) ) )	overnight-restaurants
restaurant whose neighborhood is midtown west and that has outdoor seating	( call SW.listValue ( call SW.filter ( call SW.filter ( call SW.getProperty ( call SW.singleton en.restaurant ) ( string ! type ) ) ( string neighborhood ) ( string = ) en.neighborhood.midtown_west ) ( string outdoor ) ) )	overnight-restaurants
what are the types of cuisine available in the midtown west neighborhood	( call SW.listValue ( call SW.filter ( call SW.getProperty ( call SW.singleton en.cuisine ) ( string ! type ) ) ( call SW.reverse ( string cuisine ) ) ( string = ) ( call SW.filter ( call SW.getProperty ( call SW.singleton en.restaurant ) ( string ! type ) ) ( string neighborhood ) ( string = ) en.neighborhood.midtown_west ) ) )	overnight-restaurants
which resturants have a star rating smaller than 3 or 5 stars	( call SW.listValue ( call SW.filter ( call SW.getProperty ( call SW.singleton en.restaurant ) ( string ! type ) ) ( call SW.ensureNumericProperty ( string star_rating ) ) ( string < ) ( call SW.ensureNumericEntity ( call SW.concat ( number 3 en.star ) ( number 5 en.star ) ) ) ) )	overnight-restaurants
restaurants with delivery for kids	( call SW.listValue ( call SW.filter ( call SW.filter ( call SW.getProperty ( call SW.singleton en.restaurant ) ( string ! type ) ) ( string kids ) ) ( string delivery ) ) )	overnight-restaurants
restaurant whose star rating is 3 stars or 5 stars	( call SW.listValue ( call SW.filter ( call SW.getProperty ( call SW.singleton en.restaurant ) ( string ! type ) ) ( string star_rating ) ( string = ) ( call SW.concat ( number 3 en.star ) ( number 5 en.star ) ) ) )	overnight-restaurants
which neighborhood has restaurants that offer outdoor seating	( call SW.listValue ( call SW.filter ( call SW.getProperty ( call SW.singleton en.neighborhood ) ( string ! type ) ) ( call SW.reverse ( string neighborhood ) ) ( string = ) ( call SW.filter ( call SW.getProperty ( call SW.singleton en.restaurant ) ( string ! type ) ) ( string outdoor ) ) ) )	overnight-restaurants
restaurants rated 3 stars with a 2 dollar sign price rating	( call SW.listValue ( call SW.filter ( call SW.filter ( call SW.getProperty ( call SW.singleton en.restaurant ) ( string ! type ) ) ( string star_rating ) ( string = ) ( number 3 en.star ) ) ( string price_rating ) ( string = ) ( number 2 en.dollar_sign ) ) )	overnight-restaurants
restaurants that accept credit cards	( call SW.listValue ( call SW.filter ( call SW.getProperty ( call SW.singleton en.restaurant ) ( string ! type ) ) ( string credit ) ) )	overnight-restaurants
what cuisine is served at no more than two restaurants	( call SW.listValue ( call SW.countComparative ( call SW.getProperty ( call SW.singleton en.cuisine ) ( string ! type ) ) ( call SW.reverse ( string cuisine ) ) ( string <= ) ( number 2 ) ( call SW.getProperty ( call SW.singleton en.restaurant ) ( string ! type ) ) ) )	overnight-restaurants
a restaurant in midtown west that takes credit cards	( call SW.listValue ( call SW.filter ( call SW.filter ( call SW.getProperty ( call SW.singleton en.restaurant ) ( string ! type ) ) ( string neighborhood ) ( string = ) en.neighborhood.midtown_west ) ( string credit ) ) )	overnight-restaurants
a restaurant with alot of meals	( call SW.listValue ( call SW.countSuperlative ( call SW.getProperty ( call SW.singleton en.restaurant ) ( string ! type ) ) ( string max ) ( string meals ) ( call SW.getProperty ( call SW.singleton en.food ) ( string ! type ) ) ) )	overnight-restaurants
find a restaurant with more than 3 stars	( call SW.listValue ( call SW.filter ( call SW.getProperty ( call SW.singleton en.restaurant ) ( string ! type ) ) ( call SW.ensureNumericProperty ( string star_rating ) ) ( string > ) ( call SW.ensureNumericEntity ( call SW.concat ( number 3 en.star ) ( number 5 en.star ) ) ) ) )	overnight-restaurants
restaurants that are near two neighborhoods	( call SW.listValue ( call SW.countComparative ( call SW.getProperty ( call SW.singleton en.neighborhood ) ( string ! type ) ) ( call SW.reverse ( string neighborhood ) ) ( string <= ) ( number 2 ) ( call SW.getProperty ( call SW.singleton en.restaurant ) ( string ! type ) ) ) )	overnight-restaurants
name a restaurant in mid town that accepts credit cards	( call SW.listValue ( call SW.filter ( call SW.filter ( call SW.getProperty ( call SW.singleton en.restaurant ) ( string ! type ) ) ( string neighborhood ) ( string = ) en.neighborhood.midtown_west ) ( string credit ) ) )	overnight-restaurants
3star restaurants that deliver	( call SW.listValue ( call SW.filter ( call SW.filter ( call SW.getProperty ( call SW.singleton en.restaurant ) ( string ! type ) ) ( string delivery ) ) ( string star_rating ) ( string = ) ( number 3 en.star ) ) )	overnight-restaurants
what is the cuisine of most restaurants	( call SW.listValue ( call SW.countSuperlative ( call SW.getProperty ( call SW.singleton en.cuisine ) ( string ! type ) ) ( string max ) ( call SW.reverse ( string cuisine ) ) ( call SW.getProperty ( call SW.singleton en.restaurant ) ( string ! type ) ) ) )	overnight-restaurants
restaurant in midtown west for kids	( call SW.listValue ( call SW.filter ( call SW.filter ( call SW.getProperty ( call SW.singleton en.restaurant ) ( string ! type ) ) ( string kids ) ) ( string neighborhood ) ( string = ) en.neighborhood.midtown_west ) )	overnight-restaurants
thai restaurants that deliver	( call SW.listValue ( call SW.filter ( call SW.filter ( call SW.getProperty ( call SW.singleton en.restaurant ) ( string ! type ) ) ( string cuisine ) ( string = ) en.cuisine.thai ) ( string delivery ) ) )	overnight-restaurants
a lunch serving restaurant with take out	( call SW.listValue ( call SW.filter ( call SW.filter ( call SW.getProperty ( call SW.singleton en.restaurant ) ( string ! type ) ) ( string takeout ) ) ( string meals ) ( string = ) en.food.lunch ) )	overnight-restaurants
restaurant that has delivery and that has delivery	( call SW.listValue ( call SW.filter ( call SW.filter ( call SW.getProperty ( call SW.singleton en.restaurant ) ( string ! type ) ) ( string delivery ) ) ( string delivery ) ) )	overnight-restaurants
what restaurant serves the most meals	( call SW.listValue ( call SW.countSuperlative ( call SW.getProperty ( call SW.singleton en.restaurant ) ( string ! type ) ) ( string max ) ( string meals ) ( call SW.getProperty ( call SW.singleton en.food ) ( string ! type ) ) ) )	overnight-restaurants
what neighborhood is thai cafe or pizzeria juno in	( call SW.listValue ( call SW.filter ( call SW.getProperty ( call SW.singleton en.neighborhood ) ( string ! type ) ) ( call SW.reverse ( string neighborhood ) ) ( string = ) ( call SW.concat en.restaurant.thai_cafe en.restaurant.pizzeria_juno ) ) )	overnight-restaurants
restaurant whose star rating is larger than 3 stars or 5 stars	( call SW.listValue ( call SW.filter ( call SW.getProperty ( call SW.singleton en.restaurant ) ( string ! type ) ) ( call SW.ensureNumericProperty ( string star_rating ) ) ( string > ) ( call SW.ensureNumericEntity ( call SW.concat ( number 3 en.star ) ( number 5 en.star ) ) ) ) )	overnight-restaurants
what restaurant serves the same food as the thai cafe	( call SW.listValue ( call SW.filter ( call SW.getProperty ( call SW.singleton en.restaurant ) ( string ! type ) ) ( string meals ) ( string = ) ( call SW.filter ( call SW.getProperty ( call SW.singleton en.food ) ( string ! type ) ) ( call SW.reverse ( string meals ) ) ( string = ) en.restaurant.thai_cafe ) ) )	overnight-restaurants
what restaurant can i get reservations and get delivery from	( call SW.listValue ( call SW.filter ( call SW.filter ( call SW.getProperty ( call SW.singleton en.restaurant ) ( string ! type ) ) ( string delivery ) ) ( string reserve ) ) )	overnight-restaurants
which restaurants have waiters and a price rating of two dollar signs	( call SW.listValue ( call SW.filter ( call SW.filter ( call SW.getProperty ( call SW.singleton en.restaurant ) ( string ! type ) ) ( string waiter ) ) ( string price_rating ) ( string = ) ( number 2 en.dollar_sign ) ) )	overnight-restaurants
thai restaurants that have takeout	( call SW.listValue ( call SW.filter ( call SW.filter ( call SW.getProperty ( call SW.singleton en.restaurant ) ( string ! type ) ) ( string cuisine ) ( string = ) en.cuisine.thai ) ( string takeout ) ) )	overnight-restaurants
what restaurant offers takeout and delivery	( call SW.listValue ( call SW.filter ( call SW.filter ( call SW.getProperty ( call SW.singleton en.restaurant ) ( string ! type ) ) ( string delivery ) ) ( string takeout ) ) )	overnight-restaurants
what restaurants offer waiter serivce	( call SW.listValue ( call SW.filter ( call SW.getProperty ( call SW.singleton en.cuisine ) ( string ! type ) ) ( call SW.reverse ( string cuisine ) ) ( string = ) ( call SW.filter ( call SW.getProperty ( call SW.singleton en.restaurant ) ( string ! type ) ) ( string waiter ) ) ) )	overnight-restaurants
hotel that has more than a three star rating	( call SW.listValue ( call SW.filter ( call SW.getProperty ( call SW.singleton en.restaurant ) ( string ! type ) ) ( call SW.ensureNumericProperty ( string star_rating ) ) ( string > ) ( call SW.ensureNumericEntity ( number 3 en.star ) ) ) )	overnight-restaurants
restaurant with takeout	( call SW.listValue ( call SW.filter ( call SW.getProperty ( call SW.singleton en.food ) ( string ! type ) ) ( call SW.reverse ( string meals ) ) ( string = ) ( call SW.filter ( call SW.getProperty ( call SW.singleton en.restaurant ) ( string ! type ) ) ( string takeout ) ) ) )	overnight-restaurants
what restaurants are good for groups and kids	( call SW.listValue ( call SW.filter ( call SW.filter ( call SW.getProperty ( call SW.singleton en.restaurant ) ( string ! type ) ) ( string kids ) ) ( string groups ) ) )	overnight-restaurants
hotel which has a 3 star rating	( call SW.listValue ( call SW.filter ( call SW.getProperty ( call SW.singleton en.restaurant ) ( string ! type ) ) ( string star_rating ) ( string = ) ( number 3 en.star ) ) )	overnight-restaurants
a restaurant for kids in midtown west	( call SW.listValue ( call SW.filter ( call SW.filter ( call SW.getProperty ( call SW.singleton en.restaurant ) ( string ! type ) ) ( string neighborhood ) ( string = ) en.neighborhood.midtown_west ) ( string kids ) ) )	overnight-restaurants
restaurants in the midtown west neighborhood with outdoor seating	( call SW.listValue ( call SW.filter ( call SW.filter ( call SW.getProperty ( call SW.singleton en.restaurant ) ( string ! type ) ) ( string neighborhood ) ( string = ) en.neighborhood.midtown_west ) ( string outdoor ) ) )	overnight-restaurants
what is a meal served by a restaurant that accepts credit cards	( call SW.listValue ( call SW.filter ( call SW.getProperty ( call SW.singleton en.food ) ( string ! type ) ) ( call SW.reverse ( string meals ) ) ( string = ) ( call SW.filter ( call SW.getProperty ( call SW.singleton en.restaurant ) ( string ! type ) ) ( string credit ) ) ) )	overnight-restaurants
restaurants with delivery in midtown west	( call SW.listValue ( call SW.filter ( call SW.filter ( call SW.getProperty ( call SW.singleton en.restaurant ) ( string ! type ) ) ( string neighborhood ) ( string = ) en.neighborhood.midtown_west ) ( string delivery ) ) )	overnight-restaurants
restaurant that is good for groups and whose cuisine is thai	( call SW.listValue ( call SW.filter ( call SW.filter ( call SW.getProperty ( call SW.singleton en.restaurant ) ( string ! type ) ) ( string groups ) ) ( string cuisine ) ( string = ) en.cuisine.thai ) )	overnight-restaurants
what neighborhood has the least restaurants	( call SW.listValue ( call SW.countSuperlative ( call SW.getProperty ( call SW.singleton en.neighborhood ) ( string ! type ) ) ( string min ) ( call SW.reverse ( string neighborhood ) ) ( call SW.getProperty ( call SW.singleton en.restaurant ) ( string ! type ) ) ) )	overnight-restaurants
what restaurant serves the least amount of meals	( call SW.listValue ( call SW.countSuperlative ( call SW.getProperty ( call SW.singleton en.food ) ( string ! type ) ) ( string min ) ( call SW.reverse ( string meals ) ) ( call SW.getProperty ( call SW.singleton en.restaurant ) ( string ! type ) ) ) )	overnight-restaurants
find a restaurant that has delivery as well as waiter service	( call SW.listValue ( call SW.filter ( call SW.filter ( call SW.getProperty ( call SW.singleton en.restaurant ) ( string ! type ) ) ( string waiter ) ) ( string delivery ) ) )	overnight-restaurants
neighborhood that is neighborhood of restaurant that takes reservations	( call SW.listValue ( call SW.filter ( call SW.getProperty ( call SW.singleton en.neighborhood ) ( string ! type ) ) ( call SW.reverse ( string neighborhood ) ) ( string = ) ( call SW.filter ( call SW.getProperty ( call SW.singleton en.restaurant ) ( string ! type ) ) ( string reserve ) ) ) )	overnight-restaurants
thai restaurants rated 2 dollar signs	( call SW.listValue ( call SW.filter ( call SW.filter ( call SW.getProperty ( call SW.singleton en.restaurant ) ( string ! type ) ) ( string price_rating ) ( string = ) ( number 2 en.dollar_sign ) ) ( string cuisine ) ( string = ) en.cuisine.thai ) )	overnight-restaurants
what are some 2 dollar rated restaurants good for groups	( call SW.listValue ( call SW.filter ( call SW.filter ( call SW.getProperty ( call SW.singleton en.restaurant ) ( string ! type ) ) ( string price_rating ) ( string = ) ( number 2 en.dollar_sign ) ) ( string groups ) ) )	overnight-restaurants
restaurants open for at least two meals per day	( call SW.listValue ( call SW.countComparative ( call SW.getProperty ( call SW.singleton en.restaurant ) ( string ! type ) ) ( string meals ) ( string >= ) ( number 2 ) ( call SW.getProperty ( call SW.singleton en.food ) ( string ! type ) ) ) )	overnight-restaurants
restaurants with no more than 2 locations	( call SW.listValue ( call SW.countComparative ( call SW.getProperty ( call SW.singleton en.restaurant ) ( string ! type ) ) ( string neighborhood ) ( string <= ) ( number 2 ) ) )	overnight-restaurants
what restaurant is in the least number of neighborhoods	( call SW.listValue ( call SW.countSuperlative ( call SW.getProperty ( call SW.singleton en.restaurant ) ( string ! type ) ) ( string min ) ( string neighborhood ) ) )	overnight-restaurants
which restaurant has a three star rating and also takes reservations	( call SW.listValue ( call SW.filter ( call SW.filter ( call SW.getProperty ( call SW.singleton en.restaurant ) ( string ! type ) ) ( string reserve ) ) ( string star_rating ) ( string = ) ( number 3 en.star ) ) )	overnight-restaurants
restaurants that serve same meals as thai cafe	( call SW.listValue ( call SW.filter ( call SW.getProperty ( call SW.singleton en.restaurant ) ( string ! type ) ) ( string meals ) ( string = ) ( call SW.filter ( call SW.getProperty ( call SW.singleton en.food ) ( string ! type ) ) ( call SW.reverse ( string meals ) ) ( string = ) en.restaurant.thai_cafe ) ) )	overnight-restaurants
restaurants that are in midtown west	( call SW.listValue ( call SW.filter ( call SW.getProperty ( call SW.singleton en.food ) ( string ! type ) ) ( call SW.reverse ( string meals ) ) ( string = ) ( call SW.filter ( call SW.getProperty ( call SW.singleton en.restaurant ) ( string ! type ) ) ( string neighborhood ) ( string = ) en.neighborhood.midtown_west ) ) )	overnight-restaurants
what restaurant takes reservations	( call SW.listValue ( call SW.filter ( call SW.getProperty ( call SW.singleton en.restaurant ) ( string ! type ) ) ( string reserve ) ) )	overnight-restaurants
restaurants with two neighborhood locations	( call SW.listValue ( call SW.countComparative ( call SW.getProperty ( call SW.singleton en.restaurant ) ( string ! type ) ) ( string neighborhood ) ( string = ) ( number 2 ) ) )	overnight-restaurants
which neighborhoods have 3 star restaurants	( call SW.listValue ( call SW.filter ( call SW.getProperty ( call SW.singleton en.neighborhood ) ( string ! type ) ) ( call SW.reverse ( string neighborhood ) ) ( string = ) ( call SW.filter ( call SW.getProperty ( call SW.singleton en.restaurant ) ( string ! type ) ) ( string star_rating ) ( string = ) ( number 3 en.star ) ) ) )	overnight-restaurants
what restaurant serves two different types of cuisines	( call SW.listValue ( call SW.countComparative ( call SW.getProperty ( call SW.singleton en.restaurant ) ( string ! type ) ) ( string cuisine ) ( string = ) ( number 2 ) ) )	overnight-restaurants
restaurant in the  area around midtown west that offers delivery services	( call SW.listValue ( call SW.filter ( call SW.filter ( call SW.getProperty ( call SW.singleton en.restaurant ) ( string ! type ) ) ( string delivery ) ) ( string neighborhood ) ( string = ) en.neighborhood.midtown_west ) )	overnight-restaurants
which restaurants serve lunch and accept reservations	( call SW.listValue ( call SW.filter ( call SW.filter ( call SW.getProperty ( call SW.singleton en.restaurant ) ( string ! type ) ) ( string meals ) ( string = ) en.food.lunch ) ( string reserve ) ) )	overnight-restaurants
restaurant whose star rating is at most star rating of thai cafe	( call SW.listValue ( call SW.filter ( call SW.getProperty ( call SW.singleton en.restaurant ) ( string ! type ) ) ( call SW.ensureNumericProperty ( string star_rating ) ) ( string <= ) ( call SW.ensureNumericEntity ( call SW.getProperty en.restaurant.thai_cafe ( string star_rating ) ) ) ) )	overnight-restaurants
what 3 star restaurant offers delivery	( call SW.listValue ( call SW.filter ( call SW.filter ( call SW.getProperty ( call SW.singleton en.restaurant ) ( string ! type ) ) ( string delivery ) ) ( string star_rating ) ( string = ) ( number 3 en.star ) ) )	overnight-restaurants
what is a meal served at the thai cafe	( call SW.listValue ( call SW.filter ( call SW.filter ( call SW.getProperty ( call SW.singleton en.food ) ( string ! type ) ) ( call SW.reverse ( string meals ) ) ( string = ) en.restaurant.thai_cafe ) ( call SW.reverse ( string meals ) ) ( string = ) en.restaurant.thai_cafe ) )	overnight-restaurants
which 3 star restaurants have waiters	( call SW.listValue ( call SW.filter ( call SW.filter ( call SW.getProperty ( call SW.singleton en.restaurant ) ( string ! type ) ) ( string star_rating ) ( string = ) ( number 3 en.star ) ) ( string waiter ) ) )	overnight-restaurants
restaurants with 5 star and lower price ratings	( call SW.listValue ( call SW.filter ( call SW.getProperty ( call SW.singleton en.restaurant ) ( string ! type ) ) ( call SW.ensureNumericProperty ( string star_rating ) ) ( string <= ) ( call SW.ensureNumericEntity ( call SW.concat ( number 3 en.star ) ( number 5 en.star ) ) ) ) )	overnight-restaurants
what restaurant is amenable to children and has delivery	( call SW.listValue ( call SW.filter ( call SW.filter ( call SW.getProperty ( call SW.singleton en.restaurant ) ( string ! type ) ) ( string kids ) ) ( string delivery ) ) )	overnight-restaurants
what restaurant does not have a 3 star rating	( call SW.listValue ( call SW.filter ( call SW.getProperty ( call SW.singleton en.restaurant ) ( string ! type ) ) ( string star_rating ) ( string ! = ) ( number 3 en.star ) ) )	overnight-restaurants
what restaurant offers lunch and takeout	( call SW.listValue ( call SW.filter ( call SW.filter ( call SW.getProperty ( call SW.singleton en.restaurant ) ( string ! type ) ) ( string takeout ) ) ( string meals ) ( string = ) en.food.lunch ) )	overnight-restaurants
restaurants with outdoor seating that takes reservations	( call SW.listValue ( call SW.filter ( call SW.filter ( call SW.getProperty ( call SW.singleton en.restaurant ) ( string ! type ) ) ( string reserve ) ) ( string outdoor ) ) )	overnight-restaurants
what restaurants take credit cards and offers waiter service	( call SW.listValue ( call SW.filter ( call SW.filter ( call SW.getProperty ( call SW.singleton en.restaurant ) ( string ! type ) ) ( string waiter ) ) ( string credit ) ) )	overnight-restaurants
restaurants with a 3 or 5 star rating	( call SW.listValue ( call SW.filter ( call SW.getProperty ( call SW.singleton en.restaurant ) ( string ! type ) ) ( string star_rating ) ( string = ) ( call SW.concat ( number 3 en.star ) ( number 5 en.star ) ) ) )	overnight-restaurants
a restaurant with a 2 dollar sign rating for kids	( call SW.listValue ( call SW.filter ( call SW.filter ( call SW.getProperty ( call SW.singleton en.restaurant ) ( string ! type ) ) ( string price_rating ) ( string = ) ( number 2 en.dollar_sign ) ) ( string kids ) ) )	overnight-restaurants
restaurant that has the least number of cuisine	( call SW.listValue ( call SW.countSuperlative ( call SW.getProperty ( call SW.singleton en.restaurant ) ( string ! type ) ) ( string min ) ( string cuisine ) ) )	overnight-restaurants
list all thai or italian restaurants	( call SW.listValue ( call SW.filter ( call SW.getProperty ( call SW.singleton en.restaurant ) ( string ! type ) ) ( string cuisine ) ( string = ) ( call SW.concat en.cuisine.thai en.cuisine.italian ) ) )	overnight-restaurants
thai cafe in the neighborhood	( call SW.listValue ( call SW.getProperty en.restaurant.thai_cafe ( string neighborhood ) ) )	overnight-restaurants
what kind of meals does takeout restaurants serve	( call SW.listValue ( call SW.filter ( call SW.getProperty ( call SW.singleton en.food ) ( string ! type ) ) ( call SW.reverse ( string meals ) ) ( string = ) ( call SW.filter ( call SW.getProperty ( call SW.singleton en.restaurant ) ( string ! type ) ) ( string takeout ) ) ) )	overnight-restaurants
restaurants that serve lunch and have a price rating of 2	( call SW.listValue ( call SW.filter ( call SW.filter ( call SW.getProperty ( call SW.singleton en.restaurant ) ( string ! type ) ) ( string price_rating ) ( string = ) ( number 2 en.dollar_sign ) ) ( string meals ) ( string = ) en.food.lunch ) )	overnight-restaurants
what neighborhood has no more than two restaurants	( call SW.listValue ( call SW.countComparative ( call SW.getProperty ( call SW.singleton en.neighborhood ) ( string ! type ) ) ( call SW.reverse ( string neighborhood ) ) ( string <= ) ( number 2 ) ( call SW.getProperty ( call SW.singleton en.restaurant ) ( string ! type ) ) ) )	overnight-restaurants
hotels that have a minimum  price rating of 2 dollar signs	( call SW.listValue ( call SW.filter ( call SW.getProperty ( call SW.singleton en.restaurant ) ( string ! type ) ) ( call SW.ensureNumericProperty ( string price_rating ) ) ( string >= ) ( call SW.ensureNumericEntity ( call SW.concat ( number 2 en.dollar_sign ) ( number 3 en.dollar_sign ) ) ) ) )	overnight-restaurants
restaurants with no more than two cuisines	( call SW.listValue ( call SW.countComparative ( call SW.getProperty ( call SW.singleton en.restaurant ) ( string ! type ) ) ( string cuisine ) ( string <= ) ( number 2 ) ) )	overnight-restaurants
restaurant that is cheaper than thai cafe	( call SW.listValue ( call SW.filter ( call SW.getProperty ( call SW.singleton en.restaurant ) ( string ! type ) ) ( call SW.ensureNumericProperty ( string price_rating ) ) ( string < ) ( call SW.ensureNumericEntity ( call SW.getProperty en.restaurant.thai_cafe ( string price_rating ) ) ) ) )	overnight-restaurants
what restaurant has outdoor seating and has a price rating of the 2 dollar sign	( call SW.listValue ( call SW.filter ( call SW.filter ( call SW.getProperty ( call SW.singleton en.restaurant ) ( string ! type ) ) ( string outdoor ) ) ( string price_rating ) ( string = ) ( number 2 en.dollar_sign ) ) )	overnight-restaurants
what neighborhood has more than two restaurants	( call SW.listValue ( call SW.countComparative ( call SW.getProperty ( call SW.singleton en.neighborhood ) ( string ! type ) ) ( call SW.reverse ( string neighborhood ) ) ( string > ) ( number 2 ) ( call SW.getProperty ( call SW.singleton en.restaurant ) ( string ! type ) ) ) )	overnight-restaurants
which restaurants accept reservations	( call SW.listValue ( call SW.filter ( call SW.filter ( call SW.getProperty ( call SW.singleton en.restaurant ) ( string ! type ) ) ( string reserve ) ) ( string reserve ) ) )	overnight-restaurants
restaurant with outdoor seating that accepts credit cards	( call SW.listValue ( call SW.filter ( call SW.filter ( call SW.getProperty ( call SW.singleton en.restaurant ) ( string ! type ) ) ( string outdoor ) ) ( string credit ) ) )	overnight-restaurants
what thai restaurant has the highest star rating	( call SW.listValue ( call SW.filter ( call SW.getProperty ( call SW.singleton en.restaurant ) ( string ! type ) ) ( call SW.ensureNumericProperty ( string star_rating ) ) ( string <= ) ( call SW.ensureNumericEntity ( call SW.getProperty en.restaurant.thai_cafe ( string star_rating ) ) ) ) )	overnight-restaurants
thai restaurant which provides outdoor seating facilities	( call SW.listValue ( call SW.filter ( call SW.filter ( call SW.getProperty ( call SW.singleton en.restaurant ) ( string ! type ) ) ( string outdoor ) ) ( string cuisine ) ( string = ) en.cuisine.thai ) )	overnight-restaurants
restaurants in the midtown west neighborhood that have a 2 dollar sign price rating	( call SW.listValue ( call SW.filter ( call SW.filter ( call SW.getProperty ( call SW.singleton en.restaurant ) ( string ! type ) ) ( string neighborhood ) ( string = ) en.neighborhood.midtown_west ) ( string price_rating ) ( string = ) ( number 2 en.dollar_sign ) ) )	overnight-restaurants
restaurants that offer credit cards and takeout	( call SW.listValue ( call SW.filter ( call SW.filter ( call SW.getProperty ( call SW.singleton en.restaurant ) ( string ! type ) ) ( string credit ) ) ( string takeout ) ) )	overnight-restaurants
find a 3 star restaurant with waiter service	( call SW.listValue ( call SW.filter ( call SW.filter ( call SW.getProperty ( call SW.singleton en.restaurant ) ( string ! type ) ) ( string waiter ) ) ( string star_rating ) ( string = ) ( number 3 en.star ) ) )	overnight-restaurants
what restaurants serve at least two cuisines	( call SW.listValue ( call SW.countComparative ( call SW.getProperty ( call SW.singleton en.restaurant ) ( string ! type ) ) ( string cuisine ) ( string >= ) ( number 2 ) ) )	overnight-restaurants
restaurants who have a price rating lower than 2 dollar signs	( call SW.listValue ( call SW.filter ( call SW.getProperty ( call SW.singleton en.restaurant ) ( string ! type ) ) ( string price_rating ) ( string ! = ) ( number 2 en.dollar_sign ) ) )	overnight-restaurants
what thai restaurant has outdoor seating	( call SW.listValue ( call SW.filter ( call SW.filter ( call SW.getProperty ( call SW.singleton en.restaurant ) ( string ! type ) ) ( string cuisine ) ( string = ) en.cuisine.thai ) ( string outdoor ) ) )	overnight-restaurants
what restaurants have a price rating of two dollar signs and also accept credit cards	( call SW.listValue ( call SW.filter ( call SW.filter ( call SW.getProperty ( call SW.singleton en.restaurant ) ( string ! type ) ) ( string price_rating ) ( string = ) ( number 2 en.dollar_sign ) ) ( string credit ) ) )	overnight-restaurants
hotel that can be booked in advance and which has a price rating of 2 dollar signs	( call SW.listValue ( call SW.filter ( call SW.filter ( call SW.getProperty ( call SW.singleton en.restaurant ) ( string ! type ) ) ( string price_rating ) ( string = ) ( number 2 en.dollar_sign ) ) ( string reserve ) ) )	overnight-restaurants
a restaurant with waiter service	( call SW.listValue ( call SW.filter ( call SW.filter ( call SW.getProperty ( call SW.singleton en.restaurant ) ( string ! type ) ) ( string waiter ) ) ( string waiter ) ) )	overnight-restaurants
which thai restaurants take reservations	( call SW.listValue ( call SW.filter ( call SW.filter ( call SW.getProperty ( call SW.singleton en.restaurant ) ( string ! type ) ) ( string reserve ) ) ( string cuisine ) ( string = ) en.cuisine.thai ) )	overnight-restaurants
restaurant that has two cuisines	( call SW.listValue ( call SW.countComparative ( call SW.getProperty ( call SW.singleton en.restaurant ) ( string ! type ) ) ( string cuisine ) ( string > ) ( number 2 ) ) )	overnight-restaurants
what restaurant offers only one cuisine	( call SW.listValue ( call SW.countComparative ( call SW.getProperty ( call SW.singleton en.restaurant ) ( string ! type ) ) ( string cuisine ) ( string < ) ( number 2 ) ) )	overnight-restaurants
restaurant that has delivery and whose price rating is 2 dollar signs	( call SW.listValue ( call SW.filter ( call SW.filter ( call SW.getProperty ( call SW.singleton en.restaurant ) ( string ! type ) ) ( string delivery ) ) ( string price_rating ) ( string = ) ( number 2 en.dollar_sign ) ) )	overnight-restaurants
restaurants that serve the same cuisine	( call SW.listValue ( call SW.countComparative ( call SW.getProperty ( call SW.singleton en.cuisine ) ( string ! type ) ) ( call SW.reverse ( string cuisine ) ) ( string < ) ( number 2 ) ( call SW.getProperty ( call SW.singleton en.restaurant ) ( string ! type ) ) ) )	overnight-restaurants
what is the price range for the thai restaurant	( call SW.listValue ( call SW.filter ( call SW.getProperty ( call SW.singleton en.restaurant ) ( string ! type ) ) ( string price_rating ) ( string = ) ( call SW.getProperty en.restaurant.thai_cafe ( string price_rating ) ) ) )	overnight-restaurants
which restaurant offers the most variety of cuisine	( call SW.listValue ( call SW.countSuperlative ( call SW.getProperty ( call SW.singleton en.restaurant ) ( string ! type ) ) ( string max ) ( string cuisine ) ) )	overnight-restaurants
the restaurant serves lunch as well as thai food	( call SW.listValue ( call SW.filter ( call SW.filter ( call SW.getProperty ( call SW.singleton en.restaurant ) ( string ! type ) ) ( string cuisine ) ( string = ) en.cuisine.thai ) ( string meals ) ( string = ) en.food.lunch ) )	overnight-restaurants
which restaurant is friendly towards children and takes reservations	( call SW.listValue ( call SW.filter ( call SW.filter ( call SW.getProperty ( call SW.singleton en.restaurant ) ( string ! type ) ) ( string kids ) ) ( string reserve ) ) )	overnight-restaurants
what takeout restaurant has outdoor seating	( call SW.listValue ( call SW.filter ( call SW.filter ( call SW.getProperty ( call SW.singleton en.restaurant ) ( string ! type ) ) ( string outdoor ) ) ( string takeout ) ) )	overnight-restaurants
restaurants that have waiters and outdoor dining areas	( call SW.listValue ( call SW.filter ( call SW.filter ( call SW.getProperty ( call SW.singleton en.restaurant ) ( string ! type ) ) ( string outdoor ) ) ( string waiter ) ) )	overnight-restaurants
what restaurant is good for groups	( call SW.listValue ( call SW.filter ( call SW.filter ( call SW.getProperty ( call SW.singleton en.restaurant ) ( string ! type ) ) ( string groups ) ) ( string groups ) ) )	overnight-restaurants
thai cafe or pizzeria juno	( call SW.listValue ( call SW.concat en.restaurant.thai_cafe en.restaurant.pizzeria_juno ) )	overnight-restaurants
groupfriendly restaurants in midtown west	( call SW.listValue ( call SW.filter ( call SW.filter ( call SW.getProperty ( call SW.singleton en.restaurant ) ( string ! type ) ) ( string groups ) ) ( string neighborhood ) ( string = ) en.neighborhood.midtown_west ) )	overnight-restaurants
find a thai restaurant that serves lunch	( call SW.listValue ( call SW.filter ( call SW.filter ( call SW.getProperty ( call SW.singleton en.restaurant ) ( string ! type ) ) ( string cuisine ) ( string = ) en.cuisine.thai ) ( string meals ) ( string = ) en.food.lunch ) )	overnight-restaurants
what meal is served in at least 2 restaurants	( call SW.listValue ( call SW.countComparative ( call SW.getProperty ( call SW.singleton en.food ) ( string ! type ) ) ( call SW.reverse ( string meals ) ) ( string >= ) ( number 2 ) ( call SW.getProperty ( call SW.singleton en.restaurant ) ( string ! type ) ) ) )	overnight-restaurants
find a thai restaurant with a 2 dollar price rating	( call SW.listValue ( call SW.filter ( call SW.filter ( call SW.getProperty ( call SW.singleton en.restaurant ) ( string ! type ) ) ( string cuisine ) ( string = ) en.cuisine.thai ) ( string price_rating ) ( string = ) ( number 2 en.dollar_sign ) ) )	overnight-restaurants
what is the neighborhood of the thai restaurant	( call SW.listValue ( call SW.filter ( call SW.getProperty ( call SW.singleton en.neighborhood ) ( string ! type ) ) ( call SW.reverse ( string neighborhood ) ) ( string = ) ( call SW.filter ( call SW.getProperty ( call SW.singleton en.restaurant ) ( string ! type ) ) ( string cuisine ) ( string = ) en.cuisine.thai ) ) )	overnight-restaurants
what restaurant offers reservations and is good for kids	( call SW.listValue ( call SW.filter ( call SW.filter ( call SW.getProperty ( call SW.singleton en.restaurant ) ( string ! type ) ) ( string kids ) ) ( string reserve ) ) )	overnight-restaurants
what neighborhoods have restaurants that accept reservations	( call SW.listValue ( call SW.filter ( call SW.getProperty ( call SW.singleton en.neighborhood ) ( string ! type ) ) ( call SW.reverse ( string neighborhood ) ) ( string = ) ( call SW.filter ( call SW.getProperty ( call SW.singleton en.restaurant ) ( string ! type ) ) ( string reserve ) ) ) )	overnight-restaurants
what good kids restaurant is in the midtown west area	( call SW.listValue ( call SW.filter ( call SW.filter ( call SW.getProperty ( call SW.singleton en.restaurant ) ( string ! type ) ) ( string kids ) ) ( string neighborhood ) ( string = ) en.neighborhood.midtown_west ) )	overnight-restaurants
restaurant that has delivery and that takes reservations	( call SW.listValue ( call SW.filter ( call SW.filter ( call SW.getProperty ( call SW.singleton en.restaurant ) ( string ! type ) ) ( string delivery ) ) ( string reserve ) ) )	overnight-restaurants
list all restaurants that are at least 3 stars	( call SW.listValue ( call SW.filter ( call SW.getProperty ( call SW.singleton en.restaurant ) ( string ! type ) ) ( call SW.ensureNumericProperty ( string star_rating ) ) ( string <= ) ( call SW.ensureNumericEntity ( number 3 en.star ) ) ) )	overnight-restaurants
what good kids restaurant has delivery	( call SW.listValue ( call SW.filter ( call SW.filter ( call SW.getProperty ( call SW.singleton en.restaurant ) ( string ! type ) ) ( string delivery ) ) ( string kids ) ) )	overnight-restaurants
restaurants that accept credit cards and reservations	( call SW.listValue ( call SW.filter ( call SW.filter ( call SW.getProperty ( call SW.singleton en.restaurant ) ( string ! type ) ) ( string credit ) ) ( string reserve ) ) )	overnight-restaurants
hotel that has the minimum star rating	( call SW.listValue ( call SW.superlative ( call SW.getProperty ( call SW.singleton en.restaurant ) ( string ! type ) ) ( string min ) ( call SW.ensureNumericProperty ( string star_rating ) ) ) )	overnight-restaurants
midtown west restaurant that is open for lunch	( call SW.listValue ( call SW.filter ( call SW.filter ( call SW.getProperty ( call SW.singleton en.restaurant ) ( string ! type ) ) ( string neighborhood ) ( string = ) en.neighborhood.midtown_west ) ( string meals ) ( string = ) en.food.lunch ) )	overnight-restaurants
restaurants for two	( call SW.listValue ( call SW.countComparative ( call SW.getProperty ( call SW.singleton en.restaurant ) ( string ! type ) ) ( string meals ) ( string = ) ( number 2 ) ( call SW.getProperty ( call SW.singleton en.food ) ( string ! type ) ) ) )	overnight-restaurants
restaurant with a 2 or 3 dollar price rating	( call SW.listValue ( call SW.filter ( call SW.getProperty ( call SW.singleton en.restaurant ) ( string ! type ) ) ( string price_rating ) ( string = ) ( call SW.concat ( number 2 en.dollar_sign ) ( number 3 en.dollar_sign ) ) ) )	overnight-restaurants
restaurant that can deliver and is open for lunch	( call SW.listValue ( call SW.filter ( call SW.filter ( call SW.getProperty ( call SW.singleton en.restaurant ) ( string ! type ) ) ( string meals ) ( string = ) en.food.lunch ) ( string delivery ) ) )	overnight-restaurants
restaurants in the 2 dollar sign price category that accept credit cards	( call SW.listValue ( call SW.filter ( call SW.filter ( call SW.getProperty ( call SW.singleton en.restaurant ) ( string ! type ) ) ( string price_rating ) ( string = ) ( number 2 en.dollar_sign ) ) ( string credit ) ) )	overnight-restaurants
hotel in the area of midtown west which serves lunch	( call SW.listValue ( call SW.filter ( call SW.filter ( call SW.getProperty ( call SW.singleton en.restaurant ) ( string ! type ) ) ( string meals ) ( string = ) en.food.lunch ) ( string neighborhood ) ( string = ) en.neighborhood.midtown_west ) )	overnight-restaurants
what meal does the restaurant with a 2 dollar price rating serve	( call SW.listValue ( call SW.filter ( call SW.getProperty ( call SW.singleton en.food ) ( string ! type ) ) ( call SW.reverse ( string meals ) ) ( string = ) ( call SW.filter ( call SW.getProperty ( call SW.singleton en.restaurant ) ( string ! type ) ) ( string price_rating ) ( string = ) ( number 2 en.dollar_sign ) ) ) )	overnight-restaurants
restaurants with outdoor dining area	( call SW.listValue ( call SW.filter ( call SW.getProperty ( call SW.singleton en.restaurant ) ( string ! type ) ) ( string outdoor ) ) )	overnight-restaurants
list all restaurants that areworse than 3 or 5 star rated restaurants	( call SW.listValue ( call SW.filter ( call SW.getProperty ( call SW.singleton en.restaurant ) ( string ! type ) ) ( call SW.ensureNumericProperty ( string star_rating ) ) ( string < ) ( call SW.ensureNumericEntity ( call SW.concat ( number 3 en.star ) ( number 5 en.star ) ) ) ) )	overnight-restaurants
what 2 dollar sign restaurant contains takeout	( call SW.listValue ( call SW.filter ( call SW.filter ( call SW.getProperty ( call SW.singleton en.restaurant ) ( string ! type ) ) ( string takeout ) ) ( string price_rating ) ( string = ) ( number 2 en.dollar_sign ) ) )	overnight-restaurants
what restaurant offers outdoor seating and takeout	( call SW.listValue ( call SW.filter ( call SW.filter ( call SW.getProperty ( call SW.singleton en.restaurant ) ( string ! type ) ) ( string takeout ) ) ( string outdoor ) ) )	overnight-restaurants
restaurants that can be booked in advance ant which de	( call SW.listValue ( call SW.filter ( call SW.filter ( call SW.getProperty ( call SW.singleton en.restaurant ) ( string ! type ) ) ( string kids ) ) ( string reserve ) ) )	overnight-restaurants
name a hotel which has a three star rating and good for group dining	( call SW.listValue ( call SW.filter ( call SW.filter ( call SW.getProperty ( call SW.singleton en.restaurant ) ( string ! type ) ) ( string star_rating ) ( string = ) ( number 3 en.star ) ) ( string groups ) ) )	overnight-restaurants
list all restaurants with 3 or 5 star ratings	( call SW.listValue ( call SW.filter ( call SW.getProperty ( call SW.singleton en.restaurant ) ( string ! type ) ) ( call SW.ensureNumericProperty ( string star_rating ) ) ( string >= ) ( call SW.ensureNumericEntity ( call SW.concat ( number 3 en.star ) ( number 5 en.star ) ) ) ) )	overnight-restaurants
what restaurant serves lunch and offers takeout	( call SW.listValue ( call SW.filter ( call SW.filter ( call SW.getProperty ( call SW.singleton en.restaurant ) ( string ! type ) ) ( string meals ) ( string = ) en.food.lunch ) ( string takeout ) ) )	overnight-restaurants
what restaurants serve at least two meals	( call SW.listValue ( call SW.countComparative ( call SW.getProperty ( call SW.singleton en.restaurant ) ( string ! type ) ) ( string meals ) ( string >= ) ( number 2 ) ( call SW.getProperty ( call SW.singleton en.food ) ( string ! type ) ) ) )	overnight-restaurants
what restaurant can you eat lunch outside at	( call SW.listValue ( call SW.filter ( call SW.filter ( call SW.getProperty ( call SW.singleton en.restaurant ) ( string ! type ) ) ( string outdoor ) ) ( string meals ) ( string = ) en.food.lunch ) )	overnight-restaurants
restaurant that serves lunch in midtown west	( call SW.listValue ( call SW.filter ( call SW.filter ( call SW.getProperty ( call SW.singleton en.restaurant ) ( string ! type ) ) ( string meals ) ( string = ) en.food.lunch ) ( string neighborhood ) ( string = ) en.neighborhood.midtown_west ) )	overnight-restaurants
what neighborhood has the least amount of restaurants	( call SW.listValue ( call SW.countSuperlative ( call SW.getProperty ( call SW.singleton en.neighborhood ) ( string ! type ) ) ( string min ) ( call SW.reverse ( string neighborhood ) ) ( call SW.getProperty ( call SW.singleton en.restaurant ) ( string ! type ) ) ) )	overnight-restaurants
restaurants good for kids and has waiters	( call SW.listValue ( call SW.filter ( call SW.filter ( call SW.getProperty ( call SW.singleton en.restaurant ) ( string ! type ) ) ( string kids ) ) ( string waiter ) ) )	overnight-restaurants
a fairly inexpensive thai cuisine can be purchased at this restaurant	( call SW.listValue ( call SW.filter ( call SW.filter ( call SW.getProperty ( call SW.singleton en.restaurant ) ( string ! type ) ) ( string cuisine ) ( string = ) en.cuisine.thai ) ( string price_rating ) ( string = ) ( number 2 en.dollar_sign ) ) )	overnight-restaurants
thai restaurants that have takeout	( call SW.listValue ( call SW.filter ( call SW.filter ( call SW.getProperty ( call SW.singleton en.restaurant ) ( string ! type ) ) ( string cuisine ) ( string = ) en.cuisine.thai ) ( string takeout ) ) )	overnight-restaurants
restaurant that takes reservations and that has delivery	( call SW.listValue ( call SW.filter ( call SW.filter ( call SW.getProperty ( call SW.singleton en.restaurant ) ( string ! type ) ) ( string reserve ) ) ( string delivery ) ) )	overnight-restaurants
which restaurant has a price rating of two dollar signs and has outdoor seating	( call SW.listValue ( call SW.filter ( call SW.filter ( call SW.getProperty ( call SW.singleton en.restaurant ) ( string ! type ) ) ( string price_rating ) ( string = ) ( number 2 en.dollar_sign ) ) ( string outdoor ) ) )	overnight-restaurants
restaurant that has delivery and that has takeout	( call SW.listValue ( call SW.filter ( call SW.filter ( call SW.getProperty ( call SW.singleton en.restaurant ) ( string ! type ) ) ( string delivery ) ) ( string takeout ) ) )	overnight-restaurants
what thai restaurants takes reservations	( call SW.listValue ( call SW.filter ( call SW.filter ( call SW.getProperty ( call SW.singleton en.restaurant ) ( string ! type ) ) ( string cuisine ) ( string = ) en.cuisine.thai ) ( string reserve ) ) )	overnight-restaurants
groupfriendly restaurants	( call SW.listValue ( call SW.filter ( call SW.getProperty ( call SW.singleton en.restaurant ) ( string ! type ) ) ( string groups ) ) )	overnight-restaurants
what restaurant serves less than two meals	( call SW.listValue ( call SW.countComparative ( call SW.getProperty ( call SW.singleton en.restaurant ) ( string ! type ) ) ( string meals ) ( string < ) ( number 2 ) ( call SW.getProperty ( call SW.singleton en.food ) ( string ! type ) ) ) )	overnight-restaurants
what is the cuisine of restaurants that have waiters	( call SW.listValue ( call SW.filter ( call SW.getProperty ( call SW.singleton en.cuisine ) ( string ! type ) ) ( call SW.reverse ( string cuisine ) ) ( string = ) ( call SW.filter ( call SW.getProperty ( call SW.singleton en.restaurant ) ( string ! type ) ) ( string waiter ) ) ) )	overnight-restaurants
list all restaurants that have the same or better price rating than thai cafe	( call SW.listValue ( call SW.filter ( call SW.getProperty ( call SW.singleton en.restaurant ) ( string ! type ) ) ( call SW.ensureNumericProperty ( string price_rating ) ) ( string >= ) ( call SW.ensureNumericEntity ( call SW.getProperty en.restaurant.thai_cafe ( string price_rating ) ) ) ) )	overnight-restaurants
restaurant whose star rating is smaller than 3 stars or 5 stars	( call SW.listValue ( call SW.filter ( call SW.getProperty ( call SW.singleton en.restaurant ) ( string ! type ) ) ( call SW.ensureNumericProperty ( string star_rating ) ) ( string < ) ( call SW.ensureNumericEntity ( call SW.concat ( number 3 en.star ) ( number 5 en.star ) ) ) ) )	overnight-restaurants
restaurant that has delivery	( call SW.listValue ( call SW.filter ( call SW.getProperty ( call SW.singleton en.restaurant ) ( string ! type ) ) ( string delivery ) ) )	overnight-restaurants
restaurant that delivers and offers outside seating	( call SW.listValue ( call SW.filter ( call SW.filter ( call SW.getProperty ( call SW.singleton en.restaurant ) ( string ! type ) ) ( string delivery ) ) ( string outdoor ) ) )	overnight-restaurants
total price rating of restaurant	( call SW.listValue ( call SW.aggregate ( string sum ) ( call SW.getProperty ( call SW.getProperty ( call SW.singleton en.restaurant ) ( string ! type ) ) ( string price_rating ) ) ) )	overnight-restaurants
what restaurant offers lunch and is good for groups	( call SW.listValue ( call SW.filter ( call SW.filter ( call SW.getProperty ( call SW.singleton en.restaurant ) ( string ! type ) ) ( string groups ) ) ( string meals ) ( string = ) en.food.lunch ) )	overnight-restaurants
great place for groups and takes reservations	( call SW.listValue ( call SW.filter ( call SW.filter ( call SW.getProperty ( call SW.singleton en.restaurant ) ( string ! type ) ) ( string reserve ) ) ( string groups ) ) )	overnight-restaurants
what thai restaurant takes credit cards	( call SW.listValue ( call SW.filter ( call SW.filter ( call SW.getProperty ( call SW.singleton en.restaurant ) ( string ! type ) ) ( string credit ) ) ( string cuisine ) ( string = ) en.cuisine.thai ) )	overnight-restaurants
what restaurant has the largest menu	( call SW.listValue ( call SW.countSuperlative ( call SW.getProperty ( call SW.singleton en.restaurant ) ( string ! type ) ) ( string max ) ( string meals ) ( call SW.getProperty ( call SW.singleton en.food ) ( string ! type ) ) ) )	overnight-restaurants
list restaurants that are at or less than 2 or 3 dollar signs	( call SW.listValue ( call SW.filter ( call SW.getProperty ( call SW.singleton en.restaurant ) ( string ! type ) ) ( call SW.ensureNumericProperty ( string price_rating ) ) ( string <= ) ( call SW.ensureNumericEntity ( call SW.concat ( number 2 en.dollar_sign ) ( number 3 en.dollar_sign ) ) ) ) )	overnight-restaurants
what 2 dollar signs restaurant offers delivery	( call SW.listValue ( call SW.filter ( call SW.filter ( call SW.getProperty ( call SW.singleton en.restaurant ) ( string ! type ) ) ( string delivery ) ) ( string price_rating ) ( string = ) ( number 2 en.dollar_sign ) ) )	overnight-restaurants
what restaurants have takeout and are kidfriendly	( call SW.listValue ( call SW.filter ( call SW.filter ( call SW.getProperty ( call SW.singleton en.restaurant ) ( string ! type ) ) ( string takeout ) ) ( string kids ) ) )	overnight-restaurants
three star restaurants that take credit cards	( call SW.listValue ( call SW.filter ( call SW.filter ( call SW.getProperty ( call SW.singleton en.restaurant ) ( string ! type ) ) ( string credit ) ) ( string star_rating ) ( string = ) ( number 3 en.star ) ) )	overnight-restaurants
restaurants in midtown west with an outdoor dining area	( call SW.listValue ( call SW.filter ( call SW.filter ( call SW.getProperty ( call SW.singleton en.restaurant ) ( string ! type ) ) ( string neighborhood ) ( string = ) en.neighborhood.midtown_west ) ( string outdoor ) ) )	overnight-restaurants
italian or thai	( call SW.listValue ( call SW.concat en.cuisine.thai en.cuisine.italian ) )	overnight-restaurants
which neighborhoods have restaurants that serve lunch	( call SW.listValue ( call SW.filter ( call SW.getProperty ( call SW.singleton en.neighborhood ) ( string ! type ) ) ( call SW.reverse ( string neighborhood ) ) ( string = ) ( call SW.filter ( call SW.getProperty ( call SW.singleton en.restaurant ) ( string ! type ) ) ( string meals ) ( string = ) en.food.lunch ) ) )	overnight-restaurants
restaurant that takes credit cards and that is good for kids	( call SW.listValue ( call SW.filter ( call SW.filter ( call SW.getProperty ( call SW.singleton en.restaurant ) ( string ! type ) ) ( string credit ) ) ( string kids ) ) )	overnight-restaurants
restaurant whose neighborhood is midtown west and that takes reservations	( call SW.listValue ( call SW.filter ( call SW.filter ( call SW.getProperty ( call SW.singleton en.restaurant ) ( string ! type ) ) ( string neighborhood ) ( string = ) en.neighborhood.midtown_west ) ( string reserve ) ) )	overnight-restaurants
what restaurant offers delivery and takes credit card	( call SW.listValue ( call SW.filter ( call SW.filter ( call SW.getProperty ( call SW.singleton en.restaurant ) ( string ! type ) ) ( string credit ) ) ( string delivery ) ) )	overnight-restaurants
what restaurant is good for groups and takes reservations	( call SW.listValue ( call SW.filter ( call SW.filter ( call SW.getProperty ( call SW.singleton en.restaurant ) ( string ! type ) ) ( string reserve ) ) ( string groups ) ) )	overnight-restaurants
cuisine that is cuisine of restaurant that takes reservations	( call SW.listValue ( call SW.filter ( call SW.getProperty ( call SW.singleton en.cuisine ) ( string ! type ) ) ( call SW.reverse ( string cuisine ) ) ( string = ) ( call SW.filter ( call SW.getProperty ( call SW.singleton en.restaurant ) ( string ! type ) ) ( string reserve ) ) ) )	overnight-restaurants
restaurant that has at least 3 star rating	( call SW.listValue ( call SW.filter ( call SW.getProperty ( call SW.singleton en.restaurant ) ( string ! type ) ) ( call SW.ensureNumericProperty ( string star_rating ) ) ( string >= ) ( call SW.ensureNumericEntity ( number 3 en.star ) ) ) )	overnight-restaurants
restaurants that accept credit cards and serve outdoors	( call SW.listValue ( call SW.filter ( call SW.filter ( call SW.getProperty ( call SW.singleton en.restaurant ) ( string ! type ) ) ( string credit ) ) ( string outdoor ) ) )	overnight-restaurants
what restaurant serves two meals	( call SW.listValue ( call SW.countComparative ( call SW.getProperty ( call SW.singleton en.food ) ( string ! type ) ) ( call SW.reverse ( string meals ) ) ( string = ) ( number 2 ) ( call SW.getProperty ( call SW.singleton en.restaurant ) ( string ! type ) ) ) )	overnight-restaurants
a restaurant that does not serve thai	( call SW.listValue ( call SW.filter ( call SW.getProperty ( call SW.singleton en.restaurant ) ( string ! type ) ) ( string cuisine ) ( string ! = ) en.cuisine.thai ) )	overnight-restaurants
restaurants that accepts reservations	( call SW.listValue ( call SW.filter ( call SW.getProperty ( call SW.singleton en.food ) ( string ! type ) ) ( call SW.reverse ( string meals ) ) ( string = ) ( call SW.filter ( call SW.getProperty ( call SW.singleton en.restaurant ) ( string ! type ) ) ( string reserve ) ) ) )	overnight-restaurants
restaurant that takes reservations and that is good for kids	( call SW.listValue ( call SW.filter ( call SW.filter ( call SW.getProperty ( call SW.singleton en.restaurant ) ( string ! type ) ) ( string reserve ) ) ( string kids ) ) )	overnight-restaurants
what is a 3 star restaurant that is kid friendly	( call SW.listValue ( call SW.filter ( call SW.filter ( call SW.getProperty ( call SW.singleton en.restaurant ) ( string ! type ) ) ( string waiter ) ) ( string star_rating ) ( string = ) ( number 3 en.star ) ) )	overnight-restaurants
what cuisine offers takeout	( call SW.listValue ( call SW.filter ( call SW.getProperty ( call SW.singleton en.cuisine ) ( string ! type ) ) ( call SW.reverse ( string cuisine ) ) ( string = ) ( call SW.filter ( call SW.getProperty ( call SW.singleton en.restaurant ) ( string ! type ) ) ( string takeout ) ) ) )	overnight-restaurants
what restaurant has the smallest number of cuisines	( call SW.listValue ( call SW.countSuperlative ( call SW.getProperty ( call SW.singleton en.restaurant ) ( string ! type ) ) ( string min ) ( string cuisine ) ) )	overnight-restaurants
restaurant that has outdoor seating	( call SW.listValue ( call SW.filter ( call SW.getProperty ( call SW.singleton en.food ) ( string ! type ) ) ( call SW.reverse ( string meals ) ) ( string = ) ( call SW.filter ( call SW.getProperty ( call SW.singleton en.restaurant ) ( string ! type ) ) ( string outdoor ) ) ) )	overnight-restaurants
what restaurant in midtown west contains outdoor seating	( call SW.listValue ( call SW.filter ( call SW.filter ( call SW.getProperty ( call SW.singleton en.restaurant ) ( string ! type ) ) ( string outdoor ) ) ( string neighborhood ) ( string = ) en.neighborhood.midtown_west ) )	overnight-restaurants
restaurant that has delivery and that has outdoor seating	( call SW.listValue ( call SW.filter ( call SW.filter ( call SW.getProperty ( call SW.singleton en.restaurant ) ( string ! type ) ) ( string delivery ) ) ( string outdoor ) ) )	overnight-restaurants
restaurants with a smaller star rating than thai cafe	( call SW.listValue ( call SW.filter ( call SW.getProperty ( call SW.singleton en.restaurant ) ( string ! type ) ) ( call SW.ensureNumericProperty ( string star_rating ) ) ( string < ) ( call SW.ensureNumericEntity ( call SW.getProperty en.restaurant.thai_cafe ( string star_rating ) ) ) ) )	overnight-restaurants
restaurant that has takeout and that has delivery	( call SW.listValue ( call SW.filter ( call SW.filter ( call SW.getProperty ( call SW.singleton en.restaurant ) ( string ! type ) ) ( string takeout ) ) ( string delivery ) ) )	overnight-restaurants
what thai restaurant has a 3 star rating	( call SW.listValue ( call SW.filter ( call SW.filter ( call SW.getProperty ( call SW.singleton en.restaurant ) ( string ! type ) ) ( string star_rating ) ( string = ) ( number 3 en.star ) ) ( string cuisine ) ( string = ) en.cuisine.thai ) )	overnight-restaurants
a 3 star restaurant that is good for kids	( call SW.listValue ( call SW.filter ( call SW.filter ( call SW.getProperty ( call SW.singleton en.restaurant ) ( string ! type ) ) ( string star_rating ) ( string = ) ( number 3 en.star ) ) ( string kids ) ) )	overnight-restaurants
a thai cafe in the neighborhood	( call SW.listValue ( call SW.filter ( call SW.filter ( call SW.getProperty ( call SW.singleton en.neighborhood ) ( string ! type ) ) ( call SW.reverse ( string neighborhood ) ) ( string = ) en.restaurant.thai_cafe ) ( call SW.reverse ( string neighborhood ) ) ( string = ) en.restaurant.thai_cafe ) )	overnight-restaurants
restaurant that serves lunch and whose cuisine is thai	( call SW.listValue ( call SW.filter ( call SW.filter ( call SW.getProperty ( call SW.singleton en.restaurant ) ( string ! type ) ) ( string meals ) ( string = ) en.food.lunch ) ( string cuisine ) ( string = ) en.cuisine.thai ) )	overnight-restaurants
what restaurant has a star rating the same as thai cafe	( call SW.listValue ( call SW.filter ( call SW.getProperty ( call SW.singleton en.restaurant ) ( string ! type ) ) ( call SW.ensureNumericProperty ( string star_rating ) ) ( string >= ) ( call SW.ensureNumericEntity ( call SW.getProperty en.restaurant.thai_cafe ( string star_rating ) ) ) ) )	overnight-restaurants
what meals do the thai cafe serve	( call SW.listValue ( call SW.filter ( call SW.filter ( call SW.getProperty ( call SW.singleton en.food ) ( string ! type ) ) ( call SW.reverse ( string meals ) ) ( string = ) en.restaurant.thai_cafe ) ( call SW.reverse ( string meals ) ) ( string = ) en.restaurant.thai_cafe ) )	overnight-restaurants
restaurant that has the least number of neighborhood	( call SW.listValue ( call SW.countSuperlative ( call SW.getProperty ( call SW.singleton en.restaurant ) ( string ! type ) ) ( string min ) ( string neighborhood ) ) )	overnight-restaurants
what resturant is not in midtown west	( call SW.listValue ( call SW.filter ( call SW.getProperty ( call SW.singleton en.restaurant ) ( string ! type ) ) ( string neighborhood ) ( string ! = ) en.neighborhood.midtown_west ) )	overnight-restaurants
restaurant that not serves lunch	( call SW.listValue ( call SW.filter ( call SW.getProperty ( call SW.singleton en.restaurant ) ( string ! type ) ) ( string meals ) ( string ! = ) en.food.lunch ) )	overnight-restaurants
restaurant that has takeout and that has outdoor seating	( call SW.listValue ( call SW.filter ( call SW.filter ( call SW.getProperty ( call SW.singleton en.restaurant ) ( string ! type ) ) ( string takeout ) ) ( string outdoor ) ) )	overnight-restaurants
what neighborhood has restaurants that serve lunch	( call SW.listValue ( call SW.filter ( call SW.getProperty ( call SW.singleton en.neighborhood ) ( string ! type ) ) ( call SW.reverse ( string neighborhood ) ) ( string = ) ( call SW.filter ( call SW.getProperty ( call SW.singleton en.restaurant ) ( string ! type ) ) ( string meals ) ( string = ) en.food.lunch ) ) )	overnight-restaurants
midtown west neighborhood restaurant with 3 star ratings	( call SW.listValue ( call SW.filter ( call SW.filter ( call SW.getProperty ( call SW.singleton en.restaurant ) ( string ! type ) ) ( string neighborhood ) ( string = ) en.neighborhood.midtown_west ) ( string star_rating ) ( string = ) ( number 3 en.star ) ) )	overnight-restaurants
what good kids restaurant has a 2 dollar price rating	( call SW.listValue ( call SW.filter ( call SW.filter ( call SW.getProperty ( call SW.singleton en.restaurant ) ( string ! type ) ) ( string kids ) ) ( string price_rating ) ( string = ) ( number 2 en.dollar_sign ) ) )	overnight-restaurants
group friendly restaurants rated 3 stars	( call SW.listValue ( call SW.filter ( call SW.filter ( call SW.getProperty ( call SW.singleton en.restaurant ) ( string ! type ) ) ( string groups ) ) ( string star_rating ) ( string = ) ( number 3 en.star ) ) )	overnight-restaurants
what neighborhood with the most restaurants	( call SW.listValue ( call SW.countSuperlative ( call SW.getProperty ( call SW.singleton en.neighborhood ) ( string ! type ) ) ( string max ) ( call SW.reverse ( string neighborhood ) ) ( call SW.getProperty ( call SW.singleton en.restaurant ) ( string ! type ) ) ) )	overnight-restaurants
what restaurants have both outdoor seating and takeout	( call SW.listValue ( call SW.filter ( call SW.filter ( call SW.getProperty ( call SW.singleton en.restaurant ) ( string ! type ) ) ( string takeout ) ) ( string outdoor ) ) )	overnight-restaurants
what restaurants have outdoor dining and are childfriendly	( call SW.listValue ( call SW.filter ( call SW.filter ( call SW.getProperty ( call SW.singleton en.restaurant ) ( string ! type ) ) ( string kids ) ) ( string outdoor ) ) )	overnight-restaurants
what restaurants have at least a 3 star rating	( call SW.listValue ( call SW.filter ( call SW.getProperty ( call SW.singleton en.restaurant ) ( string ! type ) ) ( string star_rating ) ( string = ) ( number 3 en.star ) ) )	overnight-restaurants
what neighborhood is home to the most restaurants	( call SW.listValue ( call SW.countSuperlative ( call SW.getProperty ( call SW.singleton en.neighborhood ) ( string ! type ) ) ( string max ) ( call SW.reverse ( string neighborhood ) ) ( call SW.getProperty ( call SW.singleton en.restaurant ) ( string ! type ) ) ) )	overnight-restaurants
which restaurant is located in midtown west	( call SW.listValue ( call SW.filter ( call SW.getProperty ( call SW.singleton en.restaurant ) ( string ! type ) ) ( string neighborhood ) ( string = ) en.neighborhood.midtown_west ) )	overnight-restaurants
restaurant that serves lunch and takes reservations	( call SW.listValue ( call SW.filter ( call SW.filter ( call SW.getProperty ( call SW.singleton en.restaurant ) ( string ! type ) ) ( string meals ) ( string = ) en.food.lunch ) ( string reserve ) ) )	overnight-restaurants
what is the price rating of the thai cafe	( call SW.listValue ( call SW.getProperty en.restaurant.thai_cafe ( string price_rating ) ) )	overnight-restaurants
what neighborhood are the restaurants that are in midtown west	( call SW.listValue ( call SW.filter ( call SW.getProperty ( call SW.singleton en.neighborhood ) ( string ! type ) ) ( call SW.reverse ( string neighborhood ) ) ( string = ) ( call SW.filter ( call SW.getProperty ( call SW.singleton en.restaurant ) ( string ! type ) ) ( string neighborhood ) ( string = ) en.neighborhood.midtown_west ) ) )	overnight-restaurants
cheapest restaurants	( call SW.listValue ( call SW.superlative ( call SW.getProperty ( call SW.singleton en.restaurant ) ( string ! type ) ) ( string min ) ( call SW.ensureNumericProperty ( string price_rating ) ) ) )	overnight-restaurants
restaurants that is in the least numbers of neighborhoods	( call SW.listValue ( call SW.countSuperlative ( call SW.getProperty ( call SW.singleton en.restaurant ) ( string ! type ) ) ( string min ) ( string neighborhood ) ) )	overnight-restaurants
what restaurant takes reservations and has takeout	( call SW.listValue ( call SW.filter ( call SW.filter ( call SW.getProperty ( call SW.singleton en.restaurant ) ( string ! type ) ) ( string reserve ) ) ( string takeout ) ) )	overnight-restaurants
what restaurant offers delivery and has waiter service	( call SW.listValue ( call SW.filter ( call SW.filter ( call SW.getProperty ( call SW.singleton en.restaurant ) ( string ! type ) ) ( string waiter ) ) ( string delivery ) ) )	overnight-restaurants
what restaurant has waiter service and serves lunch	( call SW.listValue ( call SW.filter ( call SW.filter ( call SW.getProperty ( call SW.singleton en.restaurant ) ( string ! type ) ) ( string waiter ) ) ( string meals ) ( string = ) en.food.lunch ) )	overnight-restaurants
restaurant that has the  take out facility and has outdoor seating	( call SW.listValue ( call SW.filter ( call SW.filter ( call SW.getProperty ( call SW.singleton en.restaurant ) ( string ! type ) ) ( string outdoor ) ) ( string takeout ) ) )	overnight-restaurants
find a restaurant i can get reservations at that has a 2 dollar price rating	( call SW.listValue ( call SW.filter ( call SW.filter ( call SW.getProperty ( call SW.singleton en.restaurant ) ( string ! type ) ) ( string reserve ) ) ( string price_rating ) ( string = ) ( number 2 en.dollar_sign ) ) )	overnight-restaurants
restaurant that is good for kids and that takes reservations	( call SW.listValue ( call SW.filter ( call SW.filter ( call SW.getProperty ( call SW.singleton en.restaurant ) ( string ! type ) ) ( string kids ) ) ( string reserve ) ) )	overnight-restaurants
what restaurant has takeout and a lunch menu	( call SW.listValue ( call SW.filter ( call SW.filter ( call SW.getProperty ( call SW.singleton en.restaurant ) ( string ! type ) ) ( string meals ) ( string = ) en.food.lunch ) ( string takeout ) ) )	overnight-restaurants
what restaurant has takeout and waiter service	( call SW.listValue ( call SW.filter ( call SW.filter ( call SW.getProperty ( call SW.singleton en.restaurant ) ( string ! type ) ) ( string waiter ) ) ( string takeout ) ) )	overnight-restaurants
name some thai restaurants meant for group dining	( call SW.listValue ( call SW.filter ( call SW.filter ( call SW.getProperty ( call SW.singleton en.restaurant ) ( string ! type ) ) ( string groups ) ) ( string cuisine ) ( string = ) en.cuisine.thai ) )	overnight-restaurants
hotel  that that has the star rating of thai cafe	( call SW.listValue ( call SW.filter ( call SW.getProperty ( call SW.singleton en.restaurant ) ( string ! type ) ) ( call SW.ensureNumericProperty ( string star_rating ) ) ( string <= ) ( call SW.ensureNumericEntity ( call SW.getProperty en.restaurant.thai_cafe ( string star_rating ) ) ) ) )	overnight-restaurants
what meal is good to be served for groups	( call SW.listValue ( call SW.filter ( call SW.getProperty ( call SW.singleton en.food ) ( string ! type ) ) ( call SW.reverse ( string meals ) ) ( string = ) ( call SW.filter ( call SW.getProperty ( call SW.singleton en.restaurant ) ( string ! type ) ) ( string groups ) ) ) )	overnight-restaurants
restaurants for groups and is in midtown west	( call SW.listValue ( call SW.filter ( call SW.filter ( call SW.getProperty ( call SW.singleton en.restaurant ) ( string ! type ) ) ( string groups ) ) ( string neighborhood ) ( string = ) en.neighborhood.midtown_west ) )	overnight-restaurants
which restaurants are rated the same or below thai cafe	( call SW.listValue ( call SW.filter ( call SW.getProperty ( call SW.singleton en.restaurant ) ( string ! type ) ) ( call SW.ensureNumericProperty ( string star_rating ) ) ( string <= ) ( call SW.ensureNumericEntity ( call SW.getProperty en.restaurant.thai_cafe ( string star_rating ) ) ) ) )	overnight-restaurants
restaurants with takeout that have waiters	( call SW.listValue ( call SW.filter ( call SW.filter ( call SW.getProperty ( call SW.singleton en.restaurant ) ( string ! type ) ) ( string takeout ) ) ( string waiter ) ) )	overnight-restaurants
what2 dollar sign restaurant has outdoor seating	( call SW.listValue ( call SW.filter ( call SW.filter ( call SW.getProperty ( call SW.singleton en.restaurant ) ( string ! type ) ) ( string outdoor ) ) ( string price_rating ) ( string = ) ( number 2 en.dollar_sign ) ) )	overnight-restaurants
restaurant that has waiter service and whose price rating is 2 dollar signs	( call SW.listValue ( call SW.filter ( call SW.filter ( call SW.getProperty ( call SW.singleton en.restaurant ) ( string ! type ) ) ( string waiter ) ) ( string price_rating ) ( string = ) ( number 2 en.dollar_sign ) ) )	overnight-restaurants
restaurants with takeout that are group friendly	( call SW.listValue ( call SW.filter ( call SW.filter ( call SW.getProperty ( call SW.singleton en.restaurant ) ( string ! type ) ) ( string takeout ) ) ( string groups ) ) )	overnight-restaurants
restaurant whose star rating is at least 3 stars or 5 stars	( call SW.listValue ( call SW.filter ( call SW.getProperty ( call SW.singleton en.restaurant ) ( string ! type ) ) ( call SW.ensureNumericProperty ( string star_rating ) ) ( string >= ) ( call SW.ensureNumericEntity ( call SW.concat ( number 3 en.star ) ( number 5 en.star ) ) ) ) )	overnight-restaurants
restaurants that take credit cards and serve lunch	( call SW.listValue ( call SW.filter ( call SW.filter ( call SW.getProperty ( call SW.singleton en.restaurant ) ( string ! type ) ) ( string credit ) ) ( string meals ) ( string = ) en.food.lunch ) )	overnight-restaurants
hotel that offers lunch and best for group dining	( call SW.listValue ( call SW.filter ( call SW.filter ( call SW.getProperty ( call SW.singleton en.restaurant ) ( string ! type ) ) ( string groups ) ) ( string meals ) ( string = ) en.food.lunch ) )	overnight-restaurants
restaurant that has waiter service and that has delivery	( call SW.listValue ( call SW.filter ( call SW.filter ( call SW.getProperty ( call SW.singleton en.restaurant ) ( string ! type ) ) ( string waiter ) ) ( string delivery ) ) )	overnight-restaurants
what restaurant offers lunch and delivery	( call SW.listValue ( call SW.filter ( call SW.filter ( call SW.getProperty ( call SW.singleton en.restaurant ) ( string ! type ) ) ( string meals ) ( string = ) en.food.lunch ) ( string delivery ) ) )	overnight-restaurants
3 star restaurants which have waiters	( call SW.listValue ( call SW.filter ( call SW.filter ( call SW.getProperty ( call SW.singleton en.restaurant ) ( string ! type ) ) ( string star_rating ) ( string = ) ( number 3 en.star ) ) ( string waiter ) ) )	overnight-restaurants
which restaurants have takeout and delivery	( call SW.listValue ( call SW.filter ( call SW.filter ( call SW.getProperty ( call SW.singleton en.restaurant ) ( string ! type ) ) ( string takeout ) ) ( string delivery ) ) )	overnight-restaurants
what restaurants have outdoor dining	( call SW.listValue ( call SW.filter ( call SW.getProperty ( call SW.singleton en.restaurant ) ( string ! type ) ) ( string outdoor ) ) )	overnight-restaurants
what restaurant offers reservations	( call SW.listValue ( call SW.filter ( call SW.getProperty ( call SW.singleton en.restaurant ) ( string ! type ) ) ( string reserve ) ) )	overnight-restaurants
hotel that has waiter service  and take out facilities	( call SW.listValue ( call SW.filter ( call SW.filter ( call SW.getProperty ( call SW.singleton en.restaurant ) ( string ! type ) ) ( string waiter ) ) ( string takeout ) ) )	overnight-restaurants
what midtown west restaurant offers reservations	( call SW.listValue ( call SW.filter ( call SW.filter ( call SW.getProperty ( call SW.singleton en.restaurant ) ( string ! type ) ) ( string reserve ) ) ( string neighborhood ) ( string = ) en.neighborhood.midtown_west ) )	overnight-restaurants
restaurant that takes credit cards and whose price rating is 2 dollar signs	( call SW.listValue ( call SW.filter ( call SW.filter ( call SW.getProperty ( call SW.singleton en.restaurant ) ( string ! type ) ) ( string credit ) ) ( string price_rating ) ( string = ) ( number 2 en.dollar_sign ) ) )	overnight-restaurants
what restaurant has 3 stars and has a 2 menu	( call SW.listValue ( call SW.filter ( call SW.filter ( call SW.getProperty ( call SW.singleton en.restaurant ) ( string ! type ) ) ( string star_rating ) ( string = ) ( number 3 en.star ) ) ( string price_rating ) ( string = ) ( number 2 en.dollar_sign ) ) )	overnight-restaurants
what restaurants have at least 2 meals on the menu	( call SW.listValue ( call SW.countComparative ( call SW.getProperty ( call SW.singleton en.restaurant ) ( string ! type ) ) ( string meals ) ( string = ) ( number 2 ) ( call SW.getProperty ( call SW.singleton en.food ) ( string ! type ) ) ) )	overnight-restaurants
what is the star rating of the thai cafe	( call SW.listValue ( call SW.getProperty en.restaurant.thai_cafe ( string star_rating ) ) )	overnight-restaurants
what restaurants with 2 price rating also have waiter service	( call SW.listValue ( call SW.filter ( call SW.filter ( call SW.getProperty ( call SW.singleton en.restaurant ) ( string ! type ) ) ( string price_rating ) ( string = ) ( number 2 en.dollar_sign ) ) ( string waiter ) ) )	overnight-restaurants
name a restaurant in the neighbourhood of thai cafe	( call SW.listValue ( call SW.filter ( call SW.getProperty ( call SW.singleton en.restaurant ) ( string ! type ) ) ( string neighborhood ) ( string = ) ( call SW.filter ( call SW.getProperty ( call SW.singleton en.neighborhood ) ( string ! type ) ) ( call SW.reverse ( string neighborhood ) ) ( string = ) en.restaurant.thai_cafe ) ) )	overnight-restaurants
restaurant whose cuisine is thai and that has outdoor seating	( call SW.listValue ( call SW.filter ( call SW.filter ( call SW.getProperty ( call SW.singleton en.restaurant ) ( string ! type ) ) ( string cuisine ) ( string = ) en.cuisine.thai ) ( string outdoor ) ) )	overnight-restaurants
what restaurant is in two neighborhoods	( call SW.listValue ( call SW.countComparative ( call SW.getProperty ( call SW.singleton en.restaurant ) ( string ! type ) ) ( string neighborhood ) ( string = ) ( number 2 ) ) )	overnight-restaurants
restaurants rated less than 3 stars	( call SW.listValue ( call SW.filter ( call SW.getProperty ( call SW.singleton en.restaurant ) ( string ! type ) ) ( call SW.ensureNumericProperty ( string star_rating ) ) ( string < ) ( call SW.ensureNumericEntity ( number 3 en.star ) ) ) )	overnight-restaurants
has a 2 or 3 dollar sign rating	( call SW.listValue ( call SW.concat ( number 2 en.dollar_sign ) ( number 3 en.dollar_sign ) ) )	overnight-restaurants
a 3 star resturnt that has room for groups	( call SW.listValue ( call SW.filter ( call SW.filter ( call SW.getProperty ( call SW.singleton en.restaurant ) ( string ! type ) ) ( string star_rating ) ( string = ) ( number 3 en.star ) ) ( string groups ) ) )	overnight-restaurants
restaurants that have outdoor seating and are good for large parties	( call SW.listValue ( call SW.filter ( call SW.filter ( call SW.getProperty ( call SW.singleton en.restaurant ) ( string ! type ) ) ( string outdoor ) ) ( string groups ) ) )	overnight-restaurants
what restaurant is kid friendly and has takeout	( call SW.listValue ( call SW.filter ( call SW.filter ( call SW.getProperty ( call SW.singleton en.restaurant ) ( string ! type ) ) ( string kids ) ) ( string takeout ) ) )	overnight-restaurants
which restaurants have star ratings lower than the thai cafe	( call SW.listValue ( call SW.filter ( call SW.getProperty ( call SW.singleton en.restaurant ) ( string ! type ) ) ( call SW.ensureNumericProperty ( string star_rating ) ) ( string < ) ( call SW.ensureNumericEntity ( call SW.getProperty en.restaurant.thai_cafe ( string star_rating ) ) ) ) )	overnight-restaurants
restaurants that are deliver and are good for large parties	( call SW.listValue ( call SW.filter ( call SW.filter ( call SW.getProperty ( call SW.singleton en.restaurant ) ( string ! type ) ) ( string groups ) ) ( string delivery ) ) )	overnight-restaurants
what 2 dollar signs restaurant is good for kids	( call SW.listValue ( call SW.filter ( call SW.filter ( call SW.getProperty ( call SW.singleton en.restaurant ) ( string ! type ) ) ( string price_rating ) ( string = ) ( number 2 en.dollar_sign ) ) ( string kids ) ) )	overnight-restaurants
restaurants that take credit cards and are childfriendly	( call SW.listValue ( call SW.filter ( call SW.filter ( call SW.getProperty ( call SW.singleton en.restaurant ) ( string ! type ) ) ( string credit ) ) ( string kids ) ) )	overnight-restaurants
what restaurants are both good for groups and kids	( call SW.listValue ( call SW.filter ( call SW.filter ( call SW.getProperty ( call SW.singleton en.restaurant ) ( string ! type ) ) ( string kids ) ) ( string groups ) ) )	overnight-restaurants
what kind of meals are served by restaurants that take reservations	( call SW.listValue ( call SW.filter ( call SW.getProperty ( call SW.singleton en.food ) ( string ! type ) ) ( call SW.reverse ( string meals ) ) ( string = ) ( call SW.filter ( call SW.getProperty ( call SW.singleton en.restaurant ) ( string ! type ) ) ( string reserve ) ) ) )	overnight-restaurants
which restaurants accept credit cards for payment and also have takeout service	( call SW.listValue ( call SW.filter ( call SW.filter ( call SW.getProperty ( call SW.singleton en.restaurant ) ( string ! type ) ) ( string credit ) ) ( string takeout ) ) )	overnight-restaurants
restaurants rated 3 stars	( call SW.listValue ( call SW.filter ( call SW.getProperty ( call SW.singleton en.restaurant ) ( string ! type ) ) ( string star_rating ) ( string = ) ( number 3 en.star ) ) )	overnight-restaurants
restaurants with lunch and takes reservations	( call SW.listValue ( call SW.filter ( call SW.filter ( call SW.getProperty ( call SW.singleton en.restaurant ) ( string ! type ) ) ( string meals ) ( string = ) en.food.lunch ) ( string reserve ) ) )	overnight-restaurants
what restaurant in midtown west has a rating of two dollar signs	( call SW.listValue ( call SW.filter ( call SW.filter ( call SW.getProperty ( call SW.singleton en.restaurant ) ( string ! type ) ) ( string neighborhood ) ( string = ) en.neighborhood.midtown_west ) ( string price_rating ) ( string = ) ( number 2 en.dollar_sign ) ) )	overnight-restaurants
restaurant whose star rating is 3 stars and whose price rating is 2 dollar signs	( call SW.listValue ( call SW.filter ( call SW.filter ( call SW.getProperty ( call SW.singleton en.restaurant ) ( string ! type ) ) ( string star_rating ) ( string = ) ( number 3 en.star ) ) ( string price_rating ) ( string = ) ( number 2 en.dollar_sign ) ) )	overnight-restaurants
which restaurants are rated between 3 and 5 stars	( call SW.listValue ( call SW.filter ( call SW.getProperty ( call SW.singleton en.restaurant ) ( string ! type ) ) ( call SW.ensureNumericProperty ( string star_rating ) ) ( string >= ) ( call SW.ensureNumericEntity ( call SW.concat ( number 3 en.star ) ( number 5 en.star ) ) ) ) )	overnight-restaurants
find a good group restaurant with takeout	( call SW.listValue ( call SW.filter ( call SW.filter ( call SW.getProperty ( call SW.singleton en.restaurant ) ( string ! type ) ) ( string groups ) ) ( string takeout ) ) )	overnight-restaurants
what neighborhood contains restaurants that offer lunch	( call SW.listValue ( call SW.filter ( call SW.getProperty ( call SW.singleton en.neighborhood ) ( string ! type ) ) ( call SW.reverse ( string neighborhood ) ) ( string = ) ( call SW.filter ( call SW.getProperty ( call SW.singleton en.restaurant ) ( string ! type ) ) ( string meals ) ( string = ) en.food.lunch ) ) )	overnight-restaurants
what kind of cuisine has at least two restaurants	( call SW.listValue ( call SW.countComparative ( call SW.getProperty ( call SW.singleton en.cuisine ) ( string ! type ) ) ( call SW.reverse ( string cuisine ) ) ( string = ) ( number 2 ) ( call SW.getProperty ( call SW.singleton en.restaurant ) ( string ! type ) ) ) )	overnight-restaurants
family friendly restaurants where you can sit outside	( call SW.listValue ( call SW.filter ( call SW.filter ( call SW.getProperty ( call SW.singleton en.restaurant ) ( string ! type ) ) ( string kids ) ) ( string outdoor ) ) )	overnight-restaurants
what midtown west restaurants have a price rating of 2 dollar signs	( call SW.listValue ( call SW.filter ( call SW.filter ( call SW.getProperty ( call SW.singleton en.restaurant ) ( string ! type ) ) ( string neighborhood ) ( string = ) en.neighborhood.midtown_west ) ( string price_rating ) ( string = ) ( number 2 en.dollar_sign ) ) )	overnight-restaurants
restaurant whose price rating is 2 dollar signs and whose star rating is 3 stars	( call SW.listValue ( call SW.filter ( call SW.filter ( call SW.getProperty ( call SW.singleton en.restaurant ) ( string ! type ) ) ( string price_rating ) ( string = ) ( number 2 en.dollar_sign ) ) ( string star_rating ) ( string = ) ( number 3 en.star ) ) )	overnight-restaurants
what are the cuisines of all the 3 star rating restaurants	( call SW.listValue ( call SW.filter ( call SW.getProperty ( call SW.singleton en.cuisine ) ( string ! type ) ) ( call SW.reverse ( string cuisine ) ) ( string = ) ( call SW.filter ( call SW.getProperty ( call SW.singleton en.restaurant ) ( string ! type ) ) ( string star_rating ) ( string = ) ( number 3 en.star ) ) ) )	overnight-restaurants
restaurant that has less than two cuisine	( call SW.listValue ( call SW.countComparative ( call SW.getProperty ( call SW.singleton en.restaurant ) ( string ! type ) ) ( string cuisine ) ( string < ) ( number 2 ) ) )	overnight-restaurants
a restaurant in a kid friendly neighborhood	( call SW.listValue ( call SW.filter ( call SW.getProperty ( call SW.singleton en.neighborhood ) ( string ! type ) ) ( call SW.reverse ( string neighborhood ) ) ( string = ) ( call SW.filter ( call SW.getProperty ( call SW.singleton en.restaurant ) ( string ! type ) ) ( string kids ) ) ) )	overnight-restaurants
what restaurant is good for groups and takes credit card	( call SW.listValue ( call SW.filter ( call SW.filter ( call SW.getProperty ( call SW.singleton en.restaurant ) ( string ! type ) ) ( string groups ) ) ( string credit ) ) )	overnight-restaurants
what restaurant has a higher price rating than the thai cafe	( call SW.listValue ( call SW.filter ( call SW.getProperty ( call SW.singleton en.restaurant ) ( string ! type ) ) ( call SW.ensureNumericProperty ( string price_rating ) ) ( string > ) ( call SW.ensureNumericEntity ( call SW.getProperty en.restaurant.thai_cafe ( string price_rating ) ) ) ) )	overnight-restaurants
which restaurants are good for groups and have outdoor seating	( call SW.listValue ( call SW.filter ( call SW.filter ( call SW.getProperty ( call SW.singleton en.restaurant ) ( string ! type ) ) ( string groups ) ) ( string outdoor ) ) )	overnight-restaurants
restaurants with between 30 and 40 reviews	( call SW.listValue ( call SW.concat ( number 30 en.review ) ( number 40 en.review ) ) )	overnight-restaurants
restaurant whose neighborhood is neighborhood that is neighborhood of thai cafe	( call SW.listValue ( call SW.filter ( call SW.getProperty ( call SW.singleton en.restaurant ) ( string ! type ) ) ( string neighborhood ) ( string = ) ( call SW.filter ( call SW.getProperty ( call SW.singleton en.neighborhood ) ( string ! type ) ) ( call SW.reverse ( string neighborhood ) ) ( string = ) en.restaurant.thai_cafe ) ) )	overnight-restaurants
restaurant that is near to thai cafe	( call SW.listValue ( call SW.filter ( call SW.getProperty ( call SW.singleton en.restaurant ) ( string ! type ) ) ( string neighborhood ) ( string = ) ( call SW.getProperty en.restaurant.thai_cafe ( string neighborhood ) ) ) )	overnight-restaurants
what thai restaurants offer a waiter service	( call SW.listValue ( call SW.filter ( call SW.filter ( call SW.getProperty ( call SW.singleton en.restaurant ) ( string ! type ) ) ( string waiter ) ) ( string cuisine ) ( string = ) en.cuisine.thai ) )	overnight-restaurants
restaurants in the neighborhoods that contain thai cafe	( call SW.listValue ( call SW.filter ( call SW.getProperty ( call SW.singleton en.restaurant ) ( string ! type ) ) ( string neighborhood ) ( string = ) ( call SW.filter ( call SW.getProperty ( call SW.singleton en.neighborhood ) ( string ! type ) ) ( call SW.reverse ( string neighborhood ) ) ( string = ) en.restaurant.thai_cafe ) ) )	overnight-restaurants
a restaurant rated 2 dollar signs for lunch	( call SW.listValue ( call SW.filter ( call SW.filter ( call SW.getProperty ( call SW.singleton en.restaurant ) ( string ! type ) ) ( string price_rating ) ( string = ) ( number 2 en.dollar_sign ) ) ( string meals ) ( string = ) en.food.lunch ) )	overnight-restaurants
hotel which has a minimum of 3 star rating	( call SW.listValue ( call SW.filter ( call SW.getProperty ( call SW.singleton en.restaurant ) ( string ! type ) ) ( call SW.ensureNumericProperty ( string star_rating ) ) ( string >= ) ( call SW.ensureNumericEntity ( number 3 en.star ) ) ) )	overnight-restaurants
restaurant whose cuisine is thai and that has takeout	( call SW.listValue ( call SW.filter ( call SW.filter ( call SW.getProperty ( call SW.singleton en.restaurant ) ( string ! type ) ) ( string cuisine ) ( string = ) en.cuisine.thai ) ( string takeout ) ) )	overnight-restaurants
restaurant whose price rating is at least 2 dollar signs or 3 dollar signs	( call SW.listValue ( call SW.filter ( call SW.getProperty ( call SW.singleton en.restaurant ) ( string ! type ) ) ( call SW.ensureNumericProperty ( string price_rating ) ) ( string >= ) ( call SW.ensureNumericEntity ( call SW.concat ( number 2 en.dollar_sign ) ( number 3 en.dollar_sign ) ) ) ) )	overnight-restaurants
restaurants that can be booked in advance and good for group dining	( call SW.listValue ( call SW.filter ( call SW.filter ( call SW.getProperty ( call SW.singleton en.restaurant ) ( string ! type ) ) ( string reserve ) ) ( string groups ) ) )	overnight-restaurants
what restaurant offers an outdoot and takeout	( call SW.listValue ( call SW.filter ( call SW.filter ( call SW.getProperty ( call SW.singleton en.restaurant ) ( string ! type ) ) ( string outdoor ) ) ( string takeout ) ) )	overnight-restaurants
what restaurant offers a waiter service and is good for groups	( call SW.listValue ( call SW.filter ( call SW.filter ( call SW.getProperty ( call SW.singleton en.restaurant ) ( string ! type ) ) ( string groups ) ) ( string waiter ) ) )	overnight-restaurants
what is the type of cuisine of thai cafe	( call SW.listValue ( call SW.filter ( call SW.getProperty ( call SW.singleton en.restaurant ) ( string ! type ) ) ( string cuisine ) ( string = ) ( call SW.filter ( call SW.getProperty ( call SW.singleton en.cuisine ) ( string ! type ) ) ( call SW.reverse ( string cuisine ) ) ( string = ) en.restaurant.thai_cafe ) ) )	overnight-restaurants
find a 3 star restaurant that is good for groups	( call SW.listValue ( call SW.filter ( call SW.filter ( call SW.getProperty ( call SW.singleton en.restaurant ) ( string ! type ) ) ( string groups ) ) ( string star_rating ) ( string = ) ( number 3 en.star ) ) )	overnight-restaurants
which restaurants serve two meals	( call SW.listValue ( call SW.countComparative ( call SW.getProperty ( call SW.singleton en.restaurant ) ( string ! type ) ) ( string meals ) ( string = ) ( number 2 ) ( call SW.getProperty ( call SW.singleton en.food ) ( string ! type ) ) ) )	overnight-restaurants
what restaurant is good for kids and takes credit cards	( call SW.listValue ( call SW.filter ( call SW.filter ( call SW.getProperty ( call SW.singleton en.restaurant ) ( string ! type ) ) ( string kids ) ) ( string credit ) ) )	overnight-restaurants
restaurant that serves unique meals	( call SW.listValue ( call SW.countComparative ( call SW.getProperty ( call SW.singleton en.food ) ( string ! type ) ) ( call SW.reverse ( string meals ) ) ( string < ) ( number 2 ) ( call SW.getProperty ( call SW.singleton en.restaurant ) ( string ! type ) ) ) )	overnight-restaurants
restaurant whose neighborhood is midtown west and whose cuisine is thai	( call SW.listValue ( call SW.filter ( call SW.filter ( call SW.getProperty ( call SW.singleton en.restaurant ) ( string ! type ) ) ( string neighborhood ) ( string = ) en.neighborhood.midtown_west ) ( string cuisine ) ( string = ) en.cuisine.thai ) )	overnight-restaurants
three star restaurants that accept credit cards	( call SW.listValue ( call SW.filter ( call SW.filter ( call SW.getProperty ( call SW.singleton en.restaurant ) ( string ! type ) ) ( string star_rating ) ( string = ) ( number 3 en.star ) ) ( string credit ) ) )	overnight-restaurants
which restaurant is the most highly rated	( call SW.listValue ( call SW.superlative ( call SW.getProperty ( call SW.singleton en.restaurant ) ( string ! type ) ) ( string max ) ( call SW.ensureNumericProperty ( string star_rating ) ) ) )	overnight-restaurants
restaurants in midtown west with outdoor seating	( call SW.listValue ( call SW.filter ( call SW.filter ( call SW.getProperty ( call SW.singleton en.restaurant ) ( string ! type ) ) ( string neighborhood ) ( string = ) en.neighborhood.midtown_west ) ( string outdoor ) ) )	overnight-restaurants
restaurant whose price rating is 2 dollar signs	( call SW.listValue ( call SW.filter ( call SW.getProperty ( call SW.singleton en.restaurant ) ( string ! type ) ) ( string price_rating ) ( string = ) ( number 2 en.dollar_sign ) ) )	overnight-restaurants
restaurants in midtown west rated 3 stars	( call SW.listValue ( call SW.filter ( call SW.filter ( call SW.getProperty ( call SW.singleton en.restaurant ) ( string ! type ) ) ( string star_rating ) ( string = ) ( number 3 en.star ) ) ( string neighborhood ) ( string = ) en.neighborhood.midtown_west ) )	overnight-restaurants
what is the price rating of the hotel	( call SW.listValue ( call SW.aggregate ( string sum ) ( call SW.getProperty ( call SW.getProperty ( call SW.singleton en.restaurant ) ( string ! type ) ) ( string price_rating ) ) ) )	overnight-restaurants
restaurants with waiters that have a price rating of 2	( call SW.listValue ( call SW.filter ( call SW.filter ( call SW.getProperty ( call SW.singleton en.restaurant ) ( string ! type ) ) ( string price_rating ) ( string = ) ( number 2 en.dollar_sign ) ) ( string waiter ) ) )	overnight-restaurants
what neighborhood has a restaurant that contains outdoor seating	( call SW.listValue ( call SW.filter ( call SW.getProperty ( call SW.singleton en.neighborhood ) ( string ! type ) ) ( call SW.reverse ( string neighborhood ) ) ( string = ) ( call SW.filter ( call SW.getProperty ( call SW.singleton en.restaurant ) ( string ! type ) ) ( string outdoor ) ) ) )	overnight-restaurants
find a restaurant in a neighborhood	( call SW.listValue ( call SW.countComparative ( call SW.getProperty ( call SW.singleton en.restaurant ) ( string ! type ) ) ( string neighborhood ) ( string < ) ( number 2 ) ) )	overnight-restaurants
restaurant with at least a 2 dollar price rating	( call SW.listValue ( call SW.filter ( call SW.getProperty ( call SW.singleton en.restaurant ) ( string ! type ) ) ( call SW.ensureNumericProperty ( string price_rating ) ) ( string >= ) ( call SW.ensureNumericEntity ( number 2 en.dollar_sign ) ) ) )	overnight-restaurants
which thai restaurants offer takeout	( call SW.listValue ( call SW.filter ( call SW.filter ( call SW.getProperty ( call SW.singleton en.restaurant ) ( string ! type ) ) ( string takeout ) ) ( string cuisine ) ( string = ) en.cuisine.thai ) )	overnight-restaurants
restaurant whose price rating is 2 dollar signs or 3 dollar signs	( call SW.listValue ( call SW.filter ( call SW.getProperty ( call SW.singleton en.restaurant ) ( string ! type ) ) ( string price_rating ) ( string = ) ( call SW.concat ( number 2 en.dollar_sign ) ( number 3 en.dollar_sign ) ) ) )	overnight-restaurants
restaurants serving the same cuisine as thai cafe	( call SW.listValue ( call SW.filter ( call SW.getProperty ( call SW.singleton en.restaurant ) ( string ! type ) ) ( string cuisine ) ( string = ) ( call SW.getProperty en.restaurant.thai_cafe ( string cuisine ) ) ) )	overnight-restaurants
what neighborhoods have the most 3 star rated restaurants	( call SW.listValue ( call SW.filter ( call SW.getProperty ( call SW.singleton en.neighborhood ) ( string ! type ) ) ( call SW.reverse ( string neighborhood ) ) ( string = ) ( call SW.filter ( call SW.getProperty ( call SW.singleton en.restaurant ) ( string ! type ) ) ( string star_rating ) ( string = ) ( number 3 en.star ) ) ) )	overnight-restaurants
