what player has more than 3 rebounds in every season	( call SW.listValue ( call SW.getProperty ( ( lambda s ( call SW.filter ( var s ) ( call SW.ensureNumericProperty ( string num_rebounds ) ) ( string > ) ( call SW.ensureNumericEntity ( number 3 rebound ) ) ) ) ( call SW.domain ( string player ) ) ) ( string player ) ) )	overnight-basketball
what player had as many blocks as kobe bryant over as season	( call SW.listValue ( call SW.getProperty ( ( lambda s ( call SW.filter ( var s ) ( string num_blocks ) ( string = ) ( call SW.getProperty ( call SW.getProperty en.player.kobe_bryant ( call SW.reverse ( string player ) ) ) ( string num_blocks ) ) ) ) ( call SW.domain ( string player ) ) ) ( string player ) ) )	overnight-basketball
what team has kobe bryant played point guard for	( call SW.listValue ( call SW.getProperty ( call SW.filter ( call SW.getProperty en.player.kobe_bryant ( call SW.reverse ( string player ) ) ) ( string position ) ( string = ) en.position.point_guard ) ( string team ) ) )	overnight-basketball
number of fouls over a season of player kobe bryant who is at point guard	( call SW.listValue ( call SW.getProperty ( call SW.filter ( call SW.getProperty en.player.kobe_bryant ( call SW.reverse ( string player ) ) ) ( string position ) ( string = ) en.position.point_guard ) ( string num_fouls ) ) )	overnight-basketball
what season did kobe bryant score 3 points	( call SW.listValue ( call SW.getProperty ( call SW.filter ( call SW.getProperty en.player.kobe_bryant ( call SW.reverse ( string player ) ) ) ( string num_points ) ( string = ) ( number 3 point ) ) ( string season ) ) )	overnight-basketball
what position was kobe player when he had three assists	( call SW.listValue ( call SW.getProperty ( call SW.filter ( call SW.getProperty en.player.kobe_bryant ( call SW.reverse ( string player ) ) ) ( string num_assists ) ( string = ) ( number 3 assist ) ) ( string position ) ) )	overnight-basketball
kobe bryans assists for the season he had 3 assists	( call SW.listValue ( call SW.getProperty ( call SW.filter ( call SW.getProperty en.player.kobe_bryant ( call SW.reverse ( string player ) ) ) ( string num_assists ) ( string = ) ( number 3 assist ) ) ( string num_assists ) ) )	overnight-basketball
kobe bryant had3 turnovers	( call SW.listValue ( call SW.getProperty ( call SW.filter ( call SW.getProperty en.player.kobe_bryant ( call SW.reverse ( string player ) ) ) ( string num_turnovers ) ( string = ) ( number 3 turnover ) ) ( string num_turnovers ) ) )	overnight-basketball
which player had the same number of fouls as kobe bryant	( call SW.listValue ( call SW.getProperty ( ( lambda s ( call SW.filter ( var s ) ( string num_fouls ) ( string = ) ( call SW.getProperty ( call SW.getProperty en.player.kobe_bryant ( call SW.reverse ( string player ) ) ) ( string num_fouls ) ) ) ) ( call SW.domain ( string player ) ) ) ( string player ) ) )	overnight-basketball
what player has played the least number of positions	( call SW.listValue ( call SW.getProperty ( ( lambda s ( call SW.countSuperlative ( var s ) ( string min ) ( string position ) ) ) ( call SW.domain ( string player ) ) ) ( string player ) ) )	overnight-basketball
what player has been in for only 1 or 2 games in a season	( call SW.listValue ( call SW.getProperty ( ( lambda s ( call SW.filter ( var s ) ( call SW.ensureNumericProperty ( string num_games_played ) ) ( string < ) ( call SW.ensureNumericEntity ( number 3 game ) ) ) ) ( call SW.domain ( string player ) ) ) ( string player ) ) )	overnight-basketball
position of player kobe bryant who has 3 points over a season	( call SW.listValue ( call SW.getProperty ( call SW.filter ( call SW.getProperty en.player.kobe_bryant ( call SW.reverse ( string player ) ) ) ( string num_points ) ( string = ) ( number 3 point ) ) ( string position ) ) )	overnight-basketball
player who plays position point guard or forward	( call SW.listValue ( call SW.concat en.position.point_guard en.position.forward ) )	overnight-basketball
who has had more than 3 turnovers	( call SW.listValue ( call SW.getProperty ( ( lambda s ( call SW.filter ( var s ) ( call SW.ensureNumericProperty ( string num_turnovers ) ) ( string > ) ( call SW.ensureNumericEntity ( number 3 turnover ) ) ) ) ( call SW.domain ( string player ) ) ) ( string player ) ) )	overnight-basketball
what position does kobe bryant play who had three fouls in the season	( call SW.listValue ( call SW.getProperty ( call SW.filter ( call SW.getProperty en.player.kobe_bryant ( call SW.reverse ( string player ) ) ) ( string num_fouls ) ( string = ) ( number 3 foul ) ) ( string position ) ) )	overnight-basketball
what position did kobe bryant play in the 2004 season	( call SW.listValue ( call SW.getProperty ( call SW.filter ( call SW.getProperty en.player.kobe_bryant ( call SW.reverse ( string player ) ) ) ( string season ) ( string = ) ( date 2004 -1 -1 ) ) ( string position ) ) )	overnight-basketball
what player has played more or less than 3 games	( call SW.listValue ( call SW.getProperty ( ( lambda s ( call SW.filter ( var s ) ( string num_games_played ) ( string ! = ) ( number 3 game ) ) ) ( call SW.domain ( string player ) ) ) ( string player ) ) )	overnight-basketball
how many rebounds did kobe bryant get after 3 turnovers	( call SW.listValue ( call SW.getProperty ( call SW.filter ( call SW.getProperty en.player.kobe_bryant ( call SW.reverse ( string player ) ) ) ( string num_turnovers ) ( string = ) ( number 3 turnover ) ) ( string num_rebounds ) ) )	overnight-basketball
how many games did kobe bryant play in the 2004 season	( call SW.listValue ( call SW.getProperty ( call SW.filter ( call SW.getProperty en.player.kobe_bryant ( call SW.reverse ( string player ) ) ) ( string season ) ( string = ) ( date 2004 -1 -1 ) ) ( string num_games_played ) ) )	overnight-basketball
which player plays fewer than two positions	( call SW.listValue ( call SW.getProperty ( ( lambda s ( call SW.countComparative ( var s ) ( string position ) ( string < ) ( number 2 ) ) ) ( call SW.domain ( string player ) ) ) ( string player ) ) )	overnight-basketball
how many rebounds did kobe bryant have when he made three fouls	( call SW.listValue ( call SW.getProperty ( call SW.filter ( call SW.getProperty en.player.kobe_bryant ( call SW.reverse ( string player ) ) ) ( string num_fouls ) ( string = ) ( number 3 foul ) ) ( string num_rebounds ) ) )	overnight-basketball
which player has not played 3 fouls	( call SW.listValue ( call SW.getProperty ( ( lambda s ( call SW.filter ( var s ) ( string num_fouls ) ( string ! = ) ( number 3 foul ) ) ) ( call SW.domain ( string player ) ) ) ( string player ) ) )	overnight-basketball
number of assists over a season of player kobe bryant whose team is los angeles lakers	( call SW.listValue ( call SW.getProperty ( call SW.filter ( call SW.getProperty en.player.kobe_bryant ( call SW.reverse ( string player ) ) ) ( string team ) ( string = ) en.team.lakers ) ( string num_assists ) ) )	overnight-basketball
the player who made most fouls over a season	( call SW.listValue ( call SW.getProperty ( ( lambda s ( call SW.superlative ( var s ) ( string max ) ( call SW.ensureNumericProperty ( string num_fouls ) ) ) ) ( call SW.domain ( string player ) ) ) ( string player ) ) )	overnight-basketball
whos got the record for most rebounds in a season	( call SW.listValue ( call SW.getProperty ( ( lambda s ( call SW.superlative ( var s ) ( string max ) ( call SW.ensureNumericProperty ( string num_rebounds ) ) ) ) ( call SW.domain ( string player ) ) ) ( string player ) ) )	overnight-basketball
during 2004 how many fouls did kobe get against him	( call SW.listValue ( call SW.getProperty ( call SW.filter ( call SW.getProperty en.player.kobe_bryant ( call SW.reverse ( string player ) ) ) ( string season ) ( string = ) ( date 2004 -1 -1 ) ) ( string num_fouls ) ) )	overnight-basketball
which player had at least three assists last season	( call SW.listValue ( call SW.getProperty ( ( lambda s ( call SW.filter ( var s ) ( call SW.ensureNumericProperty ( string num_assists ) ) ( string >= ) ( call SW.ensureNumericEntity ( number 3 assist ) ) ) ) ( call SW.domain ( string player ) ) ) ( string player ) ) )	overnight-basketball
name a player with fewer than three fouls	( call SW.listValue ( call SW.getProperty ( ( lambda s ( call SW.filter ( var s ) ( call SW.ensureNumericProperty ( string num_fouls ) ) ( string < ) ( call SW.ensureNumericEntity ( number 3 foul ) ) ) ) ( call SW.domain ( string player ) ) ) ( string player ) ) )	overnight-basketball
what is the team of kobe  bryant who played 3 fouls	( call SW.listValue ( call SW.getProperty ( call SW.filter ( call SW.getProperty en.player.kobe_bryant ( call SW.reverse ( string player ) ) ) ( string num_fouls ) ( string = ) ( number 3 foul ) ) ( string team ) ) )	overnight-basketball
who has had less than or the same number of turnovers as kobe bryant	( call SW.listValue ( call SW.getProperty ( ( lambda s ( call SW.filter ( var s ) ( call SW.ensureNumericProperty ( string num_turnovers ) ) ( string <= ) ( call SW.ensureNumericEntity ( call SW.getProperty ( call SW.getProperty en.player.kobe_bryant ( call SW.reverse ( string player ) ) ) ( string num_turnovers ) ) ) ) ) ( call SW.domain ( string player ) ) ) ( string player ) ) )	overnight-basketball
how many turnovers did kobe bryant have when he had 3 assists	( call SW.listValue ( call SW.getProperty ( call SW.filter ( call SW.getProperty en.player.kobe_bryant ( call SW.reverse ( string player ) ) ) ( string num_assists ) ( string = ) ( number 3 assist ) ) ( string num_turnovers ) ) )	overnight-basketball
how many players	( call SW.listValue ( call .size ( call SW.getProperty ( call SW.singleton en.player ) ( string ! type ) ) ) )	overnight-basketball
which season did kobe bryant have 3 turnovers	( call SW.listValue ( call SW.getProperty ( call SW.filter ( call SW.getProperty en.player.kobe_bryant ( call SW.reverse ( string player ) ) ) ( string num_turnovers ) ( string = ) ( number 3 turnover ) ) ( string season ) ) )	overnight-basketball
players who are forwards or point guards	( call SW.listValue ( call SW.concat en.position.point_guard en.position.forward ) )	overnight-basketball
name a player with fewer than three blocks per season	( call SW.listValue ( call SW.getProperty ( ( lambda s ( call SW.filter ( var s ) ( call SW.ensureNumericProperty ( string num_blocks ) ) ( string < ) ( call SW.ensureNumericEntity ( number 3 block ) ) ) ) ( call SW.domain ( string player ) ) ) ( string player ) ) )	overnight-basketball
which player is it kobe bryant or lebron james	( call SW.listValue ( call SW.concat en.player.kobe_bryant en.player.lebron_james ) )	overnight-basketball
what teams did kobe bryant play on as point guard	( call SW.listValue ( call SW.getProperty ( call SW.filter ( call SW.getProperty en.player.kobe_bryant ( call SW.reverse ( string player ) ) ) ( string position ) ( string = ) en.position.point_guard ) ( string team ) ) )	overnight-basketball
which player has got a maximum of 3 turnovers	( call SW.listValue ( call SW.getProperty ( ( lambda s ( call SW.filter ( var s ) ( call SW.ensureNumericProperty ( string num_turnovers ) ) ( string <= ) ( call SW.ensureNumericEntity ( number 3 turnover ) ) ) ) ( call SW.domain ( string player ) ) ) ( string player ) ) )	overnight-basketball
what team did kobe bryant play for in 2004	( call SW.listValue ( call SW.getProperty ( call SW.filter ( call SW.getProperty en.player.kobe_bryant ( call SW.reverse ( string player ) ) ) ( string season ) ( string = ) ( date 2004 -1 -1 ) ) ( string team ) ) )	overnight-basketball
what player had the fewest turnovers this season	( call SW.listValue ( call SW.getProperty ( ( lambda s ( call SW.superlative ( var s ) ( string min ) ( call SW.ensureNumericProperty ( string num_turnovers ) ) ) ) ( call SW.domain ( string player ) ) ) ( string player ) ) )	overnight-basketball
who has the fewest assists per season	( call SW.listValue ( call SW.getProperty ( ( lambda s ( call SW.superlative ( var s ) ( string min ) ( call SW.ensureNumericProperty ( string num_assists ) ) ) ) ( call SW.domain ( string player ) ) ) ( string player ) ) )	overnight-basketball
how many steals did kobe bryant have during the season when averaging three assists	( call SW.listValue ( call SW.getProperty ( call SW.filter ( call SW.getProperty en.player.kobe_bryant ( call SW.reverse ( string player ) ) ) ( string num_assists ) ( string = ) ( number 3 assist ) ) ( string num_steals ) ) )	overnight-basketball
what players did not play in 2004	( call SW.listValue ( call SW.getProperty ( ( lambda s ( call SW.filter ( var s ) ( string season ) ( string ! = ) ( date 2004 -1 -1 ) ) ) ( call SW.domain ( string player ) ) ) ( string player ) ) )	overnight-basketball
what player had less than 3 fouls	( call SW.listValue ( call SW.getProperty ( ( lambda s ( call SW.filter ( var s ) ( call SW.ensureNumericProperty ( string num_fouls ) ) ( string < ) ( call SW.ensureNumericEntity ( number 3 foul ) ) ) ) ( call SW.domain ( string player ) ) ) ( string player ) ) )	overnight-basketball
which player had the fewest rebounds in one season	( call SW.listValue ( call SW.getProperty ( ( lambda s ( call SW.superlative ( var s ) ( string min ) ( call SW.ensureNumericProperty ( string num_rebounds ) ) ) ) ( call SW.domain ( string player ) ) ) ( string player ) ) )	overnight-basketball
which player has had the most fouls in a season	( call SW.listValue ( call SW.getProperty ( ( lambda s ( call SW.superlative ( var s ) ( string max ) ( call SW.ensureNumericProperty ( string num_fouls ) ) ) ) ( call SW.domain ( string player ) ) ) ( string player ) ) )	overnight-basketball
player with more than 3 rebounds over a season	( call SW.listValue ( call SW.getProperty ( ( lambda s ( call SW.filter ( var s ) ( call SW.ensureNumericProperty ( string num_rebounds ) ) ( string > ) ( call SW.ensureNumericEntity ( number 3 rebound ) ) ) ) ( call SW.domain ( string player ) ) ) ( string player ) ) )	overnight-basketball
which position did kobe bryant play in 2004	( call SW.listValue ( call SW.getProperty ( call SW.filter ( call SW.getProperty en.player.kobe_bryant ( call SW.reverse ( string player ) ) ) ( string season ) ( string = ) ( date 2004 -1 -1 ) ) ( string position ) ) )	overnight-basketball
player with least number of blocks over a season	( call SW.listValue ( call SW.getProperty ( ( lambda s ( call SW.superlative ( var s ) ( string min ) ( call SW.ensureNumericProperty ( string num_blocks ) ) ) ) ( call SW.domain ( string player ) ) ) ( string player ) ) )	overnight-basketball
which player made as many blocks over the season as kobe bryant	( call SW.listValue ( call SW.getProperty ( ( lambda s ( call SW.filter ( var s ) ( call SW.ensureNumericProperty ( string num_blocks ) ) ( string <= ) ( call SW.ensureNumericEntity ( call SW.getProperty ( call SW.getProperty en.player.kobe_bryant ( call SW.reverse ( string player ) ) ) ( string num_blocks ) ) ) ) ) ( call SW.domain ( string player ) ) ) ( string player ) ) )	overnight-basketball
how many players are there	( call SW.listValue ( call .size ( call SW.getProperty ( call SW.singleton en.player ) ( string ! type ) ) ) )	overnight-basketball
who has played at least 3 games in a season	( call SW.listValue ( call SW.getProperty ( ( lambda s ( call SW.filter ( var s ) ( call SW.ensureNumericProperty ( string num_games_played ) ) ( string >= ) ( call SW.ensureNumericEntity ( number 3 game ) ) ) ) ( call SW.domain ( string player ) ) ) ( string player ) ) )	overnight-basketball
which player has made the minimum number of turnovers	( call SW.listValue ( call SW.getProperty ( ( lambda s ( call SW.superlative ( var s ) ( string min ) ( call SW.ensureNumericProperty ( string num_turnovers ) ) ) ) ( call SW.domain ( string player ) ) ) ( string player ) ) )	overnight-basketball
how many games did kobe bryant get 3 fouls in	( call SW.listValue ( call SW.getProperty ( call SW.filter ( call SW.getProperty en.player.kobe_bryant ( call SW.reverse ( string player ) ) ) ( string num_fouls ) ( string = ) ( number 3 foul ) ) ( string num_games_played ) ) )	overnight-basketball
who has had the least points	( call SW.listValue ( call SW.getProperty ( ( lambda s ( call SW.superlative ( var s ) ( string min ) ( call SW.ensureNumericProperty ( string num_points ) ) ) ) ( call SW.domain ( string player ) ) ) ( string player ) ) )	overnight-basketball
what players had the same games played than kobe bryant over all seasons	( call SW.listValue ( call SW.getProperty ( ( lambda s ( call SW.filter ( var s ) ( string num_games_played ) ( string = ) ( call SW.getProperty ( call SW.getProperty en.player.kobe_bryant ( call SW.reverse ( string player ) ) ) ( string num_games_played ) ) ) ) ( call SW.domain ( string player ) ) ) ( string player ) ) )	overnight-basketball
what player had less turnovers than kobe bryant this season	( call SW.listValue ( call SW.getProperty ( ( lambda s ( call SW.filter ( var s ) ( call SW.ensureNumericProperty ( string num_turnovers ) ) ( string < ) ( call SW.ensureNumericEntity ( call SW.getProperty ( call SW.getProperty en.player.kobe_bryant ( call SW.reverse ( string player ) ) ) ( string num_turnovers ) ) ) ) ) ( call SW.domain ( string player ) ) ) ( string player ) ) )	overnight-basketball
number of played games over a season of player kobe bryant who has played 3 games over a season	( call SW.listValue ( call SW.getProperty ( call SW.filter ( call SW.getProperty en.player.kobe_bryant ( call SW.reverse ( string player ) ) ) ( string num_games_played ) ( string = ) ( number 3 game ) ) ( string num_games_played ) ) )	overnight-basketball
how many did kobe bryant play so far this year	( call SW.listValue ( call SW.getProperty ( call SW.getProperty en.player.kobe_bryant ( call SW.reverse ( string player ) ) ) ( string num_games_played ) ) )	overnight-basketball
player with smallest number of assists over a season	( call SW.listValue ( call SW.getProperty ( ( lambda s ( call SW.superlative ( var s ) ( string min ) ( call SW.ensureNumericProperty ( string num_assists ) ) ) ) ( call SW.domain ( string player ) ) ) ( string player ) ) )	overnight-basketball
who has had the same amount of assists as kobe bryant	( call SW.listValue ( call SW.getProperty ( ( lambda s ( call SW.filter ( var s ) ( string num_assists ) ( string = ) ( call SW.getProperty ( call SW.getProperty en.player.kobe_bryant ( call SW.reverse ( string player ) ) ) ( string num_assists ) ) ) ) ( call SW.domain ( string player ) ) ) ( string player ) ) )	overnight-basketball
how many points did kobe bryant score in 3 games	( call SW.listValue ( call SW.getProperty ( call SW.filter ( call SW.getProperty en.player.kobe_bryant ( call SW.reverse ( string player ) ) ) ( string num_games_played ) ( string = ) ( number 3 game ) ) ( string num_points ) ) )	overnight-basketball
what player has the lowest amount of rebounds in a season	( call SW.listValue ( call SW.getProperty ( ( lambda s ( call SW.superlative ( var s ) ( string min ) ( call SW.ensureNumericProperty ( string num_rebounds ) ) ) ) ( call SW.domain ( string player ) ) ) ( string player ) ) )	overnight-basketball
what player has had more or less fouls than 3 over a season	( call SW.listValue ( call SW.getProperty ( ( lambda s ( call SW.filter ( var s ) ( string num_fouls ) ( string ! = ) ( number 3 foul ) ) ) ( call SW.domain ( string player ) ) ) ( string player ) ) )	overnight-basketball
who plays on the same team as kobe bryant	( call SW.listValue ( call SW.getProperty ( ( lambda s ( call SW.filter ( var s ) ( string team ) ( string = ) ( call SW.getProperty ( call SW.getProperty en.player.kobe_bryant ( call SW.reverse ( string player ) ) ) ( string team ) ) ) ) ( call SW.domain ( string player ) ) ) ( string player ) ) )	overnight-basketball
who has had the same number of turnovers as kobe bryant	( call SW.listValue ( call SW.getProperty ( ( lambda s ( call SW.filter ( var s ) ( string num_fouls ) ( string = ) ( call SW.getProperty ( call SW.getProperty en.player.kobe_bryant ( call SW.reverse ( string player ) ) ) ( string num_fouls ) ) ) ) ( call SW.domain ( string player ) ) ) ( string player ) ) )	overnight-basketball
how many all season rebounds did kobe bryant have when his turnovers equaled 3	( call SW.listValue ( call SW.getProperty ( call SW.filter ( call SW.getProperty en.player.kobe_bryant ( call SW.reverse ( string player ) ) ) ( string num_turnovers ) ( string = ) ( number 3 turnover ) ) ( string num_rebounds ) ) )	overnight-basketball
what player played more games than kobe bryant this season	( call SW.listValue ( call SW.getProperty ( ( lambda s ( call SW.filter ( var s ) ( call SW.ensureNumericProperty ( string num_games_played ) ) ( string > ) ( call SW.ensureNumericEntity ( call SW.getProperty ( call SW.getProperty en.player.kobe_bryant ( call SW.reverse ( string player ) ) ) ( string num_games_played ) ) ) ) ) ( call SW.domain ( string player ) ) ) ( string player ) ) )	overnight-basketball
how many rebounds did kobe bryant who had three blocks have	( call SW.listValue ( call SW.getProperty ( call SW.filter ( call SW.getProperty en.player.kobe_bryant ( call SW.reverse ( string player ) ) ) ( string num_blocks ) ( string = ) ( number 3 block ) ) ( string num_rebounds ) ) )	overnight-basketball
how many assists kob bryant made in season 2004	( call SW.listValue ( call SW.getProperty ( call SW.filter ( call SW.getProperty en.player.kobe_bryant ( call SW.reverse ( string player ) ) ) ( string season ) ( string = ) ( date 2004 -1 -1 ) ) ( string num_assists ) ) )	overnight-basketball
mention the number of turnovers of player kobe bryant in 3 games played over this season	( call SW.listValue ( call SW.getProperty ( call SW.filter ( call SW.getProperty en.player.kobe_bryant ( call SW.reverse ( string player ) ) ) ( string num_games_played ) ( string = ) ( number 3 game ) ) ( string num_turnovers ) ) )	overnight-basketball
what player had the same or less fouls as kobe bryant	( call SW.listValue ( call SW.getProperty ( ( lambda s ( call SW.filter ( var s ) ( call SW.ensureNumericProperty ( string num_fouls ) ) ( string <= ) ( call SW.ensureNumericEntity ( call SW.getProperty ( call SW.getProperty en.player.kobe_bryant ( call SW.reverse ( string player ) ) ) ( string num_fouls ) ) ) ) ) ( call SW.domain ( string player ) ) ) ( string player ) ) )	overnight-basketball
when kobe bryant had 3 allseason assists how many rebounds did he have	( call SW.listValue ( call SW.getProperty ( call SW.filter ( call SW.getProperty en.player.kobe_bryant ( call SW.reverse ( string player ) ) ) ( string num_assists ) ( string = ) ( number 3 assist ) ) ( string num_rebounds ) ) )	overnight-basketball
player who committed more fouls than kob bryant	( call SW.listValue ( call SW.getProperty ( ( lambda s ( call SW.filter ( var s ) ( call SW.ensureNumericProperty ( string num_fouls ) ) ( string > ) ( call SW.ensureNumericEntity ( call SW.getProperty ( call SW.getProperty en.player.kobe_bryant ( call SW.reverse ( string player ) ) ) ( string num_fouls ) ) ) ) ) ( call SW.domain ( string player ) ) ) ( string player ) ) )	overnight-basketball
how many turnovers does kobe bryant have over all seasons	( call SW.listValue ( call SW.getProperty ( call SW.filter ( call SW.getProperty en.player.kobe_bryant ( call SW.reverse ( string player ) ) ) ( string num_assists ) ( string = ) ( number 3 assist ) ) ( string num_turnovers ) ) )	overnight-basketball
season of player kobe bryant who has 3 turnovers over a season	( call SW.listValue ( call SW.getProperty ( call SW.filter ( call SW.getProperty en.player.kobe_bryant ( call SW.reverse ( string player ) ) ) ( string num_turnovers ) ( string = ) ( number 3 turnover ) ) ( string season ) ) )	overnight-basketball
number of fouls over a season of player kobe bryant from los angeles lakers team	( call SW.listValue ( call SW.getProperty ( call SW.filter ( call SW.getProperty en.player.kobe_bryant ( call SW.reverse ( string player ) ) ) ( string team ) ( string = ) en.team.lakers ) ( string num_fouls ) ) )	overnight-basketball
how many blocks did kobe bryant have when he had 3 points	( call SW.listValue ( call SW.getProperty ( call SW.filter ( call SW.getProperty en.player.kobe_bryant ( call SW.reverse ( string player ) ) ) ( string num_points ) ( string = ) ( number 3 point ) ) ( string num_blocks ) ) )	overnight-basketball
which player has the same number of rebounds in any one season as kobe bryant	( call SW.listValue ( call SW.getProperty ( ( lambda s ( call SW.filter ( var s ) ( string num_rebounds ) ( string = ) ( call SW.getProperty ( call SW.getProperty en.player.kobe_bryant ( call SW.reverse ( string player ) ) ) ( string num_rebounds ) ) ) ) ( call SW.domain ( string player ) ) ) ( string player ) ) )	overnight-basketball
how many fouls did kobe bryant have with three points	( call SW.listValue ( call SW.getProperty ( call SW.filter ( call SW.getProperty en.player.kobe_bryant ( call SW.reverse ( string player ) ) ) ( string num_points ) ( string = ) ( number 3 point ) ) ( string num_fouls ) ) )	overnight-basketball
which player has a maximum of 3 fouls	( call SW.listValue ( call SW.getProperty ( ( lambda s ( call SW.filter ( var s ) ( call SW.ensureNumericProperty ( string num_fouls ) ) ( string <= ) ( call SW.ensureNumericEntity ( number 3 foul ) ) ) ) ( call SW.domain ( string player ) ) ) ( string player ) ) )	overnight-basketball
player with more than 3 blocks over a season	( call SW.listValue ( call SW.getProperty ( ( lambda s ( call SW.filter ( var s ) ( call SW.ensureNumericProperty ( string num_blocks ) ) ( string > ) ( call SW.ensureNumericEntity ( number 3 block ) ) ) ) ( call SW.domain ( string player ) ) ) ( string player ) ) )	overnight-basketball
how many rebounds did kobe bryant have after 3 games	( call SW.listValue ( call SW.getProperty ( call SW.filter ( call SW.getProperty en.player.kobe_bryant ( call SW.reverse ( string player ) ) ) ( string num_games_played ) ( string = ) ( number 3 game ) ) ( string num_rebounds ) ) )	overnight-basketball
which player had the most career blocks per season	( call SW.listValue ( call SW.getProperty ( ( lambda s ( call SW.superlative ( var s ) ( string max ) ( call SW.ensureNumericProperty ( string num_blocks ) ) ) ) ( call SW.domain ( string player ) ) ) ( string player ) ) )	overnight-basketball
what players have had the same or more blocks than kobe bryant	( call SW.listValue ( call SW.getProperty ( ( lambda s ( call SW.filter ( var s ) ( call SW.ensureNumericProperty ( string num_blocks ) ) ( string >= ) ( call SW.ensureNumericEntity ( call SW.getProperty ( call SW.getProperty en.player.kobe_bryant ( call SW.reverse ( string player ) ) ) ( string num_blocks ) ) ) ) ) ( call SW.domain ( string player ) ) ) ( string player ) ) )	overnight-basketball
what team was kobe bryant on when he played less than three games in a season	( call SW.listValue ( call SW.getProperty ( call SW.filter ( call SW.getProperty en.player.kobe_bryant ( call SW.reverse ( string player ) ) ) ( string num_games_played ) ( string = ) ( number 3 game ) ) ( string team ) ) )	overnight-basketball
how many steals did kobe bryant make	( call SW.listValue ( call SW.getProperty ( call SW.getProperty en.player.kobe_bryant ( call SW.reverse ( string player ) ) ) ( string num_steals ) ) )	overnight-basketball
how many games did kobe have three steals in over the season	( call SW.listValue ( call SW.getProperty ( call SW.filter ( call SW.getProperty en.player.kobe_bryant ( call SW.reverse ( string player ) ) ) ( string num_steals ) ( string = ) ( number 3 steal ) ) ( string num_games_played ) ) )	overnight-basketball
player with at least as many turnover as kobe bryant	( call SW.listValue ( call SW.getProperty ( ( lambda s ( call SW.filter ( var s ) ( call SW.ensureNumericProperty ( string num_turnovers ) ) ( string >= ) ( call SW.ensureNumericEntity ( call SW.getProperty ( call SW.getProperty en.player.kobe_bryant ( call SW.reverse ( string player ) ) ) ( string num_turnovers ) ) ) ) ) ( call SW.domain ( string player ) ) ) ( string player ) ) )	overnight-basketball
in what position did kobe bryant get 3 turnovers	( call SW.listValue ( call SW.getProperty ( call SW.filter ( call SW.getProperty en.player.kobe_bryant ( call SW.reverse ( string player ) ) ) ( string num_turnovers ) ( string = ) ( number 3 turnover ) ) ( string position ) ) )	overnight-basketball
how many assists did kobe bryant make in a season of 3 turnovers	( call SW.listValue ( call SW.getProperty ( call SW.filter ( call SW.getProperty en.player.kobe_bryant ( call SW.reverse ( string player ) ) ) ( string num_turnovers ) ( string = ) ( number 3 turnover ) ) ( string num_assists ) ) )	overnight-basketball
what players have had 3 or more rebounds	( call SW.listValue ( call SW.getProperty ( ( lambda s ( call SW.filter ( var s ) ( call SW.ensureNumericProperty ( string num_rebounds ) ) ( string >= ) ( call SW.ensureNumericEntity ( number 3 rebound ) ) ) ) ( call SW.domain ( string player ) ) ) ( string player ) ) )	overnight-basketball
how many seasons has kobe played more than 3 games and whats his career rebound total	( call SW.listValue ( call SW.getProperty ( call SW.filter ( call SW.getProperty en.player.kobe_bryant ( call SW.reverse ( string player ) ) ) ( string num_games_played ) ( string = ) ( number 3 game ) ) ( string num_rebounds ) ) )	overnight-basketball
98019705layers with the fewest turnovers per game during the season	( call SW.listValue ( call SW.getProperty ( ( lambda s ( call SW.superlative ( var s ) ( string min ) ( call SW.ensureNumericProperty ( string num_turnovers ) ) ) ) ( call SW.domain ( string player ) ) ) ( string player ) ) )	overnight-basketball
player who made less than 4 blocks over a season	( call SW.listValue ( call SW.getProperty ( ( lambda s ( call SW.filter ( var s ) ( call SW.ensureNumericProperty ( string num_blocks ) ) ( string <= ) ( call SW.ensureNumericEntity ( number 3 block ) ) ) ) ( call SW.domain ( string player ) ) ) ( string player ) ) )	overnight-basketball
who has equal to or more than 3 turnovers	( call SW.listValue ( call SW.getProperty ( ( lambda s ( call SW.filter ( var s ) ( call SW.ensureNumericProperty ( string num_turnovers ) ) ( string >= ) ( call SW.ensureNumericEntity ( number 3 turnover ) ) ) ) ( call SW.domain ( string player ) ) ) ( string player ) ) )	overnight-basketball
player whose number of fouls over a season is same as that of player kobe bryant over a season	( call SW.listValue ( call SW.getProperty ( ( lambda s ( call SW.filter ( var s ) ( string num_fouls ) ( string = ) ( call SW.getProperty ( call SW.getProperty en.player.kobe_bryant ( call SW.reverse ( string player ) ) ) ( string num_fouls ) ) ) ) ( call SW.domain ( string player ) ) ) ( string player ) ) )	overnight-basketball
who has made more than 3 points this season	( call SW.listValue ( call SW.getProperty ( ( lambda s ( call SW.filter ( var s ) ( call SW.ensureNumericProperty ( string num_points ) ) ( string > ) ( call SW.ensureNumericEntity ( number 3 point ) ) ) ) ( call SW.domain ( string player ) ) ) ( string player ) ) )	overnight-basketball
how many games has kobe bryant had more than 3 turnovers in all seasons	( call SW.listValue ( call SW.getProperty ( call SW.filter ( call SW.getProperty en.player.kobe_bryant ( call SW.reverse ( string player ) ) ) ( string num_blocks ) ( string = ) ( number 3 block ) ) ( string num_turnovers ) ) )	overnight-basketball
how many rebounds does kobe bryant have a season with 3 turnovers	( call SW.listValue ( call SW.getProperty ( call SW.filter ( call SW.getProperty en.player.kobe_bryant ( call SW.reverse ( string player ) ) ) ( string num_turnovers ) ( string = ) ( number 3 turnover ) ) ( string num_rebounds ) ) )	overnight-basketball
how many season did kobe bryant have no more than three assists	( call SW.listValue ( call SW.getProperty ( call SW.filter ( call SW.getProperty en.player.kobe_bryant ( call SW.reverse ( string player ) ) ) ( string num_assists ) ( string = ) ( number 3 assist ) ) ( string num_assists ) ) )	overnight-basketball
how many assists were got by kobe bryant who belonged to the los angeles team	( call SW.listValue ( call SW.getProperty ( call SW.filter ( call SW.getProperty en.player.kobe_bryant ( call SW.reverse ( string player ) ) ) ( string team ) ( string = ) en.team.lakers ) ( string num_assists ) ) )	overnight-basketball
players with a total number of rebounds in a season greater than three	( call SW.listValue ( call SW.getProperty ( ( lambda s ( call SW.filter ( var s ) ( call SW.ensureNumericProperty ( string num_rebounds ) ) ( string >= ) ( call SW.ensureNumericEntity ( number 3 rebound ) ) ) ) ( call SW.domain ( string player ) ) ) ( string player ) ) )	overnight-basketball
number of rebounds over a season of player kobe bryant who has played 3 games over a season	( call SW.listValue ( call SW.getProperty ( call SW.filter ( call SW.getProperty en.player.kobe_bryant ( call SW.reverse ( string player ) ) ) ( string num_games_played ) ( string = ) ( number 3 game ) ) ( string num_rebounds ) ) )	overnight-basketball
how many assists did kobe bryant make in a season with steals over 3	( call SW.listValue ( call SW.getProperty ( call SW.filter ( call SW.getProperty en.player.kobe_bryant ( call SW.reverse ( string player ) ) ) ( string num_steals ) ( string = ) ( number 3 steal ) ) ( string num_assists ) ) )	overnight-basketball
how many games did kobe bryant play during a season	( call SW.listValue ( call SW.getProperty ( call SW.filter ( call SW.getProperty en.player.kobe_bryant ( call SW.reverse ( string player ) ) ) ( string num_blocks ) ( string = ) ( number 3 block ) ) ( string num_games_played ) ) )	overnight-basketball
how many steals did kobebryant get in 2004	( call SW.listValue ( call SW.getProperty ( call SW.filter ( call SW.getProperty en.player.kobe_bryant ( call SW.reverse ( string player ) ) ) ( string season ) ( string = ) ( date 2004 -1 -1 ) ) ( string num_steals ) ) )	overnight-basketball
what is the number of games played by kobe bryant who made 3 rebounds over the season	( call SW.listValue ( call SW.getProperty ( call SW.filter ( call SW.getProperty en.player.kobe_bryant ( call SW.reverse ( string player ) ) ) ( string num_rebounds ) ( string = ) ( number 3 rebound ) ) ( string num_games_played ) ) )	overnight-basketball
how many assists did kobe byrant have during a season	( call SW.listValue ( call SW.getProperty ( call SW.filter ( call SW.getProperty en.player.kobe_bryant ( call SW.reverse ( string player ) ) ) ( string num_rebounds ) ( string = ) ( number 3 rebound ) ) ( string num_assists ) ) )	overnight-basketball
player whose number of assists over a season is same as that of player kobe bryant over a season	( call SW.listValue ( call SW.getProperty ( ( lambda s ( call SW.filter ( var s ) ( string num_assists ) ( string = ) ( call SW.getProperty ( call SW.getProperty en.player.kobe_bryant ( call SW.reverse ( string player ) ) ) ( string num_assists ) ) ) ) ( call SW.domain ( string player ) ) ) ( string player ) ) )	overnight-basketball
which players have made the same number of fouls as kobe bryant in a season	( call SW.listValue ( call SW.getProperty ( ( lambda s ( call SW.filter ( var s ) ( string num_fouls ) ( string = ) ( call SW.getProperty ( call SW.getProperty en.player.kobe_bryant ( call SW.reverse ( string player ) ) ) ( string num_fouls ) ) ) ) ( call SW.domain ( string player ) ) ) ( string player ) ) )	overnight-basketball
how many steals in a season did kobe bryant have for the lakers	( call SW.listValue ( call SW.getProperty ( call SW.filter ( call SW.getProperty en.player.kobe_bryant ( call SW.reverse ( string player ) ) ) ( string team ) ( string = ) en.team.lakers ) ( string num_steals ) ) )	overnight-basketball
which players have been on two or less teams	( call SW.listValue ( call SW.getProperty ( ( lambda s ( call SW.countComparative ( var s ) ( string team ) ( string <= ) ( number 2 ) ) ) ( call SW.domain ( string player ) ) ) ( string player ) ) )	overnight-basketball
how many steals did kobe bryant make over the season when made only 3 turnovers	( call SW.listValue ( call SW.getProperty ( call SW.filter ( call SW.getProperty en.player.kobe_bryant ( call SW.reverse ( string player ) ) ) ( string num_turnovers ) ( string = ) ( number 3 turnover ) ) ( string num_steals ) ) )	overnight-basketball
how many points did kobe bryant score when he had three rebounds	( call SW.listValue ( call SW.getProperty ( call SW.filter ( call SW.getProperty en.player.kobe_bryant ( call SW.reverse ( string player ) ) ) ( string num_rebounds ) ( string = ) ( number 3 rebound ) ) ( string num_points ) ) )	overnight-basketball
what players had equal or more assists than kobe bryant over all seasons	( call SW.listValue ( call SW.getProperty ( ( lambda s ( call SW.filter ( var s ) ( call SW.ensureNumericProperty ( string num_assists ) ) ( string >= ) ( call SW.ensureNumericEntity ( call SW.getProperty ( call SW.getProperty en.player.kobe_bryant ( call SW.reverse ( string player ) ) ) ( string num_assists ) ) ) ) ) ( call SW.domain ( string player ) ) ) ( string player ) ) )	overnight-basketball
who has the most points	( call SW.listValue ( call SW.getProperty ( ( lambda s ( call SW.superlative ( var s ) ( string max ) ( call SW.ensureNumericProperty ( string num_points ) ) ) ) ( call SW.domain ( string player ) ) ) ( string player ) ) )	overnight-basketball
how many points kob bryant made over a season in which he made 3 rebounds	( call SW.listValue ( call SW.getProperty ( call SW.filter ( call SW.getProperty en.player.kobe_bryant ( call SW.reverse ( string player ) ) ) ( string num_rebounds ) ( string = ) ( number 3 rebound ) ) ( string num_points ) ) )	overnight-basketball
which team did kobe bryant play for when he had only three rebounds in a season	( call SW.listValue ( call SW.getProperty ( call SW.filter ( call SW.getProperty en.player.kobe_bryant ( call SW.reverse ( string player ) ) ) ( string num_rebounds ) ( string = ) ( number 3 rebound ) ) ( string team ) ) )	overnight-basketball
what was the number of turnovers for player kobe bryant when he had just three steals in a season	( call SW.listValue ( call SW.getProperty ( call SW.filter ( call SW.getProperty en.player.kobe_bryant ( call SW.reverse ( string player ) ) ) ( string num_steals ) ( string = ) ( number 3 steal ) ) ( string num_turnovers ) ) )	overnight-basketball
how many different positions are there	( call SW.listValue ( call .size ( call SW.getProperty ( call SW.singleton en.position ) ( string ! type ) ) ) )	overnight-basketball
player who has played same number of games over a season as by player kobe bryantover a season	( call SW.listValue ( call SW.getProperty ( ( lambda s ( call SW.filter ( var s ) ( string num_games_played ) ( string = ) ( call SW.getProperty ( call SW.getProperty en.player.kobe_bryant ( call SW.reverse ( string player ) ) ) ( string num_games_played ) ) ) ) ( call SW.domain ( string player ) ) ) ( string player ) ) )	overnight-basketball
how many turnovers did kobe bryant have when he had 3 points	( call SW.listValue ( call SW.getProperty ( call SW.filter ( call SW.getProperty en.player.kobe_bryant ( call SW.reverse ( string player ) ) ) ( string num_points ) ( string = ) ( number 3 point ) ) ( string num_turnovers ) ) )	overnight-basketball
during the season in which he scored 3 assists what position was kobe bryant playing	( call SW.listValue ( call SW.getProperty ( call SW.filter ( call SW.getProperty en.player.kobe_bryant ( call SW.reverse ( string player ) ) ) ( string num_assists ) ( string = ) ( number 3 assist ) ) ( string position ) ) )	overnight-basketball
fouls by kobe bryant over all seasons with 3 games played	( call SW.listValue ( call SW.getProperty ( call SW.filter ( call SW.getProperty en.player.kobe_bryant ( call SW.reverse ( string player ) ) ) ( string num_games_played ) ( string = ) ( number 3 game ) ) ( string num_fouls ) ) )	overnight-basketball
players who had a greater number of assists in a season than kobe bryant	( call SW.listValue ( call SW.getProperty ( ( lambda s ( call SW.filter ( var s ) ( call SW.ensureNumericProperty ( string num_assists ) ) ( string > ) ( call SW.ensureNumericEntity ( call SW.getProperty ( call SW.getProperty en.player.kobe_bryant ( call SW.reverse ( string player ) ) ) ( string num_assists ) ) ) ) ) ( call SW.domain ( string player ) ) ) ( string player ) ) )	overnight-basketball
player whose number of rebounds over a season are not more than rebounds over a season of player kobe bryant	( call SW.listValue ( call SW.getProperty ( ( lambda s ( call SW.filter ( var s ) ( call SW.ensureNumericProperty ( string num_rebounds ) ) ( string <= ) ( call SW.ensureNumericEntity ( call SW.getProperty ( call SW.getProperty en.player.kobe_bryant ( call SW.reverse ( string player ) ) ) ( string num_rebounds ) ) ) ) ) ( call SW.domain ( string player ) ) ) ( string player ) ) )	overnight-basketball
during the season in which his point tally was 3 how many games was kobe bryant in	( call SW.listValue ( call SW.getProperty ( call SW.filter ( call SW.getProperty en.player.kobe_bryant ( call SW.reverse ( string player ) ) ) ( string num_points ) ( string = ) ( number 3 point ) ) ( string num_games_played ) ) )	overnight-basketball
what position did kobe bryant play for the lakers	( call SW.listValue ( call SW.getProperty ( call SW.filter ( call SW.getProperty en.player.kobe_bryant ( call SW.reverse ( string player ) ) ) ( string team ) ( string = ) en.team.lakers ) ( string position ) ) )	overnight-basketball
who has the record for steals	( call SW.listValue ( call SW.getProperty ( ( lambda s ( call SW.superlative ( var s ) ( string max ) ( call SW.ensureNumericProperty ( string num_steals ) ) ) ) ( call SW.domain ( string player ) ) ) ( string player ) ) )	overnight-basketball
name the season during which kobe bryant committed 3 fouls	( call SW.listValue ( call SW.getProperty ( call SW.filter ( call SW.getProperty en.player.kobe_bryant ( call SW.reverse ( string player ) ) ) ( string num_fouls ) ( string = ) ( number 3 foul ) ) ( string num_fouls ) ) )	overnight-basketball
what team is kobe bryant on	( call SW.listValue ( call SW.getProperty ( call SW.filter ( call SW.getProperty en.player.kobe_bryant ( call SW.reverse ( string player ) ) ) ( string num_blocks ) ( string = ) ( number 3 block ) ) ( string team ) ) )	overnight-basketball
what team will kobe bryant be on this year	( call SW.listValue ( call SW.getProperty ( call SW.filter ( call SW.getProperty en.player.kobe_bryant ( call SW.reverse ( string player ) ) ) ( string num_games_played ) ( string = ) ( number 3 game ) ) ( string team ) ) )	overnight-basketball
is there a player with the same number of turnovers in a specific season as kobe bryant has in a specific season as well	( call SW.listValue ( call SW.getProperty ( ( lambda s ( call SW.filter ( var s ) ( string num_turnovers ) ( string = ) ( call SW.getProperty ( call SW.getProperty en.player.kobe_bryant ( call SW.reverse ( string player ) ) ) ( string num_turnovers ) ) ) ) ( call SW.domain ( string player ) ) ) ( string player ) ) )	overnight-basketball
how many teams are in the nba	( call SW.listValue ( call .size ( call SW.getProperty ( call SW.singleton en.team ) ( string ! type ) ) ) )	overnight-basketball
how many games did kobe bryant play for the los angeles lakers	( call SW.listValue ( call SW.getProperty ( call SW.filter ( call SW.getProperty en.player.kobe_bryant ( call SW.reverse ( string player ) ) ) ( string team ) ( string = ) en.team.lakers ) ( string num_games_played ) ) )	overnight-basketball
who else plays the same position as kobe bryant	( call SW.listValue ( call SW.getProperty ( ( lambda s ( call SW.filter ( var s ) ( string position ) ( string = ) ( call SW.getProperty ( call SW.getProperty en.player.kobe_bryant ( call SW.reverse ( string player ) ) ) ( string position ) ) ) ) ( call SW.domain ( string player ) ) ) ( string player ) ) )	overnight-basketball
how many turnovers kob bryant made in season 2004	( call SW.listValue ( call SW.getProperty ( call SW.filter ( call SW.getProperty en.player.kobe_bryant ( call SW.reverse ( string player ) ) ) ( string season ) ( string = ) ( date 2004 -1 -1 ) ) ( string num_turnovers ) ) )	overnight-basketball
player who has same rebounds over a season as that of player kobe bryant over a season	( call SW.listValue ( call SW.getProperty ( ( lambda s ( call SW.filter ( var s ) ( string num_rebounds ) ( string = ) ( call SW.getProperty ( call SW.getProperty en.player.kobe_bryant ( call SW.reverse ( string player ) ) ) ( string num_rebounds ) ) ) ) ( call SW.domain ( string player ) ) ) ( string player ) ) )	overnight-basketball
points of kob bryant over a season in which he made 3 blocks	( call SW.listValue ( call SW.getProperty ( call SW.filter ( call SW.getProperty en.player.kobe_bryant ( call SW.reverse ( string player ) ) ) ( string num_blocks ) ( string = ) ( number 3 block ) ) ( string num_points ) ) )	overnight-basketball
players whose total number of points in a season is not 3	( call SW.listValue ( call SW.getProperty ( ( lambda s ( call SW.filter ( var s ) ( string num_points ) ( string ! = ) ( number 3 point ) ) ) ( call SW.domain ( string player ) ) ) ( string player ) ) )	overnight-basketball
for the season in which he had 3 blocks to his credit how many steals were attributable to kobe bryant	( call SW.listValue ( call SW.getProperty ( call SW.filter ( call SW.getProperty en.player.kobe_bryant ( call SW.reverse ( string player ) ) ) ( string num_blocks ) ( string = ) ( number 3 block ) ) ( string num_steals ) ) )	overnight-basketball
how many blocks does kobe bryant have in a season with at least 3 turnovers	( call SW.listValue ( call SW.getProperty ( call SW.filter ( call SW.getProperty en.player.kobe_bryant ( call SW.reverse ( string player ) ) ) ( string num_turnovers ) ( string = ) ( number 3 turnover ) ) ( string num_blocks ) ) )	overnight-basketball
players that had the same number of turnovers in a season as kobe byrant	( call SW.listValue ( call SW.getProperty ( ( lambda s ( call SW.filter ( var s ) ( string num_turnovers ) ( string = ) ( call SW.getProperty ( call SW.getProperty en.player.kobe_bryant ( call SW.reverse ( string player ) ) ) ( string num_turnovers ) ) ) ) ( call SW.domain ( string player ) ) ) ( string player ) ) )	overnight-basketball
how many fouls were played by kobe bryant when he scored 3 points	( call SW.listValue ( call SW.getProperty ( call SW.filter ( call SW.getProperty en.player.kobe_bryant ( call SW.reverse ( string player ) ) ) ( string num_points ) ( string = ) ( number 3 point ) ) ( string num_fouls ) ) )	overnight-basketball
which player has less than 3 fouls total in a season	( call SW.listValue ( call SW.getProperty ( ( lambda s ( call SW.filter ( var s ) ( string num_fouls ) ( string ! = ) ( number 3 foul ) ) ) ( call SW.domain ( string player ) ) ) ( string player ) ) )	overnight-basketball
in which season did kobe bryant have three steals	( call SW.listValue ( call SW.getProperty ( call SW.filter ( call SW.getProperty en.player.kobe_bryant ( call SW.reverse ( string player ) ) ) ( string num_steals ) ( string = ) ( number 3 steal ) ) ( string season ) ) )	overnight-basketball
player with the same or fewer blocks per season as kobe bryant	( call SW.listValue ( call SW.getProperty ( ( lambda s ( call SW.filter ( var s ) ( call SW.ensureNumericProperty ( string num_blocks ) ) ( string <= ) ( call SW.ensureNumericEntity ( call SW.getProperty ( call SW.getProperty en.player.kobe_bryant ( call SW.reverse ( string player ) ) ) ( string num_blocks ) ) ) ) ) ( call SW.domain ( string player ) ) ) ( string player ) ) )	overnight-basketball
what player had 3 or less blocks this season	( call SW.listValue ( call SW.getProperty ( ( lambda s ( call SW.filter ( var s ) ( call SW.ensureNumericProperty ( string num_blocks ) ) ( string <= ) ( call SW.ensureNumericEntity ( number 3 block ) ) ) ) ( call SW.domain ( string player ) ) ) ( string player ) ) )	overnight-basketball
in what position was kobe able to get 3 assists	( call SW.listValue ( call SW.getProperty ( call SW.filter ( call SW.getProperty en.player.kobe_bryant ( call SW.reverse ( string player ) ) ) ( string num_assists ) ( string = ) ( number 3 assist ) ) ( string position ) ) )	overnight-basketball
name the player who did not have three fouls in the season	( call SW.listValue ( call SW.getProperty ( ( lambda s ( call SW.filter ( var s ) ( string num_fouls ) ( string ! = ) ( number 3 foul ) ) ) ( call SW.domain ( string player ) ) ) ( string player ) ) )	overnight-basketball
how many fouls did kobe average in his three point total games over the season	( call SW.listValue ( call SW.getProperty ( call SW.filter ( call SW.getProperty en.player.kobe_bryant ( call SW.reverse ( string player ) ) ) ( string num_turnovers ) ( string = ) ( number 3 turnover ) ) ( string num_fouls ) ) )	overnight-basketball
which player has the least position	( call SW.listValue ( call SW.getProperty ( ( lambda s ( call SW.countSuperlative ( var s ) ( string min ) ( string position ) ) ) ( call SW.domain ( string player ) ) ) ( string player ) ) )	overnight-basketball
name a player who did not play in 2004	( call SW.listValue ( call SW.getProperty ( ( lambda s ( call SW.filter ( var s ) ( string season ) ( string ! = ) ( date 2004 -1 -1 ) ) ) ( call SW.domain ( string player ) ) ) ( string player ) ) )	overnight-basketball
what team did kobe play for during the season he average three blocks	( call SW.listValue ( call SW.getProperty ( call SW.filter ( call SW.getProperty en.player.kobe_bryant ( call SW.reverse ( string player ) ) ) ( string num_blocks ) ( string = ) ( number 3 block ) ) ( string team ) ) )	overnight-basketball
what player had 3 or less steals this season	( call SW.listValue ( call SW.getProperty ( ( lambda s ( call SW.filter ( var s ) ( call SW.ensureNumericProperty ( string num_steals ) ) ( string <= ) ( call SW.ensureNumericEntity ( number 3 steal ) ) ) ) ( call SW.domain ( string player ) ) ) ( string player ) ) )	overnight-basketball
