two attendees are at the meeting	( call SW.listValue ( call SW.countComparative ( call SW.getProperty ( call SW.singleton en.meeting ) ( string ! type ) ) ( string attendee ) ( string = ) ( number 2 ) ) )	overnight-calendar
meetings attended by two people	( call SW.listValue ( call SW.countComparative ( call SW.getProperty ( call SW.singleton en.meeting ) ( string ! type ) ) ( string attendee ) ( string = ) ( number 2 ) ) )	overnight-calendar
what meeting has the smallest length	( call SW.listValue ( call SW.superlative ( call SW.getProperty ( call SW.singleton en.meeting ) ( string ! type ) ) ( string min ) ( call SW.ensureNumericProperty ( string length ) ) ) )	overnight-calendar
show me meetings which do not conclude at 10am	( call SW.listValue ( call SW.filter ( call SW.getProperty ( call SW.singleton en.meeting ) ( string ! type ) ) ( string end_time ) ( string ! = ) ( time 10 0 ) ) )	overnight-calendar
show me meeting locations with alice	( call SW.listValue ( call SW.filter ( call SW.getProperty ( call SW.singleton en.location ) ( string ! type ) ) ( call SW.reverse ( string location ) ) ( string = ) ( call SW.filter ( call SW.getProperty ( call SW.singleton en.meeting ) ( string ! type ) ) ( string attendee ) ( string = ) en.person.alice ) ) )	overnight-calendar
what time does the weekly stand up end	( call SW.listValue ( call SW.getProperty en.meeting.weekly_standup ( string end_time ) ) )	overnight-calendar
meetings that end earlier than the weekly standup meeting	( call SW.listValue ( call SW.filter ( call SW.getProperty ( call SW.singleton en.meeting ) ( string ! type ) ) ( call SW.ensureNumericProperty ( string end_time ) ) ( string < ) ( call SW.ensureNumericEntity ( call SW.getProperty en.meeting.weekly_standup ( string end_time ) ) ) ) )	overnight-calendar
person is attendee of weekly standup or annual review	( call SW.listValue ( call SW.filter ( call SW.getProperty ( call SW.singleton en.person ) ( string ! type ) ) ( call SW.reverse ( string attendee ) ) ( string = ) ( call SW.concat en.meeting.weekly_standup en.meeting.annual_review ) ) )	overnight-calendar
what meeting starts when weekly standup ends	( call SW.listValue ( call SW.filter ( call SW.getProperty ( call SW.singleton en.meeting ) ( string ! type ) ) ( string start_time ) ( string = ) ( call SW.getProperty en.meeting.weekly_standup ( string end_time ) ) ) )	overnight-calendar
show me important meetings with alice	( call SW.listValue ( call SW.filter ( call SW.filter ( call SW.getProperty ( call SW.singleton en.meeting ) ( string ! type ) ) ( string is_important ) ) ( string attendee ) ( string = ) en.person.alice ) )	overnight-calendar
meetings at greenberg cafe attended by alice	( call SW.listValue ( call SW.filter ( call SW.filter ( call SW.getProperty ( call SW.singleton en.meeting ) ( string ! type ) ) ( string attendee ) ( string = ) en.person.alice ) ( string location ) ( string = ) en.location.greenberg_cafe ) )	overnight-calendar
where is my jan 2 meeting	( call SW.listValue ( call SW.filter ( call SW.getProperty ( call SW.singleton en.location ) ( string ! type ) ) ( call SW.reverse ( string location ) ) ( string = ) ( call SW.filter ( call SW.getProperty ( call SW.singleton en.meeting ) ( string ! type ) ) ( string date ) ( string = ) ( date 2015 1 2 ) ) ) )	overnight-calendar
person attending same meeting as alice	( call SW.listValue ( call SW.filter ( call SW.getProperty ( call SW.singleton en.person ) ( string ! type ) ) ( call SW.reverse ( string attendee ) ) ( string = ) ( call SW.filter ( call SW.getProperty ( call SW.singleton en.meeting ) ( string ! type ) ) ( string attendee ) ( string = ) en.person.alice ) ) )	overnight-calendar
select all important meetings	( call SW.listValue ( call SW.filter ( call SW.filter ( call SW.getProperty ( call SW.singleton en.meeting ) ( string ! type ) ) ( string is_important ) ) ( string is_important ) ) )	overnight-calendar
meetings attended by alice that are three hours long	( call SW.listValue ( call SW.filter ( call SW.filter ( call SW.getProperty ( call SW.singleton en.meeting ) ( string ! type ) ) ( string attendee ) ( string = ) en.person.alice ) ( string length ) ( string = ) ( number 3 en.hour ) ) )	overnight-calendar
who is attending the same meeting as alice	( call SW.listValue ( call SW.filter ( call SW.getProperty ( call SW.singleton en.person ) ( string ! type ) ) ( call SW.reverse ( string attendee ) ) ( string = ) ( call SW.filter ( call SW.getProperty ( call SW.singleton en.meeting ) ( string ! type ) ) ( string attendee ) ( string = ) en.person.alice ) ) )	overnight-calendar
what time does the weekly standup meeting end	( call SW.listValue ( call SW.getProperty en.meeting.weekly_standup ( string end_time ) ) )	overnight-calendar
start time of the meeting is after the start time of weekly standup	( call SW.listValue ( call SW.filter ( call SW.getProperty ( call SW.singleton en.meeting ) ( string ! type ) ) ( call SW.ensureNumericProperty ( string start_time ) ) ( string > ) ( call SW.ensureNumericEntity ( call SW.getProperty en.meeting.weekly_standup ( string start_time ) ) ) ) )	overnight-calendar
what meeting did alice attend at the greenberg cafe	( call SW.listValue ( call SW.filter ( call SW.filter ( call SW.getProperty ( call SW.singleton en.meeting ) ( string ! type ) ) ( string location ) ( string = ) en.location.greenberg_cafe ) ( string attendee ) ( string = ) en.person.alice ) )	overnight-calendar
show me all meetings that end at 10am and start at 10am	( call SW.listValue ( call SW.filter ( call SW.filter ( call SW.getProperty ( call SW.singleton en.meeting ) ( string ! type ) ) ( string end_time ) ( string = ) ( time 10 0 ) ) ( string start_time ) ( string = ) ( time 10 0 ) ) )	overnight-calendar
what meeting has a start time at the end time of weekly standup	( call SW.listValue ( call SW.filter ( call SW.getProperty ( call SW.singleton en.meeting ) ( string ! type ) ) ( string start_time ) ( string = ) ( call SW.getProperty en.meeting.weekly_standup ( string end_time ) ) ) )	overnight-calendar
meeting which has longest end time	( call SW.listValue ( call SW.superlative ( call SW.getProperty ( call SW.singleton en.meeting ) ( string ! type ) ) ( string max ) ( call SW.ensureNumericProperty ( string end_time ) ) ) )	overnight-calendar
who is not an attendee of weekly standup	( call SW.listValue ( call SW.filter ( call SW.getProperty ( call SW.singleton en.person ) ( string ! type ) ) ( call SW.reverse ( string attendee ) ) ( string ! = ) en.meeting.weekly_standup ) )	overnight-calendar
meetings on january 2	( call SW.listValue ( call SW.filter ( call SW.getProperty ( call SW.singleton en.meeting ) ( string ! type ) ) ( string date ) ( string = ) ( date 2015 1 2 ) ) )	overnight-calendar
what meeting ending at 10am is alice attending	( call SW.listValue ( call SW.filter ( call SW.filter ( call SW.getProperty ( call SW.singleton en.meeting ) ( string ! type ) ) ( string attendee ) ( string = ) en.person.alice ) ( string end_time ) ( string = ) ( time 10 0 ) ) )	overnight-calendar
show me any meetings that alice or bob have attended	( call SW.listValue ( call SW.concat en.person.alice en.person.bob ) )	overnight-calendar
show me all meetings beginning at 10 am	( call SW.listValue ( call SW.filter ( call SW.filter ( call SW.getProperty ( call SW.singleton en.meeting ) ( string ! type ) ) ( string start_time ) ( string = ) ( time 10 0 ) ) ( string start_time ) ( string = ) ( time 10 0 ) ) )	overnight-calendar
show me all meetings ending at 10 am or 3 pm	( call SW.listValue ( call SW.filter ( call SW.getProperty ( call SW.singleton en.meeting ) ( string ! type ) ) ( string end_time ) ( string = ) ( call SW.concat ( time 10 0 ) ( time 15 0 ) ) ) )	overnight-calendar
meeting which is on the date of first weekly standup	( call SW.listValue ( call SW.filter ( call SW.getProperty ( call SW.singleton en.meeting ) ( string ! type ) ) ( call SW.ensureNumericProperty ( string date ) ) ( string >= ) ( call SW.ensureNumericEntity ( call SW.getProperty en.meeting.weekly_standup ( string date ) ) ) ) )	overnight-calendar
show me all meetings on january 2nd beginning at 10 am	( call SW.listValue ( call SW.filter ( call SW.filter ( call SW.getProperty ( call SW.singleton en.meeting ) ( string ! type ) ) ( string date ) ( string = ) ( date 2015 1 2 ) ) ( string start_time ) ( string = ) ( time 10 0 ) ) )	overnight-calendar
what location is most meetings	( call SW.listValue ( call SW.countSuperlative ( call SW.getProperty ( call SW.singleton en.location ) ( string ! type ) ) ( string max ) ( call SW.reverse ( string location ) ) ( call SW.getProperty ( call SW.singleton en.meeting ) ( string ! type ) ) ) )	overnight-calendar
show me meetings at greenberg cafe on jan 2	( call SW.listValue ( call SW.filter ( call SW.filter ( call SW.getProperty ( call SW.singleton en.meeting ) ( string ! type ) ) ( string location ) ( string = ) en.location.greenberg_cafe ) ( string date ) ( string = ) ( date 2015 1 2 ) ) )	overnight-calendar
what meeting start time is at the end of weekly standup	( call SW.listValue ( call SW.filter ( call SW.getProperty ( call SW.singleton en.meeting ) ( string ! type ) ) ( call SW.ensureNumericProperty ( string start_time ) ) ( string <= ) ( call SW.ensureNumericEntity ( call SW.getProperty en.meeting.weekly_standup ( string end_time ) ) ) ) )	overnight-calendar
what meeting is located at greenberg cafe and alice will be attending	( call SW.listValue ( call SW.filter ( call SW.filter ( call SW.getProperty ( call SW.singleton en.meeting ) ( string ! type ) ) ( string attendee ) ( string = ) en.person.alice ) ( string location ) ( string = ) en.location.greenberg_cafe ) )	overnight-calendar
show me all meetings happening on days before the weekly standup	( call SW.listValue ( call SW.filter ( call SW.getProperty ( call SW.singleton en.meeting ) ( string ! type ) ) ( call SW.ensureNumericProperty ( string date ) ) ( string < ) ( call SW.ensureNumericEntity ( call SW.getProperty en.meeting.weekly_standup ( string date ) ) ) ) )	overnight-calendar
meetings attended by alice that start at 10am	( call SW.listValue ( call SW.filter ( call SW.filter ( call SW.getProperty ( call SW.singleton en.meeting ) ( string ! type ) ) ( string attendee ) ( string = ) en.person.alice ) ( string start_time ) ( string = ) ( time 10 0 ) ) )	overnight-calendar
shortest meeting	( call SW.listValue ( call SW.superlative ( call SW.getProperty ( call SW.singleton en.meeting ) ( string ! type ) ) ( string min ) ( call SW.ensureNumericProperty ( string length ) ) ) )	overnight-calendar
what is the average length of a meeting	( call SW.listValue ( call SW.aggregate ( string avg ) ( call SW.getProperty ( call SW.getProperty ( call SW.singleton en.meeting ) ( string ! type ) ) ( string length ) ) ) )	overnight-calendar
show me meetings that have two attendees	( call SW.listValue ( call SW.countComparative ( call SW.getProperty ( call SW.singleton en.meeting ) ( string ! type ) ) ( string attendee ) ( string = ) ( number 2 ) ) )	overnight-calendar
how many meetings are scheduled	( call SW.listValue ( call .size ( call SW.getProperty ( call SW.singleton en.meeting ) ( string ! type ) ) ) )	overnight-calendar
meetings that end later than the weekly standup meeting	( call SW.listValue ( call SW.filter ( call SW.getProperty ( call SW.singleton en.meeting ) ( string ! type ) ) ( call SW.ensureNumericProperty ( string end_time ) ) ( string > ) ( call SW.ensureNumericEntity ( call SW.getProperty en.meeting.weekly_standup ( string end_time ) ) ) ) )	overnight-calendar
important meetings at greenberg cafe	( call SW.listValue ( call SW.filter ( call SW.filter ( call SW.getProperty ( call SW.singleton en.meeting ) ( string ! type ) ) ( string is_important ) ) ( string location ) ( string = ) en.location.greenberg_cafe ) )	overnight-calendar
meetings attended by two or fewer people	( call SW.listValue ( call SW.countComparative ( call SW.getProperty ( call SW.singleton en.meeting ) ( string ! type ) ) ( string attendee ) ( string <= ) ( number 2 ) ) )	overnight-calendar
show me all people who have attended at least two meetings	( call SW.listValue ( call SW.countComparative ( call SW.getProperty ( call SW.singleton en.person ) ( string ! type ) ) ( call SW.reverse ( string attendee ) ) ( string >= ) ( number 2 ) ( call SW.getProperty ( call SW.singleton en.meeting ) ( string ! type ) ) ) )	overnight-calendar
what location is the meeting that starts at 10am	( call SW.listValue ( call SW.filter ( call SW.getProperty ( call SW.singleton en.location ) ( string ! type ) ) ( call SW.reverse ( string location ) ) ( string = ) ( call SW.filter ( call SW.getProperty ( call SW.singleton en.meeting ) ( string ! type ) ) ( string start_time ) ( string = ) ( time 10 0 ) ) ) )	overnight-calendar
what meeting is at greenberg cafe and alice is attending	( call SW.listValue ( call SW.filter ( call SW.filter ( call SW.getProperty ( call SW.singleton en.meeting ) ( string ! type ) ) ( string location ) ( string = ) en.location.greenberg_cafe ) ( string attendee ) ( string = ) en.person.alice ) )	overnight-calendar
show me meeting locations that start at 10am	( call SW.listValue ( call SW.filter ( call SW.getProperty ( call SW.singleton en.location ) ( string ! type ) ) ( call SW.reverse ( string location ) ) ( string = ) ( call SW.filter ( call SW.getProperty ( call SW.singleton en.meeting ) ( string ! type ) ) ( string start_time ) ( string = ) ( time 10 0 ) ) ) )	overnight-calendar
locations of meetings attended by alice	( call SW.listValue ( call SW.filter ( call SW.getProperty ( call SW.singleton en.location ) ( string ! type ) ) ( call SW.reverse ( string location ) ) ( string = ) ( call SW.filter ( call SW.getProperty ( call SW.singleton en.meeting ) ( string ! type ) ) ( string attendee ) ( string = ) en.person.alice ) ) )	overnight-calendar
show me all three hour meetings that are important	( call SW.listValue ( call SW.filter ( call SW.filter ( call SW.getProperty ( call SW.singleton en.meeting ) ( string ! type ) ) ( string length ) ( string = ) ( number 3 en.hour ) ) ( string is_important ) ) )	overnight-calendar
show me all meetings marked important	( call SW.listValue ( call SW.filter ( call SW.filter ( call SW.getProperty ( call SW.singleton en.meeting ) ( string ! type ) ) ( string is_important ) ) ( string is_important ) ) )	overnight-calendar
which meetings will take as much time as weekly standup	( call SW.listValue ( call SW.filter ( call SW.getProperty ( call SW.singleton en.meeting ) ( string ! type ) ) ( call SW.ensureNumericProperty ( string length ) ) ( string >= ) ( call SW.ensureNumericEntity ( call SW.getProperty en.meeting.weekly_standup ( string length ) ) ) ) )	overnight-calendar
show me all meetings alice is attending which are three hours long	( call SW.listValue ( call SW.filter ( call SW.filter ( call SW.getProperty ( call SW.singleton en.meeting ) ( string ! type ) ) ( string length ) ( string = ) ( number 3 en.hour ) ) ( string attendee ) ( string = ) en.person.alice ) )	overnight-calendar
what person attends most meetings	( call SW.listValue ( call SW.countSuperlative ( call SW.getProperty ( call SW.singleton en.person ) ( string ! type ) ) ( string max ) ( call SW.reverse ( string attendee ) ) ( call SW.getProperty ( call SW.singleton en.meeting ) ( string ! type ) ) ) )	overnight-calendar
person that attends the fewest meetings	( call SW.listValue ( call SW.countSuperlative ( call SW.getProperty ( call SW.singleton en.person ) ( string ! type ) ) ( string min ) ( call SW.reverse ( string attendee ) ) ( call SW.getProperty ( call SW.singleton en.meeting ) ( string ! type ) ) ) )	overnight-calendar
which meeting has the earliest end time	( call SW.listValue ( call SW.superlative ( call SW.getProperty ( call SW.singleton en.meeting ) ( string ! type ) ) ( string min ) ( call SW.ensureNumericProperty ( string end_time ) ) ) )	overnight-calendar
what meeting has a after jan 2 or 3	( call SW.listValue ( call SW.filter ( call SW.getProperty ( call SW.singleton en.meeting ) ( string ! type ) ) ( call SW.ensureNumericProperty ( string date ) ) ( string > ) ( call SW.ensureNumericEntity ( call SW.concat ( date 2015 1 2 ) ( date 2015 1 3 ) ) ) ) )	overnight-calendar
show me the meetings with the least number of different locations	( call SW.listValue ( call SW.countSuperlative ( call SW.getProperty ( call SW.singleton en.meeting ) ( string ! type ) ) ( string min ) ( string location ) ) )	overnight-calendar
what meetings are scheduled to run for 3 hours	( call SW.listValue ( call SW.filter ( call SW.getProperty ( call SW.singleton en.meeting ) ( string ! type ) ) ( call SW.ensureNumericProperty ( string length ) ) ( string >= ) ( call SW.ensureNumericEntity ( number 3 en.hour ) ) ) )	overnight-calendar
show me all meetings which has no more than two attendees	( call SW.listValue ( call SW.countComparative ( call SW.getProperty ( call SW.singleton en.meeting ) ( string ! type ) ) ( string attendee ) ( string <= ) ( number 2 ) ) )	overnight-calendar
meeting whose location is same as the  location of weekly standup	( call SW.listValue ( call SW.filter ( call SW.getProperty ( call SW.singleton en.meeting ) ( string ! type ) ) ( string location ) ( string = ) ( call SW.filter ( call SW.getProperty ( call SW.singleton en.location ) ( string ! type ) ) ( call SW.reverse ( string location ) ) ( string = ) en.meeting.weekly_standup ) ) )	overnight-calendar
meeting starts before weekly standup	( call SW.listValue ( call SW.filter ( call SW.getProperty ( call SW.singleton en.meeting ) ( string ! type ) ) ( call SW.ensureNumericProperty ( string start_time ) ) ( string < ) ( call SW.ensureNumericEntity ( call SW.getProperty en.meeting.weekly_standup ( string start_time ) ) ) ) )	overnight-calendar
show me all meetings beginning on or after january 2nd	( call SW.listValue ( call SW.filter ( call SW.getProperty ( call SW.singleton en.meeting ) ( string ! type ) ) ( call SW.ensureNumericProperty ( string date ) ) ( string >= ) ( call SW.ensureNumericEntity ( call SW.concat ( date 2015 1 2 ) ( date 2015 1 3 ) ) ) ) )	overnight-calendar
meeting does not start at 10am	( call SW.listValue ( call SW.filter ( call SW.getProperty ( call SW.singleton en.meeting ) ( string ! type ) ) ( string start_time ) ( string ! = ) ( time 10 0 ) ) )	overnight-calendar
show me all meetings starting at the same time as the weekly standup	( call SW.listValue ( call SW.filter ( call SW.getProperty ( call SW.singleton en.meeting ) ( string ! type ) ) ( string start_time ) ( string = ) ( call SW.getProperty en.meeting.weekly_standup ( string start_time ) ) ) )	overnight-calendar
person who attends the meeting that ends at 10 am	( call SW.listValue ( call SW.filter ( call SW.getProperty ( call SW.singleton en.person ) ( string ! type ) ) ( call SW.reverse ( string attendee ) ) ( string = ) ( call SW.filter ( call SW.getProperty ( call SW.singleton en.meeting ) ( string ! type ) ) ( string end_time ) ( string = ) ( time 10 0 ) ) ) )	overnight-calendar
show me all 3 hour meetings with alice	( call SW.listValue ( call SW.filter ( call SW.filter ( call SW.getProperty ( call SW.singleton en.meeting ) ( string ! type ) ) ( string length ) ( string = ) ( number 3 en.hour ) ) ( string attendee ) ( string = ) en.person.alice ) )	overnight-calendar
